aaaaaaabbb	TRUE	FALSE
aaaaabcbab	TRUE	FALSE
aacdbbbadb	TRUE	FALSE
aacdbbbddb	TRUE	FALSE
abbbdacdab	TRUE	FALSE
abbbdadadb	TRUE	FALSE
acaabbadbb	TRUE	FALSE
acaabbcacb	TRUE	FALSE
accdaccaab	TRUE	TRUE
accdaddbdb	TRUE	FALSE
adbbddbcdb	TRUE	FALSE
adbcaabadb	TRUE	FALSE
baaacccbcd	TRUE	TRUE
baaaccdccc	TRUE	TRUE
baccaabbca	TRUE	TRUE
baccaadcaa	TRUE	TRUE
bbbbcccadd	TRUE	TRUE
bbbbcdabac	TRUE	TRUE
bbdccaaacd	TRUE	TRUE
bbdccabcad	TRUE	TRUE
bccacddcad	TRUE	TRUE
bccacdddcc	TRUE	TRUE
bdacdddbda	TRUE	TRUE
bdacddddcc	TRUE	TRUE
bddadbabdd	TRUE	TRUE
bddadbdddc	TRUE	TRUE
cabccaacad	TRUE	TRUE
cabccabcbd	TRUE	TRUE
cbabacddca	TRUE	TRUE
cbabaddbca	TRUE	TRUE
cbcdcbddcc	TRUE	TRUE
cbcdcccaac	TRUE	TRUE
ccbbdddadc	TRUE	TRUE
ccbcaadbac	TRUE	TRUE
cdaabdccaa	TRUE	TRUE
cdaacabbac	TRUE	TRUE
cdccbdbadd	TRUE	TRUE
cdccbdbccc	TRUE	TRUE
daadbcccba	TRUE	TRUE
daadbdbccc	TRUE	TRUE
dadbccbdbc	TRUE	TRUE
dadbccdccc	TRUE	TRUE
dbbdccddcd	TRUE	TRUE
dbbddaabad	TRUE	TRUE
dcacacadbc	TRUE	TRUE
dcacacbabc	TRUE	TRUE
dcdabaabcc	TRUE	TRUE
dcdabacdbc	TRUE	TRUE
ddbcccbdbc	TRUE	TRUE
ddbccccbca	TRUE	TRUE
aaaaaaabbd	FALSE	TRUE
aaaaaccbaa	FALSE	TRUE
aacbddaccc	FALSE	TRUE
aacbddbcbc	FALSE	TRUE
abbadbcbbc	FALSE	FALSE
abbadcdabc	FALSE	TRUE
abddcbdbda	FALSE	TRUE
abddccadcc	FALSE	TRUE
accccadadc	FALSE	TRUE
accccbbbcd	FALSE	TRUE
adbbccacca	FALSE	TRUE
adbbcdaaac	FALSE	TRUE
baabcbcabb	FALSE	FALSE
baabcbccdb	FALSE	FALSE
bacdbcdbbb	FALSE	FALSE
bacdbdcbcb	FALSE	FALSE
bbbdabbacb	FALSE	FALSE
bbbdabdbcb	FALSE	FALSE
bcabbadcdb	FALSE	FALSE
bcabbaddbb	FALSE	FALSE
bcdabbcbcb	FALSE	FALSE
bcdabcbcbb	FALSE	FALSE
bdbcccdbab	FALSE	FALSE
bdbccdcacb	FALSE	TRUE
bdddccbdcb	FALSE	FALSE
bddddccbdb	FALSE	FALSE
cacbdacccb	FALSE	TRUE
cacbdbaacb	FALSE	FALSE
cbbaabdbbb	FALSE	FALSE
cbbaaddadb	FALSE	FALSE
cbdcbbccdb	FALSE	FALSE
cbdcbbdbbb	FALSE	FALSE
cccabbcdcb	FALSE	FALSE
cccabbdcab	FALSE	FALSE
cdabdcbabb	FALSE	FALSE
cdacaadcbb	FALSE	FALSE
cdcdacbbdb	FALSE	FALSE
cdcdadddcb	FALSE	TRUE
daadcacbcb	FALSE	FALSE
daadcdaccb	FALSE	TRUE
dadcbcdbcb	FALSE	FALSE
dadcbdbbdb	FALSE	FALSE
dbcababcbb	FALSE	FALSE
dbcababdcb	FALSE	FALSE
dcabcbbaab	FALSE	FALSE
dcabcbcdcb	FALSE	FALSE
dcdaacbacb	FALSE	FALSE
dcdaacdcbb	FALSE	FALSE
ddbcacdccb	FALSE	TRUE
ddbcaddadb	FALSE	TRUE
aaaaabacbcb	TRUE	FALSE
aaaaabbdbab	TRUE	FALSE
aaccbccaddb	TRUE	TRUE
aaccbdaccdb	TRUE	TRUE
abbaabbdcbb	TRUE	FALSE
abbaadcbbcb	TRUE	FALSE
abdccddbaab	TRUE	FALSE
abdccdddbab	TRUE	FALSE
accbaaacacb	TRUE	TRUE
accbaabdccb	TRUE	FALSE
adacdbbbabb	TRUE	FALSE
adadaacaccb	TRUE	TRUE
addbcbbbdab	TRUE	FALSE
addbcbbbdcb	TRUE	FALSE
babdbdcbbbc	TRUE	FALSE
babdbddbdba	TRUE	FALSE
bbabcabbdad	TRUE	TRUE
bbabcadbdcc	TRUE	TRUE
bbccbcdaddc	TRUE	TRUE
bbccbdbdaba	TRUE	TRUE
bcbbbcbdaba	TRUE	FALSE
bcbbcabdbac	TRUE	TRUE
bcddacccbba	TRUE	TRUE
bcddacdaadc	TRUE	TRUE
bdcadaaacac	TRUE	TRUE
bdcadacbcac	TRUE	TRUE
caacdcdacca	TRUE	TRUE
caacddabccd	TRUE	TRUE
cadbcdcbcbc	TRUE	TRUE
cadbdaacbdc	TRUE	TRUE
cbbdbcdaaac	TRUE	TRUE
cbbdcabadda	TRUE	TRUE
ccacaabacca	TRUE	TRUE
ccacabccadc	TRUE	TRUE
ccdaaacbbba	TRUE	FALSE
ccdaabcccbc	TRUE	TRUE
cdbcbbddcbc	TRUE	TRUE
cdbcbcccbca	TRUE	TRUE
daabdbcdbbc	TRUE	FALSE
daabddcbbaa	TRUE	TRUE
dadacccdaca	TRUE	TRUE
dadacddbbdc	TRUE	TRUE
dbbcbacacad	TRUE	TRUE
dbbcbbaadca	TRUE	TRUE
dcaaacaddaa	TRUE	TRUE
dcaaacdbacc	TRUE	TRUE
dccccadcccd	TRUE	TRUE
dccccbaabda	TRUE	TRUE
ddbadbddabc	TRUE	TRUE
ddbadcdacba	TRUE	TRUE
aaaaabacbbc	FALSE	TRUE
aaaaabcbbbc	FALSE	FALSE
aaccadcbccc	FALSE	TRUE
aaccbbdabda	FALSE	TRUE
abaddbcbbcd	FALSE	TRUE
abaddcabcac	FALSE	TRUE
abdbcdaacdc	FALSE	TRUE
abdbdbabdcd	FALSE	TRUE
accaddaabbc	FALSE	TRUE
accadddaaba	FALSE	TRUE
adbaacbbaaa	FALSE	TRUE
adbaadcaccc	FALSE	TRUE
addbdbaccdc	FALSE	TRUE
addbdbbdadc	FALSE	TRUE
bacbabaddab	FALSE	FALSE
bacbabddccb	FALSE	FALSE
bbadbaabcdb	FALSE	FALSE
bbadbbacccb	FALSE	FALSE
bbdbdababcb	FALSE	FALSE
bbdbdabddbb	FALSE	FALSE
bccbccabccb	FALSE	FALSE
bccbdbaaaab	FALSE	FALSE
bdbaadabccb	FALSE	FALSE
bdbabcccdbb	FALSE	FALSE
bddbdbdbacb	FALSE	FALSE
bddbdcbbdbb	FALSE	FALSE
cacabdcdbab	FALSE	FALSE
cacabddcdab	FALSE	TRUE
cbacbbabbab	FALSE	FALSE
cbacbbdddab	FALSE	FALSE
cbdbadbaccb	FALSE	FALSE
cbdbaddabdb	FALSE	FALSE
ccbcbbdbadb	FALSE	FALSE
ccbcbcacaab	FALSE	TRUE
cdaabdbbabb	FALSE	FALSE
cdaacacadab	FALSE	TRUE
cdccacbdacb	FALSE	TRUE
cdccadbbbcb	FALSE	FALSE
dabadbbdcbb	FALSE	FALSE
dabadccadab	FALSE	TRUE
dadccaabddb	FALSE	FALSE
dadccabddcb	FALSE	TRUE
dbcacbddbcb	FALSE	FALSE
dbcaccabdbb	FALSE	FALSE
dcaccdcaccb	FALSE	TRUE
dcaccdccdab	FALSE	TRUE
dcdacabccab	FALSE	TRUE
dcdacbcdadb	FALSE	TRUE
ddbcadbbccb	FALSE	FALSE
ddbcadcacbb	FALSE	FALSE
aaaaaaacacdb	TRUE	TRUE
aaaaaadabbdb	TRUE	FALSE
aacbacbcbddb	TRUE	FALSE
aacbbbbdbcdb	TRUE	FALSE
abbadaaddcbb	TRUE	FALSE
abbadacdacab	TRUE	TRUE
abddccdaabcb	TRUE	FALSE
abdddbaaccab	TRUE	TRUE
acccacbbbdab	TRUE	FALSE
acccacbdcaab	TRUE	TRUE
adbaabcbcaab	TRUE	FALSE
adbaabcdddcb	TRUE	FALSE
addcbbddcbcb	TRUE	FALSE
addcbccbacab	TRUE	TRUE
bacaccbbdbaa	TRUE	TRUE
bacacdcbbaac	TRUE	TRUE
bbadaaaacbbc	TRUE	TRUE
bbadaadcabdc	TRUE	TRUE
bbdbdbdbdaba	TRUE	TRUE
bbdcabbdbabd	TRUE	FALSE
bccabadccdcd	TRUE	TRUE
bccabbccabda	TRUE	TRUE
bdabdaccbccc	TRUE	TRUE
bdacaabaccaa	TRUE	TRUE
bddbcabdbdac	TRUE	TRUE
bddbcaccabba	TRUE	TRUE
cacacdcdabdc	TRUE	TRUE
cacacddabcca	TRUE	TRUE
cbadabcabbba	TRUE	FALSE
cbadaccbcbad	TRUE	TRUE
cbdadcaabcbd	TRUE	TRUE
cbdadcbacbaa	TRUE	TRUE
ccbcabcabbcc	TRUE	TRUE
ccbcabdbdcdd	TRUE	TRUE
ccdcddddcdac	TRUE	TRUE
ccddaabccdbd	TRUE	TRUE
cdbddababccd	TRUE	TRUE
cdbddacadddc	TRUE	TRUE
daabcdbdacdd	TRUE	TRUE
daabdabccccd	TRUE	TRUE
dadacdcdbbaa	TRUE	TRUE
dadacddacaad	TRUE	TRUE
dbbcdcbccbad	TRUE	TRUE
dbbcdcbdabda	TRUE	TRUE
dcabcaddcadd	TRUE	TRUE
dcabcbacaacc	TRUE	TRUE
dccdaaaacccd	TRUE	TRUE
dccdaaacccca	TRUE	TRUE
ddbaabacdadd	TRUE	TRUE
ddbaabadabcd	TRUE	TRUE
aaaaaaddcddc	FALSE	TRUE
aaaaabacbbbc	FALSE	FALSE
aadaacccacbc	FALSE	TRUE
aadaadbaddba	FALSE	TRUE
abbdaacccbdd	FALSE	TRUE
abbdabbaaada	FALSE	TRUE
acacbbabaaac	FALSE	TRUE
acacbbbdccaa	FALSE	TRUE
acdabbaadadd	FALSE	TRUE
acdacccdccbc	FALSE	TRUE
adbddacbbaaa	FALSE	TRUE
adbddacddbba	FALSE	TRUE
baaccbcddbcb	FALSE	FALSE
baacccbadacb	FALSE	TRUE
badaadadacbb	FALSE	FALSE
badabadbbbbb	FALSE	FALSE
bbbdbcbdbadb	FALSE	FALSE
bbbdbccacdab	FALSE	FALSE
bcababaabbbb	FALSE	FALSE
bcabacbbacbb	FALSE	FALSE
bcccdaaaabbb	FALSE	FALSE
bcccdaabccbb	FALSE	FALSE
bdbbaccbcddb	FALSE	FALSE
bdbbadcbbdcb	FALSE	FALSE
bdddbcacddbb	FALSE	FALSE
bdddbcdddbbb	FALSE	FALSE
caccccadcabb	FALSE	FALSE
cacccdabcccb	FALSE	TRUE
cbbabbddbbab	FALSE	FALSE
cbbabdbbcbdb	FALSE	FALSE
cbdccdcaddcb	FALSE	TRUE
cbdcdbabbcab	FALSE	FALSE
ccbdadbbbdcb	FALSE	FALSE
ccbdaddadbdb	FALSE	FALSE
cdaaabaaaccb	FALSE	TRUE
cdaaabaabbbb	FALSE	FALSE
cdccbcccdcbb	FALSE	FALSE
cdccbcdadcbb	FALSE	FALSE
daadbcdbadbb	FALSE	FALSE
daadbdbdcbdb	FALSE	FALSE
dadbbbacccdb	FALSE	FALSE
dadbbbbacabb	FALSE	FALSE
dbcaaaacabcb	FALSE	FALSE
dbcaaadbbcab	FALSE	FALSE
dcaccaaaadab	FALSE	TRUE
dcaccbadcbcb	FALSE	FALSE
dcdaabbbcbab	FALSE	FALSE
dcdaaccdaccb	FALSE	TRUE
ddbdbaccaddb	FALSE	FALSE
ddbdbbdacbcb	FALSE	FALSE
aaaaaabdbbabb	TRUE	FALSE
aaaaaadabcacb	TRUE	TRUE
aaccdbbabdabb	TRUE	FALSE
aaccddcacbcbb	TRUE	FALSE
abbdacbccbcdb	TRUE	FALSE
abbdaccdacdab	TRUE	FALSE
acabbcadcbbdb	TRUE	FALSE
acabbccdcadbb	TRUE	FALSE
accddabbcabab	TRUE	FALSE
accddacbbadcb	TRUE	FALSE
adbbbdbcdccab	TRUE	FALSE
adbbcbcbabbab	TRUE	FALSE
baaabdcabbaac	TRUE	TRUE
baaacacbccaaa	TRUE	TRUE
baccbbbbabaaa	TRUE	TRUE
baccbdbabccdc	TRUE	TRUE
bbaddccdcabda	TRUE	TRUE
bbadddacbbbcd	TRUE	TRUE
bbdccbbcbbcac	TRUE	TRUE
bbdccccaccdda	TRUE	TRUE
bcbdddadbddac	TRUE	TRUE
bcbddddbaabbd	TRUE	FALSE
bdaccbddcbbdd	TRUE	TRUE
bdacccbabdcbd	TRUE	TRUE
bddabbaaadbba	TRUE	FALSE
bddabbbbaddbd	TRUE	TRUE
cabcbacdadbac	TRUE	TRUE
cabcbcaadacad	TRUE	TRUE
cbaabccbdaacd	TRUE	TRUE
cbaabcccbccac	TRUE	TRUE
cbccdcdbdaabc	TRUE	TRUE
cbcdaaadcdbcd	TRUE	TRUE
ccbabdbdabcac	TRUE	TRUE
ccbacababbccc	TRUE	TRUE
ccdcaabcabbda	TRUE	TRUE
ccdcaccdccdba	TRUE	TRUE
cdcbacadcadda	TRUE	TRUE
cdcbadbcdcadc	TRUE	TRUE
daaddaaddabdd	TRUE	TRUE
daaddababcdcc	TRUE	TRUE
dadbcbacbbcad	TRUE	TRUE
dadbcbdadcdcd	TRUE	TRUE
dbbcdcadbacbc	TRUE	TRUE
dbbcdcbccabad	TRUE	TRUE
dcabcdaabaadd	TRUE	TRUE
dcabcdbaabbbc	TRUE	FALSE
dcdacabcbadad	TRUE	TRUE
dcdacaccadbbc	TRUE	TRUE
ddbccaadadcbd	TRUE	TRUE
ddbccbacabcdd	TRUE	TRUE
aaaaaacccddcd	FALSE	TRUE
aaaaaadacaadc	FALSE	TRUE
aacccadbbddac	FALSE	TRUE
aacccbaaaaaaa	FALSE	TRUE
abbadacbcdacd	FALSE	TRUE
abbadaccbdcad	FALSE	TRUE
acabaccdacbcd	FALSE	TRUE
acabadabbbaba	FALSE	FALSE
acdaadbbaccaa	FALSE	TRUE
acdabadcbacac	FALSE	TRUE
adbdbbcdabcaa	FALSE	TRUE
adbdbcabdbabd	FALSE	TRUE
baabbbbdbcaab	FALSE	FALSE
baabbcddcabab	FALSE	FALSE
baccddadabcab	FALSE	FALSE
baccddbaadabb	FALSE	FALSE
bbbbaaaaadcbb	FALSE	FALSE
bbbbaaadcadcb	FALSE	FALSE
bbdcddcadcdab	FALSE	TRUE
bbddabaadcdab	FALSE	FALSE
bccbcabcaaccb	FALSE	TRUE
bccbdbcccdadb	FALSE	FALSE
bdadcbcccccbb	FALSE	FALSE
bdadcdacddddb	FALSE	FALSE
bddbbabdcbbab	FALSE	FALSE
bddbbcacacddb	FALSE	FALSE
cabdbaaaadddb	FALSE	FALSE
cabdbaacadbbb	FALSE	FALSE
cbabdbdbdacab	FALSE	FALSE
cbabdcbcccdab	FALSE	FALSE
cbcdbddabcaab	FALSE	FALSE
cbcdbddbabcab	FALSE	FALSE
ccbcdbabbabcb	FALSE	FALSE
ccbcdbacabdab	FALSE	FALSE
cdaadaabdaabb	FALSE	FALSE
cdaadacbacdab	FALSE	TRUE
cdccbacdbbbbb	FALSE	FALSE
cdccbbabcbdcb	FALSE	FALSE
daaddaadaccdb	FALSE	TRUE
daaddacaccabb	FALSE	FALSE
dadcaccdcabab	FALSE	FALSE
dadcadbcdcdcb	FALSE	TRUE
dbcaabdabddbb	FALSE	FALSE
dbcaacbcdaacb	FALSE	TRUE
dcabddabcbbab	FALSE	FALSE
dcacacaccadbb	FALSE	FALSE
dccddbaadcccb	FALSE	TRUE
dccddbacdcdab	FALSE	TRUE
ddbbdddcbdcdb	FALSE	FALSE
ddbcaadacaaab	FALSE	TRUE
aaaaaacccddcdb	TRUE	FALSE
aaaaaadcaadbbb	TRUE	FALSE
aacccaaaddbadb	TRUE	FALSE
aacccaacbdbdab	TRUE	FALSE
abbadacdddabbb	TRUE	FALSE
abbadbdbcbbbab	TRUE	FALSE
acabbccbcdcdbb	TRUE	FALSE
acabbcdbdcbacb	TRUE	FALSE
acdabbdbaacbcb	TRUE	FALSE
acdabdaccaddbb	TRUE	FALSE
adbdcbcdddcbdb	TRUE	FALSE
adbdcccabbddcb	TRUE	FALSE
baabadbaabbdaa	TRUE	TRUE
baabaddbbcaacc	TRUE	TRUE
baccdacbbbaabd	TRUE	TRUE
baccdbbddccbbc	TRUE	FALSE
bbbaacabdacdbc	TRUE	TRUE
bbbabacbbabbba	TRUE	FALSE
bbdbccdababddd	TRUE	TRUE
bbdbcdcdbaddaa	TRUE	TRUE
bccacadcdbcbac	TRUE	TRUE
bccacaddccbdaa	TRUE	TRUE
bdacdaacabaabc	TRUE	TRUE
bdacdaadacbccd	TRUE	TRUE
bddadbbcadbdcc	TRUE	TRUE
bddadccadbcddc	TRUE	TRUE
cabdcacccbddac	TRUE	TRUE
cabdcbbaadacda	TRUE	TRUE
cbaccadddbcdba	TRUE	TRUE
cbaccbcbdacdbc	TRUE	TRUE
cbdabcacabaaad	TRUE	TRUE
cbdabcccaadcad	TRUE	TRUE
ccbcbabbcaacdc	TRUE	TRUE
ccbcbaccbcabdc	TRUE	TRUE
ccdddadacddacc	TRUE	TRUE
ccdddbcadabbcc	TRUE	TRUE
cdcbbccdcadbdc	TRUE	TRUE
cdcbccdabcbbcc	TRUE	TRUE
daadabdcdbaaaa	TRUE	TRUE
daadacdadababc	TRUE	TRUE
dadbbbacddbcaa	TRUE	TRUE
dadbbbbdacdbbd	TRUE	FALSE
dbbcddadaaabbc	TRUE	TRUE
dbbdaacbcddaaa	TRUE	TRUE
dcacabacacdbba	TRUE	TRUE
dcacabbcbabbdc	TRUE	TRUE
dccdddbdacdcdd	TRUE	TRUE
dccdddccbabbca	TRUE	TRUE
ddbbcadccdaadc	TRUE	TRUE
ddbbcbacdbcdbd	TRUE	TRUE
aaaaaaabddaacd	FALSE	TRUE
aaaaaabcbdabca	FALSE	TRUE
aaccacdbdadaba	FALSE	TRUE
aaccadbdabbcac	FALSE	TRUE
abbadaabbbcbbc	FALSE	FALSE
abbadadcddbcba	FALSE	TRUE
abdcacddbbadcd	FALSE	TRUE
abdcadaccaadca	FALSE	TRUE
accadbbccdcdca	FALSE	TRUE
accadbcacbdaaa	FALSE	TRUE
adbacbcaabacbd	FALSE	TRUE
adbacbccdccccd	FALSE	TRUE
addccdcddabcaa	FALSE	TRUE
addcdacadccdda	FALSE	TRUE
bacabcaadadbdb	FALSE	FALSE
bacacabdbcbbcb	FALSE	FALSE
bbabaadddccadb	FALSE	FALSE
bbababaaccccdb	FALSE	FALSE
bbdaccadcdcdbb	FALSE	FALSE
bbdacccaccbcbb	FALSE	FALSE
bcbbabddbabcab	FALSE	FALSE
bcbbbcbcdcbadb	FALSE	FALSE
bdaabcdcdbccbb	FALSE	FALSE
bdaabddaaacbcb	FALSE	FALSE
bdcdcbcbbddabb	FALSE	FALSE
bdcdcbdbbbacab	FALSE	FALSE
cabbabdabcdcab	FALSE	FALSE
cabbaccacdbccb	FALSE	FALSE
cadcddcdccdabb	FALSE	FALSE
cadcddcddacbdb	FALSE	FALSE
cbcbaabdcdbbcb	FALSE	FALSE
cbcbabaddabcab	FALSE	FALSE
ccbabdbaccaccb	FALSE	FALSE
ccbacadbbacddb	FALSE	FALSE
ccddacadcdaccb	FALSE	FALSE
ccddbabadbbcbb	FALSE	FALSE
cdcbbdcbcabbcb	FALSE	FALSE
cdcbcabacbdbbb	FALSE	FALSE
dabacaababcdab	FALSE	FALSE
dabacbcdccddcb	FALSE	FALSE
daddabaaabbaab	FALSE	FALSE
daddabdaddaaab	FALSE	TRUE
dbcbadcbccbadb	FALSE	FALSE
dbcbbbbdcbdabb	FALSE	FALSE
dcadcabbbccbbb	FALSE	FALSE
dcadcaccdcbbcb	FALSE	FALSE
dcdaadbbccbadb	FALSE	FALSE
dcdaadcdbcaabb	FALSE	FALSE
ddbbbcdbabadbb	FALSE	FALSE
ddbbcadcbbdacb	FALSE	FALSE
aaaaaaabdbadcdb	TRUE	FALSE
aaaaaabbddddddb	TRUE	FALSE
aaccccbacadddab	TRUE	FALSE
aaccccbadadbdab	TRUE	FALSE
abaddccbacbbdab	TRUE	FALSE
abadddacdaadcab	TRUE	FALSE
abdcadaaadadaab	TRUE	FALSE
abdcadbacdaadab	TRUE	FALSE
accadaaaabcbcbb	TRUE	FALSE
accadacbdbbbadb	TRUE	FALSE
adbaaaccacacbdb	TRUE	FALSE
adbaabacdbdbcbb	TRUE	FALSE
addbdccbdaccbdb	TRUE	FALSE
addbdcdbdabdbab	TRUE	FALSE
bacacddcbbbbcbd	TRUE	FALSE
bacadababcaccba	TRUE	TRUE
bbacdbddacaccca	TRUE	TRUE
bbacdcacdddacaa	TRUE	TRUE
bbcdccadbbcdbad	TRUE	TRUE
bbcdcdaccdbbabd	TRUE	TRUE
bcbdccccddacdca	TRUE	TRUE
bcbdcdbbcbacabd	TRUE	TRUE
bdadacbcaabcaba	TRUE	TRUE
bdadadccaccccdd	TRUE	TRUE
bddbaddcddddcda	TRUE	TRUE
bddbbaadbbadbcd	TRUE	TRUE
cabdcdbcccbbccc	TRUE	TRUE
cabddbadddaddca	TRUE	TRUE
cbabcbadadabcad	TRUE	TRUE
cbabcbdddaaddbd	TRUE	TRUE
cbcdaaacacdbbcd	TRUE	TRUE
cbcdaaccbcaacba	TRUE	TRUE
ccbbabdcbdcbddc	TRUE	TRUE
ccbbacbcccddbdd	TRUE	TRUE
ccddccdbabaacbd	TRUE	TRUE
ccddcdccaabbabc	TRUE	TRUE
cdcbdccabacdadc	TRUE	TRUE
cdcbddbdddacccc	TRUE	TRUE
dabbbdcbdcaadcc	TRUE	TRUE
dabbcadacaabadd	TRUE	TRUE
dadccadacdabccc	TRUE	TRUE
dadccbcaabaaada	TRUE	TRUE
dbbddcdcbadcaaa	TRUE	TRUE
dbcaababdddcbac	TRUE	TRUE
dcabbdcacdcbbdc	TRUE	TRUE
dcabcbabdbcdccd	TRUE	TRUE
dccdddbccbbabbd	TRUE	FALSE
dccdddcdabaacdd	TRUE	TRUE
ddbcaadacaaadca	TRUE	TRUE
ddbcabccdbdbcac	TRUE	TRUE
aaaaaacbddaaacd	FALSE	TRUE
aaaaaadbabdabba	FALSE	TRUE
aacbadbbcbdcaca	FALSE	TRUE
aacbadcbabbaaad	FALSE	TRUE
abadbcccaaaadbd	FALSE	TRUE
abadbcccaabcdac	FALSE	TRUE
abdabdbcdcaadbd	FALSE	TRUE
abdabdbdccababa	FALSE	TRUE
acbcccbdbdcccba	FALSE	TRUE
acbccdadddddbcc	FALSE	TRUE
adabaddcbacbaaa	FALSE	TRUE
adabadddbcabbda	FALSE	TRUE
adccaaadddccabc	FALSE	TRUE
adccacaaaccbcad	FALSE	TRUE
babacabbcbbadbb	FALSE	FALSE
babacbadbcccacb	FALSE	FALSE
badcddaacaadddb	FALSE	FALSE
badcdddbcdbaacb	FALSE	FALSE
bbcbbcabdcdbaab	FALSE	FALSE
bbcbcacccbbabdb	FALSE	FALSE
bcbaaaacadaabdb	FALSE	FALSE
bcbaaaccbdcdddb	FALSE	FALSE
bcdcacdaddadbdb	FALSE	FALSE
bcdcadbcaacdddb	FALSE	FALSE
bdcaccdacddccab	FALSE	FALSE
bdcadaaaabdbccb	FALSE	FALSE
caadcbdaaabcaab	FALSE	FALSE
caadcccdbbccbab	FALSE	FALSE
cadbddacbbadccb	FALSE	FALSE
cadcaabdcbabddb	FALSE	FALSE
cbcbbdcacdbadcb	FALSE	FALSE
cbcbbdddcbbdadb	FALSE	FALSE
ccbabadaddbbbdb	FALSE	FALSE
ccbabbddbdbbcdb	FALSE	FALSE
ccdcdbcbabcaacb	FALSE	FALSE
ccdcdbdaaabbdab	FALSE	FALSE
cdcacddaccabadb	FALSE	FALSE
cdcadbabbccacab	FALSE	FALSE
dababadabcacabb	FALSE	FALSE
dababadacaacbcb	FALSE	FALSE
dadccdacbddabdb	FALSE	FALSE
dadccdcccacacdb	FALSE	FALSE
dbcadbbcbdbccdb	FALSE	FALSE
dbcadbdacadcdab	FALSE	FALSE
dcaccbdbadbcabb	FALSE	FALSE
dcacccadbabbbab	FALSE	FALSE
dcccdbdcaddaadb	FALSE	FALSE
dccdabbaabdabab	FALSE	FALSE
ddbbbdccbcdbdab	FALSE	FALSE
ddbbcaacbdadbab	FALSE	FALSE
aaaaaabddcbcddab	TRUE	FALSE
aaaaaadcaccabbdb	TRUE	FALSE
aacbdccacaddbdcb	TRUE	FALSE
aaccaabbbddddcab	TRUE	FALSE
abaddddbaccbcabb	TRUE	FALSE
abadddddcddccadb	TRUE	FALSE
abdcbbbacaacbdcb	TRUE	FALSE
abdcbcbcbddcdadb	TRUE	FALSE
accacbaddabdcddb	TRUE	FALSE
accaccbcbcdacdab	TRUE	FALSE
adadcdcaaacabcdb	TRUE	FALSE
adaddadbbaccdadb	TRUE	FALSE
addbdcacdaaaadbb	TRUE	FALSE
addbdddabacdccab	TRUE	FALSE
babdddcdcaabbddd	TRUE	TRUE
bacaabbdcaabccba	TRUE	TRUE
bbadbdabacbdacdd	TRUE	TRUE
bbadbdddadcbdbcd	TRUE	TRUE
bbdbcbbaccacbadd	TRUE	TRUE
bbdbdcbacbbaccca	TRUE	TRUE
bccaccdbbdacddbd	TRUE	TRUE
bccacddbabaadcac	TRUE	TRUE
bdacbacccbbacbad	TRUE	TRUE
bdacbadcadbdbdda	TRUE	TRUE
bddaaddadbcacdba	TRUE	TRUE
bddabaddccdabcba	TRUE	TRUE
cabbddabbacbccca	TRUE	TRUE
cabbddccacdbbccc	TRUE	TRUE
caddddbcccacbddd	TRUE	TRUE
cbaaabbcdbbccbbd	TRUE	FALSE
cbcccabbbcdaadcc	TRUE	TRUE
cbccdaabadbdcacd	TRUE	TRUE
ccadcdbcbbccabcd	TRUE	TRUE
ccaddaaabbbabbdd	TRUE	TRUE
ccdcadbdadbcbbad	TRUE	TRUE
ccdcbaacddacdbcc	TRUE	TRUE
cdbddcdadacaadba	TRUE	TRUE
cdbddcdcbaacbbad	TRUE	TRUE
daacaaadaacadbda	TRUE	TRUE
daacacabaddadbac	TRUE	TRUE
dadabbaabdbadcbd	TRUE	TRUE
dadabbccbabdbddc	TRUE	TRUE
dbbcbbadaddbaacc	TRUE	TRUE
dbbcbcddaabcacac	TRUE	TRUE
dcabdbdbaaaaddad	TRUE	TRUE
dcabdcbbdacccbac	TRUE	TRUE
dcdacabadccaccca	TRUE	TRUE
dcdacaccdaddcdca	TRUE	TRUE
ddbcbcbbacadbbdd	TRUE	TRUE
ddbcbdbccadaaddc	TRUE	TRUE
aaaaaaabcbbaacda	FALSE	TRUE
aaaaaadcacaccacd	FALSE	TRUE
aacbbdbbaabaaadc	FALSE	TRUE
aacbcabdddccabbc	FALSE	FALSE
abbaabcaabddcdcd	FALSE	TRUE
abbaabddaacdcdca	FALSE	TRUE
abddadbaaabadbcc	FALSE	TRUE
abddadccddbabcac	FALSE	TRUE
accbdabbccaabbbd	FALSE	FALSE
accbdbdccdadcaca	FALSE	TRUE
adaddccbbbdababd	FALSE	TRUE
adaddcdbdcbbccad	FALSE	TRUE
addcadddbbbcabad	FALSE	TRUE
addcbaabddbbcaaa	FALSE	TRUE
bacacccdbbdbbdbb	FALSE	FALSE
bacacdcaddaacaab	FALSE	FALSE
bbadacbccacadaab	FALSE	FALSE
bbadadbbabccaccb	FALSE	FALSE
bbdaadcdacdbacbb	FALSE	FALSE
bbdababaacbabadb	FALSE	FALSE
bcbdaabbddabdccb	FALSE	FALSE
bcbdaaccdccccccb	FALSE	FALSE
bdabaccaacdbdcab	FALSE	FALSE
bdabaccadbabcbbb	FALSE	FALSE
bddaaacbbddbcacb	FALSE	FALSE
bddaadaaadadbdab	FALSE	FALSE
cabcacdacccadcdb	FALSE	FALSE
cabcbadcacbbadcb	FALSE	FALSE
cbaadcbcaaacaaab	FALSE	FALSE
cbaadccabddaddbb	FALSE	FALSE
cbcddaabddbdbbab	FALSE	FALSE
cbcddaaddbaaabdb	FALSE	FALSE
ccbbdcabdccbcbcb	FALSE	FALSE
ccbbdcbbbbbaadcb	FALSE	FALSE
cdaaddddadbcaddb	FALSE	FALSE
cdabaaaabbaadddb	FALSE	FALSE
cdcdddbadbdaccbb	FALSE	FALSE
cdcdddbbdbccbacb	FALSE	FALSE
dabbcdaccdaddadb	FALSE	FALSE
dabbcdadcaadcdcb	FALSE	FALSE
daddacbaabbddbbb	FALSE	FALSE
daddacbbcbddabcb	FALSE	FALSE
dbcbdbbbbacbdcab	FALSE	FALSE
dbcbdcaaaddcdbdb	FALSE	FALSE
dcadadbbdbbaddbb	FALSE	FALSE
dcadbcabccbacddb	FALSE	FALSE
dcdaddbddaadaccb	FALSE	FALSE
dcdadddacadddcdb	FALSE	FALSE
ddbcabdbcdbdbcbb	FALSE	FALSE
ddbcacccaddddcab	FALSE	FALSE
aaaaaaadacaacbbab	TRUE	FALSE
aaaaaadabcdddadcb	TRUE	FALSE
aaccdccadaacbcbcb	TRUE	FALSE
aaccdccbbabbddacb	TRUE	FALSE
abbaddccaacacaabb	TRUE	FALSE
abbbaabbabcdcaacb	TRUE	FALSE
acabacdababdbbbdb	TRUE	FALSE
acabadbccddaddadb	TRUE	FALSE
accccbdaadcadccab	TRUE	FALSE
acccccabaadacabdb	TRUE	FALSE
adaddacccccbcdddb	TRUE	FALSE
adaddacdbcbdddcdb	TRUE	FALSE
addbdaabddddcbccb	TRUE	FALSE
addbdadababbacbab	TRUE	FALSE
babcdbabdadcbaadd	TRUE	TRUE
babcdbdccbccbdbdd	TRUE	TRUE
bbaabacccabacadad	TRUE	TRUE
bbaabbacabbaabada	TRUE	TRUE
bbcdadbdcbcddbdad	TRUE	TRUE
bbcdbbdcbbadbdcac	TRUE	TRUE
bcbbcccbdbdadcdad	TRUE	TRUE
bcbbcdbccadbdacda	TRUE	TRUE
bdabccbdabbddacca	TRUE	TRUE
bdabcccaadacbadcd	TRUE	TRUE
bdcdbcbdcbcbcadbc	TRUE	TRUE
bdcdbccadbaddbcac	TRUE	TRUE
cabaccdddcdccacad	TRUE	TRUE
cabacdaadbdbcacba	TRUE	TRUE
cadcdbbacddacaaac	TRUE	TRUE
cadcdbdcdbcdacdcc	TRUE	TRUE
cbcabcdcaacaadabc	TRUE	TRUE
cbcabdadaaabdbbdd	TRUE	TRUE
ccadbaddadaaacdcd	TRUE	TRUE
ccadbbaddccbaddbc	TRUE	TRUE
ccdacdbabcabababa	TRUE	TRUE
ccdadbabddbbddcca	TRUE	TRUE
cdbddcdcdcacbcdcd	TRUE	TRUE
cdbdddbdbcdabcaac	TRUE	TRUE
daadbabbddadcdaaa	TRUE	TRUE
daadbabdcdbadccba	TRUE	TRUE
dadbdbccaabdbaccc	TRUE	TRUE
dadbdccdaaaacacca	TRUE	TRUE
dbcabacdcbddabacc	TRUE	TRUE
dbcabbbbaacbaaada	TRUE	TRUE
dcacbcddacdbbdaaa	TRUE	TRUE
dcacbdcddabdbbada	TRUE	TRUE
dccdccabbcccdcdcd	TRUE	TRUE
dccdccbbacaaccbad	TRUE	TRUE
ddbabddaccdbadadc	TRUE	TRUE
ddbacbabbbcaacdbd	TRUE	TRUE
aaaaacaaadccbaaac	FALSE	TRUE
aaaaaccdccddaddbc	FALSE	TRUE
aacbdddccccbbadac	FALSE	TRUE
aaccaabcabdccbdcd	FALSE	TRUE
abbaacbbabcdcdbdd	FALSE	TRUE
abbaadbcbbddbcddc	FALSE	TRUE
abddacbbcdbadccad	FALSE	TRUE
abddaccdbcacdbcbd	FALSE	TRUE
accaddcacdadbadda	FALSE	TRUE
accaddcadadcaabcd	FALSE	TRUE
adadadccbdcddadbd	FALSE	TRUE
adadbacbdccbaadac	FALSE	TRUE
addcabccbbdbdadcc	FALSE	TRUE
addcadabcabcdaadd	FALSE	TRUE
bacbacbcccbdcadab	FALSE	FALSE
bacbacdbcabadbadb	FALSE	FALSE
bbadadadbaaddbabb	FALSE	FALSE
bbadadcabbbbaabdb	FALSE	FALSE
bbdbccccdabaccbab	FALSE	FALSE
bbdbccdabcbbacadb	FALSE	FALSE
bcbcccadcccbbddab	FALSE	FALSE
bcbccccbaaacbbbcb	FALSE	FALSE
bdaaccaaaccccadcb	FALSE	FALSE
bdaaccbdcdccadddb	FALSE	FALSE
bdcdaccbcaabcbbab	FALSE	FALSE
bdcdbaabcabcddcab	FALSE	FALSE
cabadabbdbbdbcaab	FALSE	FALSE
cabadbcbcbbabbdab	FALSE	FALSE
caddcbbcbbbbcdddb	FALSE	FALSE
caddccbddaaababbb	FALSE	FALSE
cbccccaadbddacbbb	FALSE	FALSE
cbcccccbadbbbcbbb	FALSE	FALSE
ccbaabbaccccdddcb	FALSE	FALSE
ccbaabbbdddadddcb	FALSE	FALSE
ccdcaabaacdccdacb	FALSE	FALSE
ccdcabccbadcdabdb	FALSE	FALSE
cdcaacbaabadcaaab	FALSE	FALSE
cdcaacbaacbbccdab	FALSE	FALSE
daadbcbbbdbbddadb	FALSE	FALSE
daadbccbcaccddadb	FALSE	FALSE
dadaddabbacaddaab	FALSE	FALSE
dadbaacacaacddacb	FALSE	FALSE
dbbdbbcbcabbcccdb	FALSE	FALSE
dbbdbdcbbaadbcdbb	FALSE	FALSE
dcacadccdabdaaabb	FALSE	FALSE
dcacaddcadbccdbbb	FALSE	FALSE
dcdadaaadddcacdab	FALSE	FALSE
dcdadacacacbdbccb	FALSE	FALSE
ddbcadbcbaabbabcb	FALSE	FALSE
ddbcbaddcbcabdbbb	FALSE	FALSE
aaaaaaadbdcccdacab	TRUE	FALSE
aaaaabbcaacadbbcab	TRUE	FALSE
aaccccadcbbbbcddab	TRUE	FALSE
aacccccdaacdbabddb	TRUE	FALSE
abbbbaabcbdbaabdcb	TRUE	FALSE
abbbbaddccbddcdcbb	TRUE	FALSE
abdcdcbbdaacacaaab	TRUE	FALSE
abdcdcccaabddcacab	TRUE	FALSE
accbcdabaabcbcdcbb	TRUE	FALSE
accbdbbdaccdbbddcb	TRUE	FALSE
adbabdbadbccadddbb	TRUE	FALSE
adbacaacbabaccdadb	TRUE	FALSE
addcdaccabacabbdcb	TRUE	FALSE
addcdcaccdbcbcbbab	TRUE	FALSE
bacbadbdcddddadcdc	TRUE	TRUE
bacbbaadccaddccacd	TRUE	TRUE
bbacdcbadbbaddcbbd	TRUE	FALSE
bbadaaacccbbadbbcc	TRUE	TRUE
bbdbcccdabdbbcddcd	TRUE	TRUE
bbdbccdbbcdcdccccd	TRUE	TRUE
bcbdbbbdcaddaccaba	TRUE	TRUE
bcbdbbcbdabdacbdba	TRUE	FALSE
bdabbbaccbdbcddadc	TRUE	TRUE
bdabbbdacadaaaabba	TRUE	FALSE
bdcdcbcadbcaadadbd	TRUE	TRUE
bdcdcdacaaacdaabba	TRUE	FALSE
cabbcccccbadcabaca	TRUE	TRUE
cabbdabbcccccdabaa	TRUE	TRUE
cadddcabaaadcadacc	TRUE	TRUE
caddddbacbbdbddcca	TRUE	TRUE
cbccabcabbcaadccac	TRUE	TRUE
cbccacadacbcdbbdaa	TRUE	TRUE
ccbabbdccabdadddbc	TRUE	TRUE
ccbabcaacdbaaaadbc	TRUE	TRUE
ccdcbaddcdbbcddccd	TRUE	TRUE
ccdcbbccccadaaaaba	TRUE	TRUE
cdcabdbccdcdaabdcc	TRUE	TRUE
cdcabddcdccbcbcbda	TRUE	TRUE
daacaabbacbdddddac	TRUE	TRUE
daacabbccdbcaadadd	TRUE	TRUE
dacddddacaadaaabaa	TRUE	TRUE
dadaaabbbddadaccdd	TRUE	TRUE
dbbccbccbbbdbddbaa	TRUE	TRUE
dbbccdcbaddabacdac	TRUE	TRUE
dcababaaccdaccaccd	TRUE	TRUE
dcababacaaadddbcda	TRUE	TRUE
dccdbdcacbbbbabadc	TRUE	TRUE
dccdcadcdccccbdabc	TRUE	TRUE
ddbcccbadbbdbdbdaa	TRUE	TRUE
ddbccddccaaaacdacc	TRUE	TRUE
aaaaaaadccdccdcacc	FALSE	TRUE
aaaaaacbaacbbdcaac	FALSE	TRUE
aacbbccbbdbbdcacac	FALSE	TRUE
aacbbdbccacaacaacc	FALSE	TRUE
abbaaddcdadcccacda	FALSE	TRUE
abbabbdcaacacccbcc	FALSE	TRUE
abdcaaccddabdbdbad	FALSE	TRUE
abdcabcccbdbabbabc	FALSE	FALSE
accbcaacdcdabbabda	FALSE	TRUE
accbcaacddbcdcabdc	FALSE	TRUE
adaddcddcdabddcaba	FALSE	TRUE
adadddbdbaaacccbad	FALSE	TRUE
addbbdadbabacacadc	FALSE	TRUE
addbcaccaddccadada	FALSE	TRUE
bacaaadccaccabcdbb	FALSE	FALSE
bacaabccbdccdcbdab	FALSE	FALSE
bbabdcabdcbaadbcbb	FALSE	FALSE
bbabdcbbacddacccdb	FALSE	FALSE
bbdabbaddabbddddab	FALSE	FALSE
bbdabbbcdacacbbabb	FALSE	FALSE
bcbcccbcbcacdcdaab	FALSE	FALSE
bcbccccaccdbbbbcbb	FALSE	FALSE
bdabccbdcddadabbdb	FALSE	FALSE
bdabccdabbaadcbbab	FALSE	FALSE
bdcdabccccdcbcaabb	FALSE	FALSE
bdcdadabcdbddadbab	FALSE	FALSE
cabbaddbbbddbaaacb	FALSE	FALSE
cabbadddaccaadbacb	FALSE	FALSE
cadccbaadbdcabcbcb	FALSE	FALSE
cadccbccbbdcccbdbb	FALSE	FALSE
cbcadcdaabcabbcacb	FALSE	FALSE
cbcaddccbcdcdbcbdb	FALSE	FALSE
ccacccdbacbbadbbcb	FALSE	FALSE
ccacdabbbdadcaacbb	FALSE	FALSE
ccdbcadcdabdacbbcb	FALSE	FALSE
ccdbcbaacbdddbaabb	FALSE	FALSE
cdcabacddcbaabbcab	FALSE	FALSE
cdcabbbdcbddbadacb	FALSE	FALSE
daacddcccaaaababab	FALSE	FALSE
daadabdacbaadbdbbb	FALSE	FALSE
dadadbdbcccdabbdab	FALSE	FALSE
dadadbddcaadaccacb	FALSE	FALSE
dbbdcccdabbdbacbcb	FALSE	FALSE
dbbdccddbcdcabdcab	FALSE	FALSE
dcacadbaccacaaabcb	FALSE	FALSE
dcacadbbddbcaadbab	FALSE	FALSE
dcdaaddcccaabdaddb	FALSE	FALSE
dcdabaabbddbcbaaab	FALSE	FALSE
ddbcabdacdbdaccbab	FALSE	FALSE
ddbcacabbaadbabcdb	FALSE	FALSE
aaaaaadddbcdbcbdbab	TRUE	FALSE
aaaaabcddcaadcaabbb	TRUE	FALSE
aaccbadbdacdbdababb	TRUE	FALSE
aaccbbdbddddacbcbab	TRUE	FALSE
abbabababbaadcabdab	TRUE	FALSE
abbababbbcbbaabaccb	TRUE	FALSE
abddccacccdcacdbbdb	TRUE	FALSE
abdddadadccbabbcbbb	TRUE	FALSE
acccbbcbacacbcadadb	TRUE	FALSE
acccbcaaabbdadaddcb	TRUE	FALSE
adbbaacbadbacdcccdb	TRUE	FALSE
adbbadaabccaadcddab	TRUE	FALSE
addccabbcaaabcbddbb	TRUE	FALSE
addccacbabdbbdbbadb	TRUE	FALSE
bacaadbddbcbcbadcaa	TRUE	TRUE
bacaadccabaacdddacc	TRUE	TRUE
bbadaaaacbbbadacdba	TRUE	TRUE
bbadabddbcbacbaccac	TRUE	TRUE
bbdadcddadacbaaacdc	TRUE	TRUE
bbdbaaabdaacbaabddd	TRUE	TRUE
bcbcbbcbdcbacdaadca	TRUE	TRUE
bcbcbcdcccdcddbccac	TRUE	TRUE
bdaaddccdbbbdcbbbbd	TRUE	FALSE
bdabaabdcbddbddcaac	TRUE	TRUE
bdccddcdabccaadddca	TRUE	TRUE
bdcdabdaddccbddadcd	TRUE	TRUE
cabbabccccdadbdacbd	TRUE	TRUE
cabbacdcdbddaabcddd	TRUE	TRUE
caddbadacaabbbbaddc	TRUE	TRUE
caddbdacbcdccccbbdc	TRUE	TRUE
cbcbddadcacdbbdcbca	TRUE	TRUE
cbcbddbcbbbabaabacd	TRUE	TRUE
ccbabaaddabcbccabcd	TRUE	TRUE
ccbabcccdcccbcbaada	TRUE	TRUE
ccdddaacbbababbbaaa	TRUE	TRUE
ccdddadbddddbcbcbdd	TRUE	TRUE
cdcccccbccdadbabcac	TRUE	TRUE
cdccccccabaccbdcdcc	TRUE	TRUE
dabacaddcdcbbbcbdda	TRUE	TRUE
dabacbaddcccccabdbc	TRUE	FALSE
dadbcdcbcbbbccdcdbd	TRUE	TRUE
dadbcddbdabdcbddccd	TRUE	TRUE
dbbddabacbbdcdadcaa	TRUE	TRUE
dbbddbbbbbdddddcabc	TRUE	TRUE
dcabbaababbccdddbdd	TRUE	TRUE
dcabbadbddabbccbcac	TRUE	TRUE
dcdbaddbbddbccabacc	TRUE	TRUE
dcdbbcabbaddaccbcaa	TRUE	TRUE
ddbcadbccccccdaadca	TRUE	TRUE
ddbcadddabacababcac	TRUE	TRUE
aaaaaabbddcbabbacdd	FALSE	TRUE
aaaaabdddcdcbdbcdda	FALSE	TRUE
aacbdacbbabccabaddc	FALSE	TRUE
aacbdbcdadaadcabdaa	FALSE	TRUE
abacdbcdbaccacbacbc	FALSE	TRUE
abacdcbabdbdbabcbad	FALSE	TRUE
abdbbdbcbabbcaccdcd	FALSE	TRUE
abdbbdcdbacaccbcabc	FALSE	TRUE
accaccadbcbbdbbacda	FALSE	TRUE
accacddcbccdabdbbba	FALSE	FALSE
adadaaacadbaababbbc	FALSE	FALSE
adadabbabcacbdabddd	FALSE	TRUE
addbdcadabaddcabbcd	FALSE	TRUE
addbdcbaacbadabaaaa	FALSE	TRUE
babddbadcbadbbcabbb	FALSE	FALSE
babddbbbaaccadbdddb	FALSE	FALSE
bbabcdbddbaadcdbdbb	FALSE	FALSE
bbabdccacdaadbbbdbb	FALSE	FALSE
bbdacabacdabaabbacb	FALSE	FALSE
bbdacabadabbcdacbbb	FALSE	FALSE
bcbcaabdbadadddbdab	FALSE	FALSE
bcbcadbccddbbdbaabb	FALSE	FALSE
bdaaccccdbdacdacdab	FALSE	FALSE
bdaadaaaaadbbaaabdb	FALSE	FALSE
bdccbddaddbbabcdcdb	FALSE	FALSE
bdcccabaaaaddbdbbab	FALSE	FALSE
cabaddbccacdbbbadbb	FALSE	FALSE
cabaddcdaddddcbcaab	FALSE	FALSE
caddaaddabccdbadddb	FALSE	FALSE
caddabbacaacacdcaab	FALSE	FALSE
cbcbcbababacccabcbb	FALSE	FALSE
cbcbcbdbababcabcdab	FALSE	FALSE
ccadcbddbdaccccccdb	FALSE	FALSE
ccadccaccbbacdaaddb	FALSE	FALSE
ccdbdcaccaccabbdcdb	FALSE	FALSE
ccdbdccacbdbdaadbdb	FALSE	FALSE
cdbdddccdbbddbabadb	FALSE	FALSE
cdcaaacbbcbddcdddcb	FALSE	FALSE
daaccdcbaabccacdabb	FALSE	FALSE
daacdaabacdddcbcbab	FALSE	FALSE
dadaabcbdaaaacdbddb	FALSE	FALSE
dadaacabbacbcacbdcb	FALSE	FALSE
dbbcccdcacaaababddb	FALSE	FALSE
dbbccdaccbccbadcdcb	FALSE	FALSE
dcabbcacddddabbdddb	FALSE	FALSE
dcabbccbacadccdacab	FALSE	FALSE
dccdbabcacbcbbccbab	FALSE	FALSE
dccdbacabccbbcdadbb	FALSE	FALSE
ddbadbcdcaaccbcdacb	FALSE	FALSE
ddbadbcdddbdadccddb	FALSE	FALSE
