adadadadad	TRUE
adadadadad	TRUE
adadccbcdb	TRUE
adadccbcdd	TRUE
adbcbcbccd	TRUE
adbcbcbcdc	TRUE
adbcddbccb	TRUE
adbcddbccd	TRUE
adccbcadad	TRUE
adccbcadad	TRUE
addadbcddb	TRUE
addadbcddc	TRUE
adddadadcc	TRUE
adddadadcd	TRUE
bcadbccada	TRUE
bcadbccadb	TRUE
bcbcadadca	TRUE
bcbcadadcd	TRUE
bcbcccdbcb	TRUE
bcbcccdbcc	TRUE
bccbccbccb	TRUE
bccbccbccd	TRUE
bcdadadccd	TRUE
bcdadaddbc	TRUE
bcdcccbcbc	TRUE
bcdccccadb	TRUE
cadaddddda	TRUE
cadbcadada	TRUE
cadddbcadb	TRUE
cadddbcadc	TRUE
cbccbcadad	TRUE
cbccbcadbc	TRUE
ccadcccdbc	TRUE
ccadcccdbc	TRUE
ccdbcbcada	TRUE
ccdbcbcadd	TRUE
cdbcddadbc	TRUE
cdbcddbcad	TRUE
dadadbcbcd	TRUE
dadadbccad	TRUE
daddbcadda	TRUE
daddbcaddc	TRUE
dbcbccbccd	TRUE
dbcbccbcda	TRUE
dcadadbcdd	TRUE
dcadadcadb	TRUE
dccbcdcdbc	TRUE
dccbcddccb	TRUE
ddbcaddbca	TRUE
ddbcaddcad	TRUE
aaaaaacbda	FALSE
aaaaacacad	FALSE
aaccccbccd	FALSE
aaccccdccd	FALSE
abbadacccd	FALSE
abbadacdac	FALSE
abddcdabab	FALSE
abdddaacaa	FALSE
accbbdadda	FALSE
accbbdbcbb	FALSE
adaddcabdd	FALSE
adadddcbaa	FALSE
addacbdbbd	FALSE
addacdacda	FALSE
babdadbaaa	FALSE
babdadcdcb	FALSE
bbaacdabbd	FALSE
bbaacddaac	FALSE
bbcdcbbacb	FALSE
bbcdcbdbdd	FALSE
bcbcdabcbb	FALSE
bcbcdbabdc	FALSE
bdaacadcbb	FALSE
bdaaccacbb	FALSE
bdccadaddd	FALSE
bdccadbdbb	FALSE
cabadcdadd	FALSE
cabbaaacdb	FALSE
cadcdbcbab	FALSE
caddacbaaa	FALSE
cbcaaccbdd	FALSE
cbcaadacda	FALSE
ccacccadbc	FALSE
ccacccbcbb	FALSE
ccdbbcdbaa	FALSE
ccdbcabbad	FALSE
cdbdcdbbdd	FALSE
cdbdcdcdbc	FALSE
daabbcaaac	FALSE
daabcabbbc	FALSE
dadbaabdda	FALSE
dadbaabddb	FALSE
dbbccbcbbd	FALSE
dbbccbdbca	FALSE
dcaabcbdbc	FALSE
dcaabccaaa	FALSE
dccbdcddab	FALSE
dccbddbccb	FALSE
ddbbaddaac	FALSE
ddbbbbcccd	FALSE
adadadadada	TRUE
adadadadadc	TRUE
adadccbccdb	TRUE
adadccbccdd	TRUE
adbcbcbcccd	TRUE
adbcbcbcccd	TRUE
adbcddbcadc	TRUE
adbcddbcbcb	TRUE
adccbcdadcb	TRUE
adccbcdcbcb	TRUE
addbcadbccd	TRUE
addbcadbcdb	TRUE
adddccdadad	TRUE
adddcdaddcd	TRUE
bcadcaddadc	TRUE
bcadcaddbcc	TRUE
bcbcadcdadb	TRUE
bcbcadcdadc	TRUE
bcbccdcbcbc	TRUE
bcbccdcdcdb	TRUE
bccbcbcbcbc	TRUE
bccbcbcbccb	TRUE
bcdadadbccd	TRUE
bcdadadbcdc	TRUE
bcdcdadddad	TRUE
bcdcdbcbcda	TRUE
cadbcbcddcb	TRUE
cadbcbcddcc	TRUE
cadddbcadcc	TRUE
cadddbcbcbc	TRUE
cbcccbcbccd	TRUE
cbcccbccadb	TRUE
ccbcbccbccd	TRUE
ccbcbcdadcc	TRUE
ccdddadcbcd	TRUE
ccdddbcadcb	TRUE
cdcadcccddd	TRUE
cdcaddadada	TRUE
dadadcadcdc	TRUE
dadadcadcdd	TRUE
dadcdaddbca	TRUE
dadcdadddad	TRUE
dbcbcaddadc	TRUE
dbcbcaddccb	TRUE
dbcdcdadadd	TRUE
dbcdcdadddb	TRUE
dccbcbcbccc	TRUE
dccbcbccadb	TRUE
ddbcbcadadc	TRUE
ddbcbcadbcc	TRUE
aaaaaadaaaa	FALSE
aaaaaaddcad	FALSE
aacbbddbccc	FALSE
aacbcaaccbd	FALSE
abadbbdcaad	FALSE
abadbccddac	FALSE
abddbbacdcc	FALSE
abddbbbdacd	FALSE
accccccdddc	FALSE
accccddaddb	FALSE
adbacccbcbd	FALSE
adbacccbcdb	FALSE
addccabcdbd	FALSE
addcccaaaca	FALSE
bacabbaaabd	FALSE
bacabbbadbc	FALSE
bbabdddcacb	FALSE
bbacaaadbdc	FALSE
bbdabccbcbd	FALSE
bbdabdbacdc	FALSE
bcbdbdccdbb	FALSE
bcbdbdcdcbb	FALSE
bdaacdbccda	FALSE
bdaadaccaad	FALSE
bdcdbdcbadb	FALSE
bdcdbdccdbd	FALSE
cabbbabbdda	FALSE
cabbbbadddc	FALSE
caddcbbccdb	FALSE
caddccbadab	FALSE
cbccaccbabc	FALSE
cbccacdbbbb	FALSE
ccbbdaabbda	FALSE
ccbbdacadbd	FALSE
ccdddaccbbd	FALSE
ccdddbcadbb	FALSE
cdcadaccddd	FALSE
cdcadbadcbd	FALSE
daacaabcdcc	FALSE
daacabcdbad	FALSE
dacddbbccad	FALSE
dacddbcdbcd	FALSE
dbbacadbdab	FALSE
dbbaccbabbc	FALSE
dbdcddcbcbd	FALSE
dbdcddccabd	FALSE
dccbcacddac	FALSE
dccbcbcdcaa	FALSE
ddbaddbadca	FALSE
ddbaddbddac	FALSE
adadadadadad	TRUE
adadadadadcd	TRUE
adadccaddbca	TRUE
adadccadddbc	TRUE
adbcbcaddcad	TRUE
adbcbcaddcdc	TRUE
adbcddcadbcc	TRUE
adbcddcbcbca	TRUE
adcccdbcbccb	TRUE
adcccdcbccca	TRUE
addbcadddadb	TRUE
addbcadddbcd	TRUE
adddcccadcbc	TRUE
adddccccbcbc	TRUE
bcadcbcbccad	TRUE
bcadcbcbcccd	TRUE
bcbcaddcadbc	TRUE
bcbcaddcadcb	TRUE
bcbcdbcdadbc	TRUE
bcbcdbcdbcdd	TRUE
bccbcdddbcdc	TRUE
bccbcdddcbca	TRUE
bcdadcadbccd	TRUE
bcdadcadcadd	TRUE
bcddadccadad	TRUE
bcddadcdcbca	TRUE
cadbccaddadd	TRUE
cadbccaddadd	TRUE
cbcadbcadbca	TRUE
cbcadbcadbcb	TRUE
cbcccccdaddd	TRUE
cbccccddbcdb	TRUE
ccbcadadcdda	TRUE
ccbcadaddbcd	TRUE
ccdcbcccbccc	TRUE
ccdcbcdadbca	TRUE
cdcadadadbcc	TRUE
cdcadadbcada	TRUE
dadadcadcbcb	TRUE
dadadcbcadad	TRUE
daddadadadad	TRUE
daddadadadad	TRUE
dbcbccbccdad	TRUE
dbcbccbccdad	TRUE
dcadbcbcccad	TRUE
dcadbcbcdbca	TRUE
dccdbcadbcdb	TRUE
dccdbcadccbc	TRUE
ddbcbccdbcbc	TRUE
ddbcbccdbcda	TRUE
aaaaaadaaaab	FALSE
aaaaaaddaddb	FALSE
aacbacaadcad	FALSE
aacbacbdbccc	FALSE
abadddaaaccc	FALSE
abaddddccacc	FALSE
abddababbbba	FALSE
abddabbbcbbb	FALSE
acccbbadbcbb	FALSE
acccbbbcaabd	FALSE
adbbbccdbbca	FALSE
adbbbcdbdccc	FALSE
addccabbcccb	FALSE
addccaccacdd	FALSE
bacaaadaacdd	FALSE
bacaaaddcdab	FALSE
bbaccccdaccb	FALSE
bbacccdbcaca	FALSE
bbdaacdcadac	FALSE
bbdaadabdbda	FALSE
bcbbdabdddba	FALSE
bcbbdbbcadab	FALSE
bdaacbbcbcac	FALSE
bdaacbdbcbda	FALSE
bdcdddadbbdd	FALSE
bddabaaabacd	FALSE
cabbdddcacac	FALSE
cabcacccdccc	FALSE
cbaadaaacccc	FALSE
cbaadaccadca	FALSE
cbcccdddddba	FALSE
cbccdabbcdcc	FALSE
ccbaabbbdcda	FALSE
ccbaacacbaaa	FALSE
ccdcbccaabdc	FALSE
ccdcbdbacbda	FALSE
cdcaababcbab	FALSE
cdcaabdcccdd	FALSE
daacaccdbddb	FALSE
daacaccdcdbc	FALSE
dadaabcacbaa	FALSE
dadaadccdcdc	FALSE
dbbdaadcbdac	FALSE
dbbdababcccd	FALSE
dcabdacadddc	FALSE
dcabdbaabbcc	FALSE
dccdbadadbcc	FALSE
dccdbbabdbcd	FALSE
ddbbdcabcdcd	FALSE
ddbbdcadabda	FALSE
adadadadadada	TRUE
adadadadadbca	TRUE
adadccadccada	TRUE
adadccaddadbc	TRUE
adbcadddccbcc	TRUE
adbcaddddadad	TRUE
adbcdcdadadbc	TRUE
adbcdcdaddada	TRUE
adccadcbccbcd	TRUE
adccadcccbcdd	TRUE
addadcdcccbcd	TRUE
addadcdcddbcb	TRUE
adddbcbcaddbc	TRUE
adddbcbcbcadc	TRUE
bcadbcdadaddd	TRUE
bcadbcdadbccc	TRUE
bcbcadbcbcccc	TRUE
bcbcadbcbccdd	TRUE
bcbccdadbcbca	TRUE
bcbccdaddaddd	TRUE
bccbccadbcbcc	TRUE
bccbccaddcbcd	TRUE
bcdadadcbcddc	TRUE
bcdadadcbcddd	TRUE
bcdccbcadadcc	TRUE
bcdccbcbccccc	TRUE
cadbcadcbcdda	TRUE
cadbcadccadda	TRUE
cadddbcddcbcb	TRUE
cadddcadbcada	TRUE
cbcccaddadddb	TRUE
cbcccadddadca	TRUE
ccbcaddbcdddb	TRUE
ccbcadddbcbcd	TRUE
ccddadcbcbccd	TRUE
ccddaddbcddad	TRUE
cdcbccccadcad	TRUE
cdcbccdccccad	TRUE
dadaddccadbcc	TRUE
dadaddccadcbc	TRUE
daddbccbcbcdd	TRUE
daddbccbccdbc	TRUE
dbccadbcbccad	TRUE
dbccadbccadcb	TRUE
dcadcadcdadcc	TRUE
dcadcaddadbcd	TRUE
dccddbcddbcad	TRUE
dccddcadadbcc	TRUE
ddbccbcadbcad	TRUE
ddbccbcadccdd	TRUE
aaaaaaacddddb	FALSE
aaaaaacddddda	FALSE
aacbcdddcbcab	FALSE
aacbdaaddbddb	FALSE
abbabcacdbaab	FALSE
abbabcbabccdc	FALSE
abdccbdabadcb	FALSE
abdcccbdaaabd	FALSE
accabbcadaccd	FALSE
accabbcddccac	FALSE
adadbdacccada	FALSE
adadcababbdcb	FALSE
addcaacbabcac	FALSE
addcaccddaadb	FALSE
bacaabddaacaa	FALSE
bacaacaacaadb	FALSE
bbabbddccbacb	FALSE
bbabcaaddcdbc	FALSE
bbdaabcbddddb	FALSE
bbdaabdaadaca	FALSE
bcbbadcadbbdd	FALSE
bcbbbbcaddada	FALSE
bcddcacbabacd	FALSE
bcddcdacaadbb	FALSE
bdcbdccdaacca	FALSE
bdcbddbacdcca	FALSE
cabbbddbdbada	FALSE
cabbcabdcaaac	FALSE
caddbcdbbbdcd	FALSE
caddbdabbbbba	FALSE
cbcbdaadbccdc	FALSE
cbcbdbcddccab	FALSE
ccbacdcadcdaa	FALSE
ccbacdddcdccc	FALSE
ccddacabbabcc	FALSE
ccddaccdabcdd	FALSE
cdcbccabdcccd	FALSE
cdcbcdbabddcc	FALSE
daadacbdadbdd	FALSE
daadadabbbbbb	FALSE
dadbacccaabab	FALSE
dadbadcbaabdc	FALSE
dbcadbbccaacd	FALSE
dbcadbbdbccdc	FALSE
dcacdaadbabaa	FALSE
dcacdabcbcacc	FALSE
dccddbbadbdab	FALSE
dccddcabadbcc	FALSE
ddbcacbaadbda	FALSE
ddbcadbccdcba	FALSE
adadadadadadad	TRUE
adadadadadbcad	TRUE
adadccdbccdbcb	TRUE
adadccdbccddbc	TRUE
adbcbcbcadaddc	TRUE
adbcbcbcadbcad	TRUE
adbcdddccdadcc	TRUE
adbcddddcdccad	TRUE
adccbccbcaddcb	TRUE
adccbccbccbcbc	TRUE
addaddcbccdadb	TRUE
addaddcbcdadbc	TRUE
adddbcccbccbcd	TRUE
adddbccdadbcca	TRUE
bcadbcddbccbcc	TRUE
bcadbcddcbccdd	TRUE
bcbcadbccadcdb	TRUE
bcbcadbcdbcbcc	TRUE
bcbcdaddccbcdd	TRUE
bcbcdadddadbca	TRUE
bccbcdaddbcadb	TRUE
bccbcdaddbcbca	TRUE
bcdadaddcdcadc	TRUE
bcdadadddaddad	TRUE
bcdcddaddbcbcd	TRUE
bcdcddbcccadcd	TRUE
cadbcadbcddadd	TRUE
cadbcadcadadcd	TRUE
caddcbcdaddcbc	TRUE
caddcbcdcbcdbc	TRUE
cbccadcadadbca	TRUE
cbccadcadcbcda	TRUE
ccaddbccccbcad	TRUE
ccaddcbccddadb	TRUE
ccdbcbcdcaddca	TRUE
ccdbccaddaddbc	TRUE
cdbcddcbccadbc	TRUE
cdcadadbcccadb	TRUE
dadadbccdaddad	TRUE
dadadbcdaddbcc	TRUE
daddadadbcddda	TRUE
daddadadcadcbc	TRUE
dbcbcdcadadcda	TRUE
dbcbcdcaddadca	TRUE
dcadbcadadbcdd	TRUE
dcadbcadaddadc	TRUE
dcdadadadadccc	TRUE
dcdadadadaddca	TRUE
ddbcccbcbcadad	TRUE
ddbcccbcddbcda	TRUE
aaaaaadccbbacb	FALSE
aaaaabaccbdaab	FALSE
aaccbdbbcbbaba	FALSE
aacccabbdbbadb	FALSE
abbadcaabbabac	FALSE
abbbaaadddaacb	FALSE
acaabaaccdbbaa	FALSE
acaabbcbabdccc	FALSE
acccbabbaccadb	FALSE
acccbcbabbdcca	FALSE
adbabcdddbacbb	FALSE
adbabdbacaadca	FALSE
addbdddcbdaadb	FALSE
addcaaccaabbdd	FALSE
bacadcbbdcbcda	FALSE
bacadccbbaaaca	FALSE
bbabcbcddcaadd	FALSE
bbabccaadcbccc	FALSE
bbccddbacbbdac	FALSE
bbcdaaaadadcda	FALSE
bcbbcccbabcbda	FALSE
bcbbcccbbdbadc	FALSE
bdaadabddcbdda	FALSE
bdaadbcdaacdad	FALSE
bdccccbaaddbbb	FALSE
bdccccbcbaadcb	FALSE
cabbababacacbd	FALSE
cabbabdbbcabdd	FALSE
cadcabcbabbbbc	FALSE
cadcabcccbcbdd	FALSE
cbbddcdaabacca	FALSE
cbbdddacbccbdd	FALSE
ccadcaadcaccba	FALSE
ccadcadcdadbbc	FALSE
ccdbacbdacdcda	FALSE
ccdbaccccabcaa	FALSE
cdbddbcdacadbd	FALSE
cdcaabacbddccb	FALSE
daacadbaccbadb	FALSE
daacbbbdcbacbb	FALSE
dadbaadcbcbbbb	FALSE
dadbabbccdabca	FALSE
dbbcdcddaabbbd	FALSE
dbbcddbaaacabb	FALSE
dcabbabdcabcab	FALSE
dcabbbbbacadba	FALSE
dcdaaadccadbca	FALSE
dcdaabcdcaddbd	FALSE
ddbccbaacbadbb	FALSE
ddbccbbaacbbdd	FALSE
adadadadadadadb	TRUE
adadadadadbcadc	TRUE
adadccdbcbcccad	TRUE
adadccdbcdcaddd	TRUE
adbcbcbcaddcadc	TRUE
adbcbcbcbccbccb	TRUE
adbcdddcdcbccbc	TRUE
adbcddddadcdddc	TRUE
adccbcadcdadbcb	TRUE
adccbcbcadbcdbc	TRUE
addadddcadddbca	TRUE
addadddccaddbcc	TRUE
adddbcadadcccda	TRUE
adddbcadaddadbc	TRUE
bcadbcdadbcadca	TRUE
bcadbcdadcbcdcd	TRUE
bcbcadcdcbccbcb	TRUE
bcbcaddadadadda	TRUE
bcbcdadadbcadcd	TRUE
bcbcdadadbccadc	TRUE
bccbcbcadcdbcbc	TRUE
bccbcbcaddbccad	TRUE
bcdadadadccadcb	TRUE
bcdadadadccdadd	TRUE
bcdccddccadddad	TRUE
bcdcdadbcadaddd	TRUE
cadbcadbcbcadcd	TRUE
cadbcadbccbcdca	TRUE
caddcadbcccbccc	TRUE
caddcadcbcadccd	TRUE
cbccbcadadadbca	TRUE
cbccbcadbcadada	TRUE
ccadccadadccadb	TRUE
ccadccadbcbccdb	TRUE
ccdbccbcadcbcda	TRUE
ccdbccbcbcadbcd	TRUE
cdbcdcbcdadddcc	TRUE
cdbcdcbcdcbcbcc	TRUE
dadadcadcbccadc	TRUE
dadadcadcbcdbcc	TRUE
daddaddddaddccb	TRUE
daddbcadcbcbcbc	TRUE
dbcbccccadaddbc	TRUE
dbcbccccbcadada	TRUE
dcadbcadbcbccda	TRUE
dcadbcadcdadada	TRUE
dccdadadddadcdc	TRUE
dccdadbcdadbcad	TRUE
ddbcaddadbccdcb	TRUE
ddbcaddadcbccbc	TRUE
aaaaaaaaadcbdaa	FALSE
aaaaaadabadcaaa	FALSE
aacbaaccddddcbb	FALSE
aacbabadbabbdaa	FALSE
abadbdbcbbadaaa	FALSE
abadcbbbbdbacab	FALSE
abdbcdadccbccdc	FALSE
abdbcddcdbddcda	FALSE
accaddbacdacbcb	FALSE
accbaaabbdadcda	FALSE
adaccdabcbbcbad	FALSE
adaccdbdcccdbca	FALSE
addacdabcabcadc	FALSE
addacdaccbcaaab	FALSE
babcbadaadcdaad	FALSE
babcbadbacbcbca	FALSE
bbaaaabdadbdbdc	FALSE
bbaaaacbdcbdddb	FALSE
bbccbdadcacbbbb	FALSE
bbcccaaabdbaabd	FALSE
bcbadbbadddabab	FALSE
bcbadcbcdbbbdca	FALSE
bcdcadbabcdcdda	FALSE
bcdcbaadcdcadcc	FALSE
bdcadccbccaabaa	FALSE
bdcaddcaaabbccc	FALSE
caadbbdacadaabd	FALSE
caadbbdcadadcad	FALSE
cadadcdcacbddcd	FALSE
cadadcdccbbaadd	FALSE
cbcabaaddbdcbdc	FALSE
cbcabbbaabbdddb	FALSE
ccacabbbabddacd	FALSE
ccacacbbdacbbad	FALSE
cccddcadbcbdbbd	FALSE
ccdaababcbaccda	FALSE
cdbdaabdbabcccc	FALSE
cdbdababdbaadac	FALSE
daacbdbaadaddcc	FALSE
daacccdbaabbabb	FALSE
dadabadbddcacba	FALSE
dadabcacbaaadba	FALSE
dbbccadcdbdaccd	FALSE
dbbcccdbbdabddd	FALSE
dcaaaabdbbcddcb	FALSE
dcaaaacbcbadddd	FALSE
dccdacdccaadbdc	FALSE
dccdbabcbaddaaa	FALSE
ddbcccaabbdccbb	FALSE
ddbccccabdaccca	FALSE
adadadadadadadbc	TRUE
adadadadadadadca	TRUE
adadccdadadddbca	TRUE
adadccdadcadbcad	TRUE
adbcbcadcbcdadcb	TRUE
adbcbcadccadbcca	TRUE
adbcddbcbcaddadb	TRUE
adbcddbcbccccadc	TRUE
adccbcaddadbccbc	TRUE
adccbccbccbcbccd	TRUE
addbcaddadddadcd	TRUE
addbcaddbcaddcdb	TRUE
adddcccbcadadadb	TRUE
adddcdadadcccbcc	TRUE
bcadcaddcddcddbc	TRUE
bcadcadddbcbccdb	TRUE
bcbcadddbcbcbcad	TRUE
bcbcadddbcbcbcbc	TRUE
bcbcdbcbcdcadadb	TRUE
bcbcdbcbcddadcad	TRUE
bccbcdcaddadbcbc	TRUE
bccbcdcbcadbcbcb	TRUE
bcdadbcadbcadadb	TRUE
bcdadbcadcadadda	TRUE
bcddadaddddcccbc	TRUE
bcddadbcbcadbcda	TRUE
cadbcbccadadcbcd	TRUE
cadbcbccbcadbcad	TRUE
caddcdddadcccadb	TRUE
cadddadbcaddbcbc	TRUE
cbccbcdccbcddcdd	TRUE
cbccbcdcdbcddadc	TRUE
ccaddbccdadbccad	TRUE
ccaddbcdadbcccbc	TRUE
ccdbccbcddcdcadc	TRUE
ccdbcccadbccbcad	TRUE
cdbccddcbcbcbccb	TRUE
cdbccddcdaddaddc	TRUE
dadadbcccbcdcbca	TRUE
dadadbcccddcccad	TRUE
dadcdbcbccddadad	TRUE
dadcdbcccadbcddb	TRUE
dbcbccadcdccbcad	TRUE
dbcbccaddadbccdb	TRUE
dcadbcaddbccbcca	TRUE
dcadbcaddbcccadb	TRUE
dcdadbcbcddbccbc	TRUE
dcdadbccadadbcbc	TRUE
ddbccbcdbcaddbcb	TRUE
ddbccbcdbcbccadb	TRUE
aaaaabbcdbdbaddc	FALSE
aaaaabdaaaaccddb	FALSE
aaccddcaababcbcc	FALSE
aacdaadcccadbadc	FALSE
abbbccdccbaabdcd	FALSE
abbbcdcadabcdbba	FALSE
abddccbddaccdccb	FALSE
abddcccacdadadab	FALSE
acccbdacbdacddbc	FALSE
accccabbacacddbc	FALSE
adbabaccaabdadaa	FALSE
adbabadcadbcdacb	FALSE
addcbcbbcddcabac	FALSE
addccaadaaabdcbb	FALSE
bacacdbcbdadaaba	FALSE
bacacddabadadccc	FALSE
bbadacddaccbdacb	FALSE
bbadbbdcbbaddabc	FALSE
bbdbbbccbdbcdcdb	FALSE
bbdbbbddbbcbcaaa	FALSE
bccaaacaccdbcdcc	FALSE
bccaabcddcacaaab	FALSE
bdacabcddbdcbdcb	FALSE
bdacacdbddddbbcd	FALSE
bdcdddbbdbccbccb	FALSE
bdcdddbddccddaba	FALSE
cabbbadaaaaddbbc	FALSE
cabbbbadbabcccdb	FALSE
cadcdcadccabdccd	FALSE
caddaababcaddbcc	FALSE
cbcbcaddbbccadbc	FALSE
cbcbcbaacadcbddc	FALSE
ccadaccbbbabdbca	FALSE
ccadadaddddbdcad	FALSE
ccdbbdcacccbbcbd	FALSE
ccdbbddcadbccacb	FALSE
cdbcddbacbbcabcc	FALSE
cdbcddddbddccbcc	FALSE
daabbacaabacaadd	FALSE
daabbbbdcdadcdba	FALSE
daccdbcccddcbaac	FALSE
daccdddbddcaaadc	FALSE
dbbcaccabaccdcaa	FALSE
dbbcadaccdadbccc	FALSE
dcabababacabdcdb	FALSE
dcababcaddacbbbb	FALSE
dcdacadaadcdbabc	FALSE
dcdaccdcdbdddcab	FALSE
ddbcbadabdcddcdd	FALSE
ddbcbbaaabccaaac	FALSE
adadadadadadcadbc	TRUE
adadadadadaddcbcc	TRUE
adadcadddbcaddcdb	TRUE
adadcadddbcbcaddc	TRUE
adbcadccadcdadccb	TRUE
adbcadccccccaddbc	TRUE
adbcdadcdcadccdda	TRUE
adbcdadcddadadccd	TRUE
adcbcccadbccbcada	TRUE
adcbccccbcdccdcbc	TRUE
addadbcadaddbcbca	TRUE
addadbcadbcddcadd	TRUE
addccddcdadcdbcbc	TRUE
addcdadadadbcadcc	TRUE
bcadbcccbcbcbccdc	TRUE
bcadbccccadbccdca	TRUE
bcbcadadbcccbcada	TRUE
bcbcadadbcccbcbca	TRUE
bcbcccadbccbccada	TRUE
bcbcccadcadccadbc	TRUE
bccaddccbcaddbcbc	TRUE
bccadddbcccbcbcad	TRUE
bccdbcdddbcdbcdca	TRUE
bccdcadadbcadcbcd	TRUE
bcdbcddcdcbcadccc	TRUE
bcdbcdddbccbccccd	TRUE
cadadcbcbcbcbccdc	TRUE
cadadcbccadaddbcc	TRUE
caddaddadadbcddad	TRUE
caddaddbcbcbcadca	TRUE
cbcbccdcadadbcbcd	TRUE
cbcbccdcbcadcadad	TRUE
ccadbccdbcadadcdb	TRUE
ccadbccddccadcccc	TRUE
ccdadcdbcbcadcadb	TRUE
ccdaddadbccadcbcc	TRUE
cdbccadcbcccbcbca	TRUE
cdbccaddbcadadccb	TRUE
dadadadbcddbcdbca	TRUE
dadadadcadaddcadc	TRUE
dadcdbcdadadadadd	TRUE
dadcdbcdbcdbccbcd	TRUE
dbcbcbcbcbcdadbca	TRUE
dbcbcbcbcccccbcad	TRUE
dbcddccbcccaddadc	TRUE
dbcddcddadccbcbcb	TRUE
dcccadbcddcbccddd	TRUE
dcccaddbcdcbcdcbc	TRUE
ddbcbcdbcadadccad	TRUE
ddbcbcdcadadaddbc	TRUE
aaaaaabaccddddccc	FALSE
aaaaabacaadbbcadd	FALSE
aacbbaaaadaacdaad	FALSE
aacbbabddbcccbbad	FALSE
abadbdcaccdbdacbd	FALSE
abadcaddcbddadadc	FALSE
abdbbbaabcdbbbaab	FALSE
abdbbcaadddbaacab	FALSE
acbdcdbacbdbbdcda	FALSE
acbddaabdacccbdba	FALSE
adabdacbabbcbbbca	FALSE
adabdadbdddadddcc	FALSE
adcddcdacbbcacdcb	FALSE
adcdddacbaccabaac	FALSE
babadbcdbcdabbbbd	FALSE
babadbdbcabdbabda	FALSE
badbaacabdaacbddb	FALSE
badbaacbaaaddaddd	FALSE
bbbcdcdcccbdaccda	FALSE
bbbcddbdbbacddbdb	FALSE
bcaacbcdccadaaaad	FALSE
bcaacbdddccadbdcc	FALSE
bccddadadbabdddca	FALSE
bccddbaaadadaabdd	FALSE
bdbdcdcccddbddcaa	FALSE
bdbddabdccdbbbbdb	FALSE
caacaadacaabbdbba	FALSE
caacaadcbabcbadbd	FALSE
cacddbbdbacddabaa	FALSE
cacdddddaccdadbbc	FALSE
cbbdbabcbbdadbacd	FALSE
cbbdbbbadbbbdbaba	FALSE
ccabcbcbbbaacddbd	FALSE
ccabccadcaadadaba	FALSE
ccdacccbcaccbcbaa	FALSE
ccdaccdcaadacbbba	FALSE
cdbccacaabdcadbdb	FALSE
cdbccacbdbbcbbbdd	FALSE
daaabccdcdacbcdcb	FALSE
daaabdacbbbdadbcb	FALSE
dacdbacabcddddbdd	FALSE
dacdbaccdcaabdcad	FALSE
dbbcaaaaadaddcadd	FALSE
dbbcabbbbbbdadccd	FALSE
dbddcdadcacbaccab	FALSE
dbddcdccadaddbccc	FALSE
dcccacabcddcbccdd	FALSE
dcccadabadcbbdcba	FALSE
ddbbcbddddbacdcaa	FALSE
ddbbcdbbdcadbdaac	FALSE
adadadadadbcadadad	TRUE
adadadadadbcaddcca	TRUE
adadcbcaddadcddddc	TRUE
adadcbcaddccadaddd	TRUE
adbcaddcadbcddbcad	TRUE
adbcaddcadbcdddcad	TRUE
adbcdbcddaddbcdddd	TRUE
adbcdbcddbcadccdcc	TRUE
adccadbcadadbcccbc	TRUE
adccadbcadddadbcbc	TRUE
addadbcddadccbcdad	TRUE
addadbcddbccccadbc	TRUE
adddadcbcbcaddcdbc	TRUE
adddadcbcbcbcbcdad	TRUE
bcadbcdcccbcdadbcb	TRUE
bcadbcdcdadadadbcd	TRUE
bcbcadcaddadadbcad	TRUE
bcbcadcaddcddbccad	TRUE
bcbcdbcadadbcddccc	TRUE
bcbcdbcadadccccdbc	TRUE
bccbcccadcdcadbcbc	TRUE
bccbcccdadbcdbcadb	TRUE
bccddcdadbcadbcadd	TRUE
bccddcdbcdadddcdbc	TRUE
bcdcdcadbcbccdbcbc	TRUE
bcdcdcadcadbcadadc	TRUE
cadbcbcddcbcbcdcbc	TRUE
cadbcbcdddbccbcadd	TRUE
cbcadadadbcadaddbc	TRUE
cbcadadadbcbcccbcb	TRUE
cbcccbcbcadaddbccd	TRUE
cbcccbcccdbcbccbcc	TRUE
ccbcadadadccbcadcb	TRUE
ccbcadadcbccdbcccd	TRUE
ccdcdadccadbcdadad	TRUE
ccdcdbcdadadadadcc	TRUE
cdcbccaddbcdbcdadc	TRUE
cdcbccbcbccbcadddb	TRUE
dadbcadadbccadddbc	TRUE
dadbcadadbcccbcccc	TRUE
daddccbcadbcadaddd	TRUE
daddccccbcadddadcb	TRUE
dbccaddadcaddadbcb	TRUE
dbccaddaddcadbcbca	TRUE
dcadccdbcdadcccdad	TRUE
dcadccdcdbcdcdadcc	TRUE
dcdadbccadbcbccdad	TRUE
dcdadbccdadcbcbcad	TRUE
ddbccbccaddaddbcdb	TRUE
ddbccbcdbccbcdadcd	TRUE
aaaaaacdbdaddccdda	FALSE
aaaaaadddcccddbcbc	FALSE
aaccadbabdddaacdaa	FALSE
aaccadbbcdbbadbcaa	FALSE
abacdbbdbcabdbaacb	FALSE
abacdcddaacbabccdd	FALSE
abdbdbbbababcaaaab	FALSE
abdbdbcdadaabaccbc	FALSE
accbbbdbadcccdcaad	FALSE
accbbbdbcdcccabcbc	FALSE
adaccbcccaabacddcd	FALSE
adaccbcccddcbcabcc	FALSE
adcddaddaaabaabaab	FALSE
adcddbccbdcdcbbcba	FALSE
babccabdabbccbbcba	FALSE
babccbcbbabaadcdab	FALSE
bbaaabbdbcbcccdcbd	FALSE
bbaaaccdccdcbcdbbc	FALSE
bbcccbcbadaaaddcbc	FALSE
bbcccbdccbaacccaab	FALSE
bcbbccccabdbdccbdc	FALSE
bcbbccdacddcdaabcd	FALSE
bcdcdabdcdddadbbdb	FALSE
bcdcdbabbabcaaddab	FALSE
bdcbadddddbacabcdb	FALSE
bdcbbaccaabdbbacca	FALSE
cababbacbcbacbabbc	FALSE
cababcbaabcdbbdddb	FALSE
cadbdbcbccbbddcaac	FALSE
cadbdcddbcddcbdbbd	FALSE
cbbdabdbddbbbacabd	FALSE
cbbdacadcdabacdddb	FALSE
ccaadbdccccbadddbb	FALSE
ccababdddaccbcabad	FALSE
cccccacabadbbbbdab	FALSE
cccccadccbcbbdbadc	FALSE
cdbacdadadcbdbbbdb	FALSE
cdbacdbacacbddddcb	FALSE
cdddbdaadddbdaaabd	FALSE
cdddbdacdadcdbbcdd	FALSE
daccdadddcdbbbabdd	FALSE
daccdcbbbabaacaccb	FALSE
dbbadbaaadcccaabdc	FALSE
dbbaddbbcdcbcdbcad	FALSE
dcaabddabdbaccbcbb	FALSE
dcaaccbdccbbdaacbd	FALSE
dcccdbcbcacdcbbaca	FALSE
dcccdbdbadabcdcccb	FALSE
ddbcaacabdadacdbbc	FALSE
ddbcaacacccacbdbbc	FALSE
adadadadadadadadddd	TRUE
adadadadadbcdaddbcd	TRUE
adadccbcbcbcadbcadd	TRUE
adadccbcbcbccccdccc	TRUE
adbcbcaddbcdaddcbca	TRUE
adbcbcaddcbcadbcadd	TRUE
adbcddaddcdbcdadcdb	TRUE
adbcddbcadadcaddcbc	TRUE
adcbcddcdccadbcbcbc	TRUE
adcbcddcdcccbcadbcb	TRUE
addadbcdccbcdbcdcdb	TRUE
addadbcddaddcadbcdd	TRUE
adddadadcdadcbccbcb	TRUE
adddadbcadbcbcbcbcc	TRUE
bcadbccbcbcbcadadbc	TRUE
bcadbccbcbccadcddad	TRUE
bcaddddadbcadddaddd	TRUE
bcaddddadcbcadcbcdc	TRUE
bcbcccadcaddadcbccd	TRUE
bcbcccaddadbccbcada	TRUE
bccaddcbcbccadccadc	TRUE
bccaddcbccbcbccccdd	TRUE
bccdcdbcadccbcbcdad	TRUE
bccdcdbcddcaddadadb	TRUE
bcdcbcbcdbcddadcdbc	TRUE
bcdcbcbcddadadddbcc	TRUE
cadaddadccddcbccdad	TRUE
cadaddadcddbcbcbcbc	TRUE
caddbcaddcadddadbcb	TRUE
caddbcbccbccccadbcc	TRUE
cbcbcdadbcdadddadca	TRUE
cbcbcdadcccdbcbcadb	TRUE
ccadbcadcbcadadaddb	TRUE
ccadbcaddcbcadcadad	TRUE
ccccddbcdbccdddddbc	TRUE
cccdadadadccbcddbcc	TRUE
cdbcaddadcdbccbccda	TRUE
cdbcaddbcbccddadccd	TRUE
cdddadbcbcccbcaddbc	TRUE
cdddadcadadadddbcad	TRUE
dadccadbcbccdbcdbca	TRUE
dadccaddbcdbcadbcbc	TRUE
dbcbcbcbcdccbccbcdd	TRUE
dbcbcbccadadcbcccda	TRUE
dcadadaddddcdcadbcc	TRUE
dcadadbcadccdbcadbc	TRUE
dcccbcadadadadcadbc	TRUE
dcccbcbcdadadbcbcbc	TRUE
ddbcbccaddaddbcadcd	TRUE
ddbcbccbcbcbcbcadbc	TRUE
aaaaabaabccbdaabcba	FALSE
aaaaabadacabdaabacc	FALSE
aaccbabddcbbacddabc	FALSE
aaccbbcccaacadbacba	FALSE
abbbabdccbaacdadddd	FALSE
abbbacabcaddbbaaaab	FALSE
abddabbaadacccabbca	FALSE
abddabbbdacbcdbadba	FALSE
accabbddcdbbccaddcc	FALSE
accabdadcdcbbbdcadc	FALSE
adacaccdbacbdaaabdc	FALSE
adacacdacadcabacaab	FALSE
addbcbbdaddbcdbcbbd	FALSE
addbcbdbbadbcdccccc	FALSE
bacaabbcdbcccacdabb	FALSE
bacaabbdcdcbacccddb	FALSE
bbabcadacaadbabadcb	FALSE
bbabcbccabbadbabcac	FALSE
bbccddbbdccbddddcdd	FALSE
bbccdddbbcaddbabbba	FALSE
bcbbccbdbdadadcccdb	FALSE
bcbbcdabadbddaabaca	FALSE
bdaaaaccbdbcdddcacd	FALSE
bdaaacbaababdabacda	FALSE
bdcdacbccabdddbadca	FALSE
bdcdacccacabbabacdc	FALSE
cabcacbcdabadbdcacb	FALSE
cabcbcbadbaaacbbcdd	FALSE
cadddbcdbacdabadcdc	FALSE
cadddccabcbdbbaadbd	FALSE
cbcadbacddabdddaaac	FALSE
cbcbaabbddbdcaaddad	FALSE
ccadaacddbdadcabdab	FALSE
ccadabdbcbcaddbcddc	FALSE
ccdccaacdbcabbbcbba	FALSE
ccdccbadddcaabaaaac	FALSE
cdbdcbbcbbcdcdccbdb	FALSE
cdbdcccdaadbddcbcad	FALSE
daacaadacaacddadadd	FALSE
daacaadcbacaaddbacc	FALSE
dacdcababdaaabbcacb	FALSE
dacdcadcdbbdadcbadc	FALSE
dbbcbbaccaccbdacadb	FALSE
dbbcbbbdaaabdbadbdd	FALSE
dcaacbacaabdbcdddcc	FALSE
dcaacbdddababdccbdd	FALSE
dccdabdbabaadcbbccd	FALSE
dccdacbcadcbcabdcdb	FALSE
ddbabadaddcbdacbadc	FALSE
ddbabbcbabdbaadcccc	FALSE
