aaaaaaaaaa	TRUE
aaaaaaaacc	TRUE
aacbdadccb	TRUE
aacbdcadaa	TRUE
aaddcdacba	TRUE
aaddcdbdac	TRUE
acbcdaadbc	TRUE
acbcdacaad	TRUE
acdbdadadd	TRUE
acdbdbbadc	TRUE
adbbadcadd	TRUE
adbbadcbcb	TRUE
addaddbadc	TRUE
addbaacbca	TRUE
bacbacbcac	TRUE
bacbacddca	TRUE
bbaacaacac	TRUE
bbaacaadbb	TRUE
bbcccbcbaa	TRUE
bbcccdcaac	TRUE
bcbadbdbcd	TRUE
bcbadbddbd	TRUE
bcdcbbdaad	TRUE
bcdcbcacda	TRUE
bdcadddcac	TRUE
bdcadddcca	TRUE
caadbcdada	TRUE
caadbcdbcc	TRUE
cadcbadbad	TRUE
cadcbaddcd	TRUE
cbcaaadccd	TRUE
cbcaaaddbb	TRUE
ccacdaaaac	TRUE
ccacdaaccd	TRUE
ccccddbccd	TRUE
ccccddddcd	TRUE
cdbbbcdaca	TRUE
cdbbcaaccd	TRUE
daaadaaacb	TRUE
daaadaaadc	TRUE
dacdddcdca	TRUE
dadaaaadad	TRUE
dbbbccdbdc	TRUE
dbbbcdbbbc	TRUE
dcaaaccddc	TRUE
dcaaadcdcc	TRUE
dccdccdaac	TRUE
dccddadaca	TRUE
ddbbdcaccb	TRUE
ddbbdcdcaa	TRUE
aaaaaacbab	FALSE
aaaaabacac	FALSE
aaccadcbab	FALSE
aaccbacbab	FALSE
abadddacca	FALSE
abadddbbac	FALSE
abdcbbcabb	FALSE
abdcbbdaaa	FALSE
accadbbaba	FALSE
accadcacab	FALSE
adacacaabc	FALSE
adacacadab	FALSE
addbaaccab	FALSE
addbaadabb	FALSE
babcbdbccc	FALSE
babccacbaa	FALSE
bbaababbbd	FALSE
bbaabdbdda	FALSE
bbcccbcbab	FALSE
bbcccdcaab	FALSE
bcbaccbdab	FALSE
bcbadadbab	FALSE
bcdcbbdaab	FALSE
bcdcbcacab	FALSE
bdcadbdbab	FALSE
bdcaddaaba	FALSE
caadbccdab	FALSE
caadcaddab	FALSE
cadbbbcdab	FALSE
cadbbbdcab	FALSE
cbcaaaacab	FALSE
cbcaabdbca	FALSE
ccacaddbab	FALSE
ccacbcbdab	FALSE
ccccddbcab	FALSE
ccccddddab	FALSE
cdbbbcdaba	FALSE
cdbbcaabdc	FALSE
daabaabcad	FALSE
daabababda	FALSE
dacdacccab	FALSE
dacdadcdab	FALSE
dbbbccdbab	FALSE
dbbbcdbbab	FALSE
dcaabcccba	FALSE
dcaabcdbab	FALSE
dccdccdaab	FALSE
dccddacaba	FALSE
ddbbdcabcb	FALSE
ddbbdcdcab	FALSE
aaaaaaacccd	TRUE
aaaaaaadadb	TRUE
aacbbdcddcc	TRUE
aacbbddbada	TRUE
aaddbddcdad	TRUE
aaddcaaccba	TRUE
acbccbaccda	TRUE
acbccbbbdcd	TRUE
acdbcccbbbd	TRUE
acdbdacdaaa	TRUE
adbadaddcba	TRUE
adbadbaadbb	TRUE
addbbaaaacc	TRUE
addbbacbada	TRUE
bacadbcacaa	TRUE
bacadcbacbb	TRUE
bbaadadbacd	TRUE
bbaadadbbbc	TRUE
bbdaaccddaa	TRUE
bbdaacdcacb	TRUE
bcbcbdaddaa	TRUE
bcbcbdccacd	TRUE
bdaaccacaad	TRUE
bdaaccccbcc	TRUE
bdcdacaadbb	TRUE
bdcdadadacd	TRUE
caaddddcacc	TRUE
cacaaaacdcd	TRUE
caddcbdaccd	TRUE
caddcbdcbba	TRUE
cbcbaadbccd	TRUE
cbcbacadacc	TRUE
ccaddadcbbd	TRUE
ccadddacada	TRUE
ccdbcbddcca	TRUE
ccdbccaacbc	TRUE
cdbcdbbbcad	TRUE
cdbcdbcdbcc	TRUE
daaadbcdddc	TRUE
daaadbdacba	TRUE
dacdcccbadc	TRUE
dacdcccccdd	TRUE
dbbbadbacda	TRUE
dbbbadbddbd	TRUE
dbdddacbccd	TRUE
dbdddaccbba	TRUE
dcccbddacdc	TRUE
dccccaaacdb	TRUE
ddbbbccbccd	TRUE
ddbbcbdccbd	TRUE
aaaaabdbdab	FALSE
aaaaacabccc	FALSE
aacbdaabdab	FALSE
aacbdaccbab	FALSE
abbabaddcbd	FALSE
abbabbbcadb	FALSE
abdcadaddcd	FALSE
abdcadbcaac	FALSE
accabcacbab	FALSE
accabcbabcc	FALSE
adacdabacca	FALSE
adacdadbbab	FALSE
addacbcaaab	FALSE
addacbccbab	FALSE
babcbcccada	FALSE
babcbdbacbd	FALSE
bbaadbccaab	FALSE
bbaadbdcdab	FALSE
bbdaacadbab	FALSE
bbdaadcbaba	FALSE
bcbcbdaddab	FALSE
bcbcbdccabd	FALSE
bdaadadddab	FALSE
bdaaddbdaab	FALSE
bdcdacdcbab	FALSE
bdcdadacaab	FALSE
cabbbdabdaa	FALSE
cabbcaadcdd	FALSE
caddcdcccab	FALSE
caddcddcabd	FALSE
cbcbabbcdca	FALSE
cbcbabddacd	FALSE
ccaddaccbab	FALSE
ccaddcabdba	FALSE
ccdbcbddcab	FALSE
ccdbccaacab	FALSE
cdbcdbbbcab	FALSE
cdbcdbcdbab	FALSE
daabacbbcca	FALSE
daabacbccdd	FALSE
daccacdbaab	FALSE
daccadcbbab	FALSE
dbbbadbacab	FALSE
dbbbadbddab	FALSE
dbdddabbccd	FALSE
dbdddabcbba	FALSE
dcccbddacab	FALSE
dccccaabbdb	FALSE
ddbbbccbcab	FALSE
ddbbcbdccab	FALSE
aaaaaaacccda	TRUE
aaaaaaaddbdb	TRUE
aacbcccbdacd	TRUE
aacbcdaaccdc	TRUE
aaddcbbcdacb	TRUE
aaddccbcbbba	TRUE
acbcdbbdacca	TRUE
acbcdbcaaacc	TRUE
acdcaccacadd	TRUE
acdcacdacccd	TRUE
adbbccccbdca	TRUE
adbbcccccddd	TRUE
addbcccbaacc	TRUE
addbdaacacbb	TRUE
bacaddbccdcd	TRUE
bacaddcacada	TRUE
bbaadbcbadcc	TRUE
bbaadbcbbccc	TRUE
bbcdcbaadbcd	TRUE
bbcdcbbbdacb	TRUE
bcbcaaddccac	TRUE
bcbcbaadcdcd	TRUE
bcddddadacca	TRUE
bdaaaaaacddd	TRUE
bdcdaacaadba	TRUE
bdcdacbbccda	TRUE
caaddcadddad	TRUE
caadddadccbd	TRUE
caddddcddcad	TRUE
cbaaacadbbba	TRUE
cbccbacbbaca	TRUE
cbccbadcdaad	TRUE
ccadbdbaaacd	TRUE
ccadbdcbcdbc	TRUE
ccdbadbcadca	TRUE
ccdbadcbcddc	TRUE
cdbdcccaadaa	TRUE
cdbdccdbbacb	TRUE
daaaddbbdcdc	TRUE
daaaddcbbdcc	TRUE
dadbadcbbccb	TRUE
dadbadcbdadd	TRUE
dbbdcbbcdacb	TRUE
dbbdcbcbdcca	TRUE
dcacccccacad	TRUE
dcaccccddcac	TRUE
dcdaccdddbcb	TRUE
dcdacdbcacca	TRUE
ddbcaccaaadc	TRUE
ddbcacdacddb	TRUE
aaaaabdbdabd	FALSE
aaaaacbcccab	FALSE
aacbcbabccda	FALSE
aacbccbcdbab	FALSE
abadddcbddda	FALSE
abaddddbadbb	FALSE
abdbcbbadaab	FALSE
abdbcbbbbdba	FALSE
accadcbadbab	FALSE
accadcdcbdab	FALSE
adaccccaadab	FALSE
adaccdaabaad	FALSE
adcddbcdbdab	FALSE
adcddbcdddab	FALSE
babcbcacabba	FALSE
babcbcacabbc	FALSE
bbababbbcdad	FALSE
bbababdcbccc	FALSE
bbcdcbaadbab	FALSE
bbcdcbbbdabb	FALSE
bcbcaaddccab	FALSE
bcbcbabccdcd	FALSE
bcddddadacab	FALSE
bdaaaabdacaa	FALSE
bdcdaababdba	FALSE
bdcdabbbccda	FALSE
cabbcaaddcdd	FALSE
cabbcabddbdc	FALSE
caddddcddcab	FALSE
cbaaaacabcda	FALSE
cbccbacbbaba	FALSE
cbccbadcdaab	FALSE
ccaddabdbbaa	FALSE
ccaddabdcabd	FALSE
ccdbadbcacab	FALSE
ccdbadcbcdab	FALSE
cdbdcccaadab	FALSE
cdbdccdbbabb	FALSE
daabbcaacabb	FALSE
daabbccbbbcb	FALSE
dadabbbccbad	FALSE
dadabcccaddc	FALSE
dbbdcbbcdabb	FALSE
dbbdcbcbdcab	FALSE
dcacaccdacab	FALSE
dcacaddcacab	FALSE
dcdacbbcbbab	FALSE
dcdacbbdadab	FALSE
ddbcaccaacab	FALSE
ddbcaccbbdab	FALSE
aaaaaacaaccad	TRUE
aaaaaaccdadba	TRUE
aaccaadcddcbc	TRUE
aaccacaacbada	TRUE
aadddbaadaadb	TRUE
aadddbaccccbd	TRUE
acbddacbadbda	TRUE
acbddadcdbcca	TRUE
acdcdbccbbdca	TRUE
acdcdbddbcbca	TRUE
adbcccaadcaad	TRUE
adbccccbacbad	TRUE
addbcbacbbccc	TRUE
addbcbcdaacbb	TRUE
bacadacadddda	TRUE
bacadaccdcadd	TRUE
bbaacbadacdbb	TRUE
bbaacbcadacad	TRUE
bbcdbbbacdbad	TRUE
bbcdbcbaacdbd	TRUE
bcbdcacbadaac	TRUE
bcbdcbaaaacad	TRUE
bdaccadddbadd	TRUE
bdaccbbcdcaad	TRUE
bddaaccdbdbcd	TRUE
bddaadaaaadbd	TRUE
cacaccbaadccb	TRUE
cacaccbdbbddb	TRUE
cbaadcbaadbba	TRUE
cbaadccdbacda	TRUE
cbcdcbcaadbac	TRUE
cbcdccaaacdaa	TRUE
ccbcacadadddc	TRUE
ccbcadcbdcbda	TRUE
ccddbdcbacaaa	TRUE
ccddcacaddbdc	TRUE
cdcbbcdcadacd	TRUE
cdcbbdaaaaacd	TRUE
daaddaacaaadc	TRUE
daaddaacccdbb	TRUE
dbaaacaaacbbd	TRUE
dbaaacadcadcc	TRUE
dbcbdaadadcdb	TRUE
dbcbdadbdaacd	TRUE
dcbaaaadbbbdc	TRUE
dcbaaaaddbbcc	TRUE
dcdbdbddacdad	TRUE
dcdbddcdccacd	TRUE
ddbdacaadacac	TRUE
ddbdacbaaadaa	TRUE
aaaaabdbbbcda	FALSE
aaaaacaccddab	FALSE
aaccdbbcddbab	FALSE
aaccddadadcab	FALSE
abbcadddadcab	FALSE
abbcbbbadabcd	FALSE
abddbdbdbacdc	FALSE
abddbddccdbba	FALSE
accbcdcaababc	FALSE
accbcdcacbbab	FALSE
adadccbcacdab	FALSE
adadcccabadcb	FALSE
addacdbcaabbc	FALSE
addacdcadaaab	FALSE
babccacdacbda	FALSE
babccadcacbbd	FALSE
bbaaccdabbacb	FALSE
bbaadaaaadbab	FALSE
bbcdbbbabdbac	FALSE
bbcdbcbaabdbd	FALSE
bcbdcabbadaac	FALSE
bcbdcbabbacac	FALSE
bdacbdddddbab	FALSE
bdaccadcaadab	FALSE
bddaadcdcccab	FALSE
bddabaabbdaca	FALSE
cabcbcdbabacc	FALSE
cabcbddcbabbb	FALSE
cbababdbddcdd	FALSE
cbabaccccbddd	FALSE
cbcdcbcaadbab	FALSE
cbcdccabacdaa	FALSE
ccbcaccdadcab	FALSE
ccbcadcbdcbab	FALSE
ccddbdcbacaab	FALSE
ccddcacaddbab	FALSE
cdcbbcdcacabd	FALSE
cdcbbdaaabacd	FALSE
dabacbdaaabdb	FALSE
dabadaaccdaac	FALSE
dbaaaccacbcab	FALSE
dbaaadacddcab	FALSE
dbcbdaadadcab	FALSE
dbcbdadbdaabd	FALSE
dcbaabcccadac	FALSE
dcbaabdbaccbb	FALSE
dcdbdbddacdab	FALSE
dcdbddcdccaab	FALSE
ddbdabcdbacba	FALSE
ddbdabcdcadab	FALSE
aaaaaacacbcaaa	TRUE
aaaaaaccaaacac	TRUE
aacbdaadacdbdc	TRUE
aacbdadbcbdacb	TRUE
aaddbaadddacbc	TRUE
aaddbacbbaaccb	TRUE
acbbddaaccdcac	TRUE
acbbddcbcaccdc	TRUE
acdbacadbdcddd	TRUE
acdbacaddadbad	TRUE
adbbbbaccbdcbc	TRUE
adbbbcaacdcbaa	TRUE
addbbaaaddbbac	TRUE
addbbadaacbacc	TRUE
bacadbbcaaadaa	TRUE
bacadbccdbbbbb	TRUE
bbaacbbaaaccba	TRUE
bbaacbbbdcdacc	TRUE
bbcddcaadaaaca	TRUE
bbcddcbdbbdbad	TRUE
bcbbaaacdcccdd	TRUE
bcbbaacacaaaac	TRUE
bdaaaccaaddacb	TRUE
bdaaaccdaadbaa	TRUE
bdcccdacdcaddc	TRUE
bdccdbbdcaddcb	TRUE
caadbbdbbddada	TRUE
caadbdaaaaddad	TRUE
cadcbccccbbddc	TRUE
cadcbddcacacaa	TRUE
cbbdcacaadcbcb	TRUE
cbbdcacbdaaadd	TRUE
ccacbcadacaccd	TRUE
ccacbdbcacbddb	TRUE
ccdaadaaddaaaa	TRUE
ccdaadadcacbda	TRUE
cdbcaaacdbdbba	TRUE
cdbcacccddbbca	TRUE
daaaadadadaacb	TRUE
daaaadbaacadac	TRUE
dadacaaaddcbac	TRUE
dadacaccddcdaa	TRUE
dbbbaacbacdaad	TRUE
dbbbacbbcddbcb	TRUE
dcaaacddacbaca	TRUE
dcaaadccacbdcb	TRUE
dccccbacccdbcc	TRUE
dcccccaadbaccd	TRUE
ddbbcaccaaddba	TRUE
ddbbcbcdbaddcd	TRUE
aaaaaabbbcdabc	FALSE
aaaaabacbcadcc	FALSE
aacbddcadbacab	FALSE
aacbddccddcabd	FALSE
abbaadbbbacadd	FALSE
abbaadbdacabab	FALSE
abddbbdaccbcbc	FALSE
abddcaabaacbdd	FALSE
accadadbcccdab	FALSE
accadccbbdbabc	FALSE
adabacbcddacab	FALSE
adabadcdbcbbcc	FALSE
adcddcdcadacab	FALSE
adcdddadadabca	FALSE
babcacdddccdcb	FALSE
babcbaacbbaada	FALSE
bbaacbcbbdabcc	FALSE
bbaacbcccbbbab	FALSE
bbcddcaadaaaba	FALSE
bbcddcbdbbdbab	FALSE
bcbbaaacdcccab	FALSE
bcbbaacacabaac	FALSE
bdaaacbaddadab	FALSE
bdaabaabaacbaa	FALSE
bdcccdacdcadab	FALSE
bdccdbbdcacdab	FALSE
cabacbbccbddcd	FALSE
cabacbcadabbbb	FALSE
cadbbbccddcaba	FALSE
cadbbcacaabbcb	FALSE
cbbdcabcaadcbc	FALSE
cbbdcaccdaaabd	FALSE
ccabdaabdcdaad	FALSE
ccabdabcacbaab	FALSE
ccdabaacadddaa	FALSE
ccdababcacacbd	FALSE
cdbcaaacdbdbab	FALSE
cdbcabccddbbca	FALSE
daaacbaaddccab	FALSE
daaacbbaadaaab	FALSE
daccdbbabcdabc	FALSE
daccdcacddbbab	FALSE
dbbbaabbacdabd	FALSE
dbbbabbbdbbcdd	FALSE
dcaabcabbcbbaa	FALSE
dcaabccdabdcbc	FALSE
dccccbacccdbab	FALSE
dcccccaacbabcd	FALSE
ddbbcabcaaddba	FALSE
ddbbcbcdbaddab	FALSE
aaaaaaacbaadaad	TRUE
aaaaaaaccdbdcbd	TRUE
aacbbbdbdddbcaa	TRUE
aacbbcaaaccdacc	TRUE
aaddcbbbcbcbdbd	TRUE
aaddcbcaaaaacbc	TRUE
acbccdadddcadbb	TRUE
acbccddaacadcbd	TRUE
acdbbdbccbdaccc	TRUE
acdbcbbcbdddbad	TRUE
adbbadaacaaacaa	TRUE
adbbadccacaadcd	TRUE
addaaadacccbbac	TRUE
addaaadbcccdadb	TRUE
baaddddcbbaacac	TRUE
bacaaaccacadacd	TRUE
baddcccaacbddda	TRUE
baddccccbcdbacd	TRUE
bbcbbcadbacdaac	TRUE
bbcbbccaaaadadc	TRUE
bcadbdcaccaaada	TRUE
bcadbdcdacacbac	TRUE
bcdaddcaaacacbc	TRUE
bcdbaacbacacbcb	TRUE
bdbccadaaddbbbc	TRUE
bdbcccadcdadcaa	TRUE
caaadcadacbaacb	TRUE
caaadccbacbadbc	TRUE
cadbbdadbcbbbcc	TRUE
cadbbdcdacdadad	TRUE
cbbdaaacacbacba	TRUE
cbbdacaacaaaaac	TRUE
ccaaaccddadcacb	TRUE
ccaaadacbbbdaaa	TRUE
ccccbcdaadcacbc	TRUE
cccccaaacadbaad	TRUE
cdbbbcdbbdcdbba	TRUE
cdbbbdcbdbbbacc	TRUE
cddddbdaaddacdb	TRUE
cddddbdbdddbcdb	TRUE
dacddadbbccddcc	TRUE
dacddaddbadbbca	TRUE
dbbaacdcbccbccc	TRUE
dbbaadadacaadac	TRUE
dbdcaaadddbdcbb	TRUE
dbdcaadaaccccbb	TRUE
dccadcaddccbada	TRUE
dccadcdcaaaccca	TRUE
ddbaccbacdbccaa	TRUE
ddbacdcdddcbcaa	TRUE
aaaaaaaaaadbdab	FALSE
aaaaaaddbacbdab	FALSE
aacbcddccabaabd	FALSE
aacbdacbaccabda	FALSE
abbacbadbbbaadd	FALSE
abbacbcbbcbcddb	FALSE
abdbdbaccdcaacb	FALSE
abdbdbcdacaadab	FALSE
acbdddbacdabccd	FALSE
acbdddbbadcbbab	FALSE
adabccccadbabcb	FALSE
adabccdcbbaaddc	FALSE
adccbdbbdcdadab	FALSE
adccbddabdaddbc	FALSE
babbcaacbdbacbc	FALSE
babbcaadbcbdbda	FALSE
baddadbbcacbdab	FALSE
baddadbccbcdbab	FALSE
bbcbbcadbabdaac	FALSE
bbcbbccaaabdadc	FALSE
bcadbbdacdaccab	FALSE
bcadbccddabacba	FALSE
bcdaddcaaababbc	FALSE
bcdbabaabcbbcdd	FALSE
bdbccadabcdbbbc	FALSE
bdbcccadcdadcab	FALSE
caabdbbdacacacd	FALSE
caabdbdabadbbaa	FALSE
cadadcadbdacabc	FALSE
cadaddcbdbcaaab	FALSE
cbbdaaacabbabba	FALSE
cbbdababababaaa	FALSE
ccaaaddcacbbdab	FALSE
ccaabaddbaaccdb	FALSE
ccccbcdaaccacab	FALSE
cccccaaabadbaad	FALSE
cdbbbcdbbdcdbab	FALSE
cdbbbdcbdbbbaab	FALSE
cddddbdaaddabdb	FALSE
cddddbdbdddbcab	FALSE
daccbcbdbdbaabb	FALSE
daccbdcdcacdcab	FALSE
dbbaacbdcbccbab	FALSE
dbbaadbabadcaba	FALSE
dbdcaaadddbdcab	FALSE
dbdcaacaabcccbb	FALSE
dccaddaacddadab	FALSE
dccaddabacccaad	FALSE
ddbacbbdbccaaab	FALSE
ddbacbcdddcbcab	FALSE
aaaaaacbaaadbdca	TRUE
aaaaaaccacddcbcd	TRUE
aacbcaacbbdcbacc	TRUE
aacbcacadbacacad	TRUE
aaddbccbccccbbba	TRUE
aaddbddddbdacbcb	TRUE
acbddbdcaacaacda	TRUE
acbddbdcdccccaac	TRUE
acddbaaddacbdcad	TRUE
acddbadbcdcbdbcb	TRUE
adbdadcacaacacad	TRUE
adbdadccbbaadadc	TRUE
addcdaccaadbadda	TRUE
addcdacdcbaccbad	TRUE
baccdcbccdadbaaa	TRUE
baccddbaccbdddda	TRUE
bbadbbbbacbbbcdc	TRUE
bbadbccdbddbdbcc	TRUE
bbdadadcdaddadaa	TRUE
bbdadaddddbcadba	TRUE
bcbdbbddadcacdac	TRUE
bcbdcacaadacdccd	TRUE
bdacbaaaadaccdbb	TRUE
bdacbaddacdadbba	TRUE
bdcdacbdbdccbcdd	TRUE
bdcdaccacdcadcdb	TRUE
cacbbdcaddcbadba	TRUE
cacbbddaaaadbbdd	TRUE
cadddaacbbddadba	TRUE
cadddacbbdcbbacb	TRUE
cbccacbbbbadcbdb	TRUE
cbccaccbcaacadca	TRUE
ccbacdcdcbbaaaac	TRUE
ccbacddadaacacac	TRUE
ccdcdbbddccdbaac	TRUE
ccdcdbddbbacbdba	TRUE
cdcadbbcacccaaad	TRUE
cdcadcdadccaacdb	TRUE
daacccaacccdccdd	TRUE
daaccccdccdcbbdb	TRUE
dadbdaddaaacdacd	TRUE
dadbdbadcdccbcaa	TRUE
dbbcaaccbbbbbdac	TRUE
dbbcaacdccbbbdca	TRUE
dcaacadcaaaacdbc	TRUE
dcaacadccacdadbc	TRUE
dccbcdacbdbaadbb	TRUE
dccbcdadbadbccdd	TRUE
ddadddcbcdcdadca	TRUE
ddbaaacaaccadacc	TRUE
aaaaababaaaccbcc	FALSE
aaaaabababaaddca	FALSE
aacbccacaadcadab	FALSE
aacbccbabcccdbbc	FALSE
abbacbcbaacbaacd	FALSE
abbacbdbcadbddda	FALSE
abdcbaacbbdccccd	FALSE
abdcbbddaccdcdaa	FALSE
accacacdbabdaddb	FALSE
accacccdbaaddbab	FALSE
adaddaaaacbdadab	FALSE
adaddbaadacabaca	FALSE
addcadaadbacdaab	FALSE
addcadbabcbadbcd	FALSE
bacbaddbddcaacab	FALSE
bacbbacdcbcbbbab	FALSE
bbadbbabbbcdcbaa	FALSE
bbadbbbddbdbccab	FALSE
bbdacbdabadbdbcc	FALSE
bbdaccdbbbccddab	FALSE
bcbdbbddadcabdab	FALSE
bcbdcabbdadabdcc	FALSE
bdabccabbbadbcaa	FALSE
bdabcdbcaccdbbaa	FALSE
bdcdabbdbdccbcdd	FALSE
bdcdabcabdcadcdb	FALSE
cabcdbadcbdbdadc	FALSE
cabcdbccbdbdbcdb	FALSE
caddcbababbbbdda	FALSE
caddcbabbdbabbdc	FALSE
cbccacbbbbadcbab	FALSE
cbccacdbcaabadca	FALSE
ccbaccdcbaaabbaa	FALSE
ccbaccdcddaacaab	FALSE
ccdcdbbddccdbaab	FALSE
ccdcdbddbbacbdab	FALSE
cdcadbaccaaadabc	FALSE
cdcadbcdcbcdbcab	FALSE
daacbddcdcddcbab	FALSE
daaccccbbbdbabab	FALSE
dadadbdcaadbadab	FALSE
dadadcadbaddaabc	FALSE
dbbcaaddccbbbbab	FALSE
dbbcabacbbbdcabd	FALSE
dcaaccbaaddbcdab	FALSE
dcaacddcdbacbdab	FALSE
dccbcdabbdbaacbb	FALSE
dccbcdadbacbccab	FALSE
ddaddcdbcdcdadab	FALSE
ddbaaabbabbcacac	FALSE
aaaaaaaaacccbdbca	TRUE
aaaaaacbbaccaaacd	TRUE
aacbcdbcbdacdbddb	TRUE
aacbdaaacbcddadaa	TRUE
aaddadbcbdaacdacd	TRUE
aaddbbaddaccaddac	TRUE
acbbcddbdbdbbdddb	TRUE
acbbdbcdddcaadadd	TRUE
acdbcddadcdcbbadd	TRUE
acdbcdddbcdcaaacb	TRUE
adbbbbbdaacbcddbc	TRUE
adbbbbddcdddacdcd	TRUE
addaddbbadcbcacac	TRUE
addaddbbbacccaaaa	TRUE
bacacdbdaadbbbbca	TRUE
bacacdbdccddaddaa	TRUE
bbacbdcbcccddcbcb	TRUE
bbacbddddbacadaaa	TRUE
bbcdcaaddbadacbac	TRUE
bbcdcacadbddbbaaa	TRUE
bcbcaddaacbcdbdcb	TRUE
bcbcadddadccbdbdc	TRUE
bdaaaddcbbcbdbbcc	TRUE
bdaacaaddbacbccca	TRUE
bdcdaaadcdcdccbcd	TRUE
bdcdacdcbdcdbbdcd	TRUE
cacacaaadaaadaaaa	TRUE
cacacaadbbacdbdac	TRUE
caddbadacbccdcaaa	TRUE
caddbbbbacbddbddd	TRUE
cbcbdacddddcdddda	TRUE
cbcbdbdccadcaaadd	TRUE
ccbaacdaaaadbcaac	TRUE
ccbaadcbcbbddaccb	TRUE
ccdbdacdcdbaaaddb	TRUE
ccdbdbbacadcaaacd	TRUE
cdcacaddacccacdad	TRUE
cdcacccbdaaaaaccc	TRUE
daacaadacdbdcddca	TRUE
daacaaddccccbaadd	TRUE
dadbbbbcdadbdcadb	TRUE
dadbbcdcbddcddbcb	TRUE
dbbcbdbdbbcadacac	TRUE
dbbcbdcadcaddcbca	TRUE
dcaadbddcbacbbbcc	TRUE
dcaaddaaacbcaccba	TRUE
dccdcbdddcacbdbdd	TRUE
dccdccbaadbaaaaca	TRUE
ddbcaaacdacbdaadb	TRUE
ddbcaccbcdccccbaa	TRUE
aaaaaadddbddaadab	FALSE
aaaaacbabcdbbdadb	FALSE
aaccccddacdddbaba	FALSE
aacccdbcaddabdaaa	FALSE
abbabddaaabaacbda	FALSE
abbabdddaccbbcbda	FALSE
acaaaadccdbbcdcab	FALSE
acaaabcabdcbdcdad	FALSE
accdaccabddcabaad	FALSE
accdbabacadcdcdba	FALSE
adbcaccbaccdaaaab	FALSE
adbcadbbabdbbdbdd	FALSE
baaadabdbdaabaacb	FALSE
baaadabddcdccdadd	FALSE
baccacbadbbcaccab	FALSE
baccacbbbdcbaacab	FALSE
bbbbcaadccdbbcbab	FALSE
bbbbdacbdddabddca	FALSE
bbdddbbdbbabaadbc	FALSE
bbdddcdbbcbdccbab	FALSE
bccbcdadbbbcaacab	FALSE
bccbdcddccbddccab	FALSE
bdaccaaaabacbdbdc	FALSE
bdaccbacdddcadbab	FALSE
bddaadadbbacadabd	FALSE
bddabbbbdccaaadbc	FALSE
cabdbcdbbdbbcddca	FALSE
cabdbdacbbccbbaab	FALSE
cbaabdaacdccddadb	FALSE
cbaabdcadbaabddca	FALSE
cbcbbacccdbacbcab	FALSE
cbcbbadabcdadcccd	FALSE
ccadcbcbdbcacbaab	FALSE
ccadcdbabdabaacac	FALSE
ccdbdbcddaabbcbcb	FALSE
ccdbdcaaddcdacbab	FALSE
cdcaaaabbaccbacdd	FALSE
cdcaacbcabbcccaba	FALSE
daacccdaadcacccab	FALSE
daacccdcabcddddba	FALSE
dadbbcddcacabadcd	FALSE
dadbbdaadacbaacab	FALSE
dbcacbbdbabdbddbd	FALSE
dbcaccacbacdaddab	FALSE
dcacacccaadcbcbab	FALSE
dcacacdccbcdbaaab	FALSE
dccdcdccddcbbbbab	FALSE
dccddadbbbdbbbdab	FALSE
ddbcbbbbdadbdadab	FALSE
ddbcbbdddcccddcab	FALSE
aaaaaaadbaacadcbdc	TRUE
aaaaacaadbdcaadbca	TRUE
aaccadcdaaadbbbdaa	TRUE
aaccadcddaaaadcada	TRUE
aaddcdddadcdcbccdd	TRUE
aadddaaccddbbbbaad	TRUE
accacddcbbdccaacdd	TRUE
accadbacdcdaaacbbb	TRUE
adaaacbccaadbbbbac	TRUE
adaaacbccbaaadddcb	TRUE
adcacacbcdcaddacda	TRUE
adcacacdbaacddbbcc	TRUE
baaacbddcbaadbcdad	TRUE
baaaccacccbcddcaac	TRUE
badaccacccacbbbadb	TRUE
badaccadbacadbbbbd	TRUE
bbbbbcdbdcbdaaadcd	TRUE
bbbbbdaaacddadcdaa	TRUE
bbddacdadcaaadcaaa	TRUE
bbddbaaacbcbadcdcd	TRUE
bccbbbbbccbaaadada	TRUE
bccbbbbdbadcaaaada	TRUE
bdadacdaccbadcbcaa	TRUE
bdadadacbddacdbbdc	TRUE
bddaacdadbbdaadbcd	TRUE
bddaacdbaaddcacada	TRUE
cacaadaaaadacadadd	TRUE
cacaadaccbcacaadaa	TRUE
cbaacbbdbdbadacbca	TRUE
cbaacbccbadddbadaa	TRUE
cbccaadddadcdccccc	TRUE
cbccacbcadbacaaccb	TRUE
ccbbbccbbcdbacdbca	TRUE
ccbbbdcadbcdbcbbca	TRUE
ccddddacaccaaacccd	TRUE
ccddddcddbdddbaada	TRUE
cdcadbbcdacadadbcb	TRUE
cdcadcaccccaddaadb	TRUE
daacbaacaaaaaccccd	TRUE
daacbadbaddacaaddc	TRUE
dadbdddbcaaaadddcd	TRUE
dadbdddcadcacaccdd	TRUE
dbbddadadacdbdcdaa	TRUE
dbbddadbbaacaacbbb	TRUE
dcaadadddcbddcacbb	TRUE
dcaadbaaaadccbadba	TRUE
dccccbcaaccddacadb	TRUE
dccccbcbbaaadcccdd	TRUE
ddbbdcbccadccdadcb	TRUE
ddbbdccaaaccacdcac	TRUE
aaaaaaaaccadcbbdab	FALSE
aaaaaaccbbdabccaba	FALSE
aaccacbbadaabbbdad	FALSE
aaccacbbbcdaaabadb	FALSE
abbabcdccbcccdbbbc	FALSE
abbabdbbcaaddcdccc	FALSE
abdcaddbdbdaaddbcb	FALSE
abdcbacddadaccdbaa	FALSE
accaadadcabbdcbdcd	FALSE
accaaddcbbbddadcab	FALSE
adacbbacdcacccbabc	FALSE
adacbbacdcdcccddab	FALSE
adcdbddadbcaaaddab	FALSE
adcdcabbcbbdabdcac	FALSE
babcabcdbbcbdacbbc	FALSE
babcaccabaadcbcbab	FALSE
bbabaaddbdcadacbca	FALSE
bbabacaccbdddbccac	FALSE
bbccdcbcbbabdadbab	FALSE
bbccdcdaabdcbdcaba	FALSE
bcbbddaaacdadacbab	FALSE
bcbbdddbcbccdaccab	FALSE
bcdcdbbbbaabaadbdd	FALSE
bcdcdbcdbcaacabdcd	FALSE
bdcccddcdaabdbcbad	FALSE
bdccdbcaaabbcabdca	FALSE
cabadaccbacadbaacb	FALSE
cabadaddddbaacccda	FALSE
cadcddbcbaadacacab	FALSE
cadcddcbddbccbaabd	FALSE
cbcbabcbccdbadcbaa	FALSE
cbcbabdcaababaaccc	FALSE
ccadbabaacadaccbab	FALSE
ccadbacccdcccdbdab	FALSE
ccdadccccabadcdbbd	FALSE
ccdadcdbdbcbadddab	FALSE
cdbdacbdccabdcbbbd	FALSE
cdbdacbddaacababac	FALSE
daaabdaacdcbaaccbc	FALSE
daaacaadcabbcadbdc	FALSE
dacdacdcbddbbaaabc	FALSE
dacdbadccbdabcaccc	FALSE
dbbcbbbbbbbbcacbab	FALSE
dbbcbbdaadbcbccdab	FALSE
dcaaccbbababbdaccc	FALSE
dcaaccbdddaabacdab	FALSE
dccccabbbbadccacdb	FALSE
dccccadbdabcdaaddc	FALSE
ddbbccacbcbcaddcab	FALSE
ddbbcdacabbcbabddd	FALSE
aaaaaaaaaadddbbcccd	TRUE
aaaaaadaccdadcacadc	TRUE
aaccbbbdbbdbadaacdc	TRUE
aaccbbcdcaadadcdcbc	TRUE
aaddbcaaddcccdaacda	TRUE
aaddbcdcdcbcaccadbb	TRUE
acbbdcbaaddddadbaad	TRUE
acbbdcccdbbbaaaaadc	TRUE
acdbccddcdbdaaaacba	TRUE
acdbcdaaadbaaaadbaa	TRUE
adbbcdaadddcddaaaac	TRUE
adbbcdbadbaddcbaacb	TRUE
addbdccdccbcddaddad	TRUE
addcacacddbccdcccbb	TRUE
bacbacbbaccbdbacadc	TRUE
bacbacbccbdacdccccb	TRUE
bbaadbdcddcbccadbcd	TRUE
bbaadcacacdccbadacd	TRUE
bbcdaaadbadbbaccbac	TRUE
bbcdaaadcbbccbdddad	TRUE
bcbbbadcccaadbacbac	TRUE
bcbbbdcbdaaadaddbbb	TRUE
bcddddbccaaacddccdd	TRUE
bdaaaaaadddadbbcdca	TRUE
bdcbdaaaadcbadbaacb	TRUE
bdcbdacaddbdcaaaacb	TRUE
caadbccbdbbadcbcdac	TRUE
caadbdaaaaccbaaccbb	TRUE
cadccaadbcaadbcaccd	TRUE
cadccdbcdcccbbbaaaa	TRUE
cbcbcaddbbdbbbaddbc	TRUE
cbcbcaddddbcddaaada	TRUE
ccbaaddbaaaaaaccdcd	TRUE
ccbaaddccbcbccdcadb	TRUE
ccdbddadaadaadcdbdd	TRUE
ccdbddbbbbbbdadbdbb	TRUE
cdbdddbddddbccbccbd	TRUE
cdbdddddacaaadbdccc	TRUE
daacadddddcbbdacdbb	TRUE
daacbaaccbdcbcbdbaa	TRUE
dadbdaaaddddaacbcaa	TRUE
dadbdbccddbdaadbacc	TRUE
dbcacbadcbdbbddacba	TRUE
dbcacbbdaadbcadcadb	TRUE
dcacdddacbaaadadacc	TRUE
dcacdddbdacdaddbcbd	TRUE
dcdaddcbbbcbcbcddba	TRUE
dcdbaadbcaadbacbaad	TRUE
ddbccaaadadccdacaad	TRUE
ddbccbccbdcacbbaccb	TRUE
aaaaaaacbacdabaaccb	FALSE
aaaaaacacdcddadbaab	FALSE
aaccbaacbbaccbaaabb	FALSE
aaccbadaadcacdddaab	FALSE
abbbbbacadaddcddaaa	FALSE
abbbbcdacdabddaaccd	FALSE
acaaabddcaabaaacadc	FALSE
acaaacabaadaddacaad	FALSE
accbdcbbbcdabccaaba	FALSE
accbdccabaabcacccac	FALSE
adbabbabadcdddacabb	FALSE
adbabbacbcdabccdcbb	FALSE
addcacbabdbccdbbaab	FALSE
addcadcaacdddccbdab	FALSE
bacbadadaabaaddbddc	FALSE
bacbadbadbbaaadabab	FALSE
bbadabcacdacdcbbacd	FALSE
bbadacbacabbcabbbcd	FALSE
bbdaddaaadcadddbcab	FALSE
bbdbaacdabdbbaaddcb	FALSE
bcbcdbbbccdcdddaaab	FALSE
bcbcdcacacdcddadcab	FALSE
bdaaddbacabbdacabda	FALSE
bdababccdaabcadbbca	FALSE
bdccbbcdabaadadadbc	FALSE
bdccbcaaabcddacdcbb	FALSE
caadccbddadcaabacba	FALSE
caaddadcdccbbbccaab	FALSE
cadbaaccbacaadbdabd	FALSE
cadbaaddcaccbcdbcab	FALSE
cbbdcbcabccbdacdbdd	FALSE
cbbdccbbadabdcdaddd	FALSE
ccabcddbdbaabdcccac	FALSE
ccacaacaadaccdbbbab	FALSE
ccdaabaabbbdbdcdccd	FALSE
ccdaababccbaabcdaab	FALSE
cdbdabbcdccadddcadb	FALSE
cdbdacccbdbcaddbbab	FALSE
daabcccdcccdacdbcca	FALSE
daabccdbbccdbdbcdcc	FALSE
dadabadbbaadddbbabc	FALSE
dadabcbdacbcbbbddcc	FALSE
dbbdbbdacccbacabcbc	FALSE
dbbdbbddbacaccaadab	FALSE
dcaadddcdcbdbccbcab	FALSE
dcababacbbdccbdddab	FALSE
dcccccdddabddbcaddb	FALSE
dccccdabadccdabcdda	FALSE
ddbbbadaaaacdbdadab	FALSE
ddbbbbaaaaccbdaddab	FALSE
