adadadadad	TRUE
adadadadad	TRUE
adadcdadcd	TRUE
adadcdbccd	TRUE
adbbcbcbdc	TRUE
adbbcbdbad	TRUE
adcadadada	TRUE
adcadadada	TRUE
adcccbdbad	TRUE
adcccbdbbc	TRUE
addbbbadad	TRUE
addbbbbbcc	TRUE
addddcadad	TRUE
addddccccc	TRUE
badcbdcada	TRUE
badcbdccad	TRUE
bbadddadcb	TRUE
bbadddaddb	TRUE
bbdbbadddd	TRUE
bbdbbbadbd	TRUE
bcbcdbccdb	TRUE
bcbcdcadad	TRUE
bdadbbcadb	TRUE
bdadbbcadc	TRUE
bdcdcccadc	TRUE
bdcdcccbbb	TRUE
cadbcbccda	TRUE
cadbcbdada	TRUE
caddddcada	TRUE
caddddcbdd	TRUE
cbcdbddddc	TRUE
cbcdcbcddb	TRUE
ccbbcdbbad	TRUE
ccbbcdcada	TRUE
cdadadbadb	TRUE
cdadadbbad	TRUE
cdcbcadcca	TRUE
cdcbcaddbc	TRUE
dadaddadcd	TRUE
dadaddaddd	TRUE
daddcadbcb	TRUE
daddcadddb	TRUE
dbcadbbbda	TRUE
dbcadbcada	TRUE
dcadadddbc	TRUE
dcadaddddb	TRUE
dccdcadcbd	TRUE
dccdcbdbcd	TRUE
ddbbcdadbd	TRUE
ddbbdadbad	TRUE
aaaaaabcdb	FALSE
aaaaabadbb	FALSE
aaccadccaa	FALSE
aaccbaccdd	FALSE
abbaacabcd	FALSE
abbaacbcca	FALSE
abdbdcbbdd	FALSE
abdbdcdddc	FALSE
accbaacbca	FALSE
accbaadcca	FALSE
adbadcaaba	FALSE
adbadcdbaa	FALSE
adddcbbbaa	FALSE
adddccdcaa	FALSE
bacbdadbbd	FALSE
bacbdbadcc	FALSE
bbaddcabbc	FALSE
bbaddcabcd	FALSE
bbdbbabddd	FALSE
bbdbbbaabd	FALSE
bcbcdbccab	FALSE
bcbcdcadab	FALSE
bdabcbdccc	FALSE
bdabccbaab	FALSE
bdcdcccacc	FALSE
bdcdcccbab	FALSE
cabcbbabac	FALSE
cabcbdbcdd	FALSE
cadddbcbab	FALSE
cadddcaacd	FALSE
cbcdbdddab	FALSE
cbcdcbcdaa	FALSE
ccbbcdbbac	FALSE
ccbbcdcaaa	FALSE
cdaaadccca	FALSE
cdaabacbda	FALSE
cdcbcacbaa	FALSE
cdcbcadbac	FALSE
dabaadbabb	FALSE
dabaadccab	FALSE
dadcaacddd	FALSE
dadcaccbba	FALSE
dbcabcbcad	FALSE
dbcabdabab	FALSE
dcaaddcabb	FALSE
dcaaddccdd	FALSE
dccdcadabd	FALSE
dccdcbdbaa	FALSE
ddbbcdadac	FALSE
ddbbdaabad	FALSE
adadadadadd	TRUE
adadadadadd	TRUE
adadcdadddc	TRUE
adadcdbccdc	TRUE
adbbcdadbda	TRUE
adbbcdbdadb	TRUE
adcadadadad	TRUE
adcadadadba	TRUE
adcccccbbad	TRUE
adccccdaddc	TRUE
addbbdadadd	TRUE
addbbdadcbb	TRUE
adddddbdcbb	TRUE
adddddcadcb	TRUE
badccadbadd	TRUE
badccaddccb	TRUE
bbbadadddad	TRUE
bbbadbadcbb	TRUE
bbdbdcaddbc	TRUE
bbdbdcbbdcc	TRUE
bccadadccdb	TRUE
bccadaddbbc	TRUE
bdadbbadadc	TRUE
bdadbbadadd	TRUE
bddaddbdccd	TRUE
bddaddccdcc	TRUE
cadbcdcdbbd	TRUE
cadbcdcddcb	TRUE
cbadbaddadc	TRUE
cbadbaddcba	TRUE
cbccdaddbda	TRUE
cbccdccadbc	TRUE
ccbbcbadbdd	TRUE
ccbbcbbdadc	TRUE
ccddadcdadd	TRUE
ccddaddadbd	TRUE
cdccbadcbad	TRUE
cdccbbcbadb	TRUE
dadaddbbbad	TRUE
dadaddbbbdd	TRUE
daddaddbcdc	TRUE
daddadddadb	TRUE
dbbcadccbbb	TRUE
dbbcaddadad	TRUE
dbddcaddadd	TRUE
dbddcbadbdc	TRUE
dcccadbddbb	TRUE
dcccadcadcd	TRUE
ddbadbcdcad	TRUE
ddbadbdadcb	TRUE
aaaaaacccbd	FALSE
aaaaaacdaca	FALSE
aaccabdaabd	FALSE
aaccabdacaa	FALSE
abaccbcaacd	FALSE
abacccbcdba	FALSE
abdbdcbcbcd	FALSE
abdbdccbdaa	FALSE
accacaccccb	FALSE
accacadabda	FALSE
adadcbadcac	FALSE
adadcbbabcc	FALSE
addbbdcabad	FALSE
addbbdcabca	FALSE
babddaabdba	FALSE
babddcacbdd	FALSE
bbabcaddcab	FALSE
bbabcbcdcca	FALSE
bbcdbbbdaab	FALSE
bbcdbbcaccb	FALSE
bcbccbccbaa	FALSE
bcbccbdadaa	FALSE
bcddbcccbab	FALSE
bcddbdcdbac	FALSE
bdcadbccaad	FALSE
bdcadcabdcd	FALSE
caacddbdcda	FALSE
caacddcccad	FALSE
cadbddbdaac	FALSE
cadcacbdbbd	FALSE
cbbdccdbdac	FALSE
cbbddbadcab	FALSE
ccadcaaaaba	FALSE
ccadcabcdba	FALSE
ccdbdcdbaac	FALSE
ccdcaababbc	FALSE
cdcaacdadcb	FALSE
cdcaadbbbdb	FALSE
daadcbcdcdb	FALSE
daaddabcdcb	FALSE
dadbbdbbaca	FALSE
dadbcadbdac	FALSE
dbbccdbccab	FALSE
dbbccddbcab	FALSE
dbddbbdaccc	FALSE
dbddbcacdba	FALSE
dcccbabbdad	FALSE
dcccbbccdab	FALSE
ddbadbdcdac	FALSE
ddbbacaabdb	FALSE
adadadadadad	TRUE
adadadadadad	TRUE
adadccbaddba	TRUE
adadcccadbcd	TRUE
adbbbaddddad	TRUE
adbbbbadadcd	TRUE
adcadadbadbd	TRUE
adcadadbaddd	TRUE
adccbaddbbcb	TRUE
adccbaddbcca	TRUE
addaddbbcbad	TRUE
addaddbbdada	TRUE
adddadadddbd	TRUE
adddadbbadad	TRUE
badcadadcadd	TRUE
badcadadccbd	TRUE
bbadcdadadad	TRUE
bbadcdbcdbbb	TRUE
bbdadadbbada	TRUE
bbdadadbdccd	TRUE
bcbcadadaddd	TRUE
bcbcadadddbb	TRUE
bcddddbcbdcb	TRUE
bcddddcadbbc	TRUE
bdcadcadadad	TRUE
bdcadcadbbad	TRUE
cadaddbcbdba	TRUE
cadaddbcdcbc	TRUE
caddbcdbbccb	TRUE
caddbdcbdbbc	TRUE
cbbdddbadcda	TRUE
cbbdddbcadad	TRUE
ccaddaddcbad	TRUE
ccaddadddadc	TRUE
ccdcbccbadcc	TRUE
ccdcbdcbadad	TRUE
cdcadadaddad	TRUE
cdcadaddaddb	TRUE
dadadddbcadb	TRUE
dadadddbcdbc	TRUE
daddcadadadb	TRUE
daddcadadadb	TRUE
dbcadddadbcb	TRUE
dbcbadbadadc	TRUE
dcaddbbcbcda	TRUE
dcaddbcadcdd	TRUE
dcdadccdccca	TRUE
dcdadcdadcad	TRUE
ddbbddccddca	TRUE
ddbbddddcadc	TRUE
aaaaaacccbdd	FALSE
aaaaaacdcabb	FALSE
aacbddadaddd	FALSE
aaccaaabbdab	FALSE
abadaacbadac	FALSE
abadaadadaab	FALSE
abdbbddaaaca	FALSE
abdbcaaacacd	FALSE
accadcbaabdb	FALSE
accadccdcacc	FALSE
adadcddbacdc	FALSE
adaddacddbdb	FALSE
addbbadaadad	FALSE
addbbccbcdab	FALSE
bacaacaabddc	FALSE
bacababdccab	FALSE
bbaccbadbbcc	FALSE
bbacccbdbabb	FALSE
bbdaadabbbcc	FALSE
bbdabbaaaacd	FALSE
bcbcaaababab	FALSE
bcbcaacbaaba	FALSE
bcddddbcbdaa	FALSE
bcddddcacbbc	FALSE
bdcacccaabdb	FALSE
bdcaccdaadac	FALSE
caadaaaacdab	FALSE
caadaabddcdc	FALSE
cadbccadccab	FALSE
cadbccadddac	FALSE
cbbdddbaccda	FALSE
cbbdddbcacab	FALSE
ccadbbcbccac	FALSE
ccadbbcddabc	FALSE
ccdcbccbabcc	FALSE
ccdcbdcbabab	FALSE
cdcaacbbbddb	FALSE
cdcaaccdabbb	FALSE
daaddbcbccab	FALSE
daaddbdbcccd	FALSE
dadbccccdcab	FALSE
dadbcddddcaa	FALSE
dbcadddacbcb	FALSE
dbcbaaacabad	FALSE
dcacdcdbdbca	FALSE
dcacdcdccddd	FALSE
dcdadbadccaa	FALSE
dcdadbcbadaa	FALSE
ddbbddccddaa	FALSE
ddbbddddcaac	FALSE
adadadadadbba	TRUE
adadadadadbbd	TRUE
adadccadcdbbd	TRUE
adadccaddadcc	TRUE
adbbbadaddbdb	TRUE
adbbbadadddda	TRUE
adbdbdccbbdba	TRUE
adbdbddadbdda	TRUE
adccadcbcdddc	TRUE
adccadcbdcbbc	TRUE
addadcbcdadbd	TRUE
addadccadadad	TRUE
adddcbadccbbb	TRUE
adddcbbbbdadb	TRUE
badcadcbdcadb	TRUE
badcadcccadba	TRUE
bbadcbbaddbdd	TRUE
bbadcbdadcbcd	TRUE
bbdadcadccbcb	TRUE
bbdadccbcadcc	TRUE
bcbbddbcbdadd	TRUE
bcbcadbadcccb	TRUE
bdadbbadbbadd	TRUE
bdadbbbdcccda	TRUE
bdccdcccdcccd	TRUE
bdccdcdbcbada	TRUE
cadbadbdbdbcb	TRUE
cadbadbdcadad	TRUE
caddccdaddbda	TRUE
caddccdbdddda	TRUE
cbcbccdbcadcd	TRUE
cbcbcdcbbdadb	TRUE
ccaddadcbaddb	TRUE
ccaddadcbdadb	TRUE
ccdbaddcadadb	TRUE
ccdbaddcdcadd	TRUE
cdcadbaddccad	TRUE
cdcadbbcbadbd	TRUE
dadadbdadbbdb	TRUE
dadadbdbcdbdc	TRUE
dadcdbcadbadd	TRUE
dadcdbcbdcbad	TRUE
dbbaddbbbcadc	TRUE
dbbaddbcbbdcc	TRUE
dbddadcdcbddc	TRUE
dbddaddbccdda	TRUE
dccbdadbcadca	TRUE
dccbdadcbbcbc	TRUE
ddbbbdbaddbdd	TRUE
ddbbcaddaddad	TRUE
aaaaaaabadacd	FALSE
aaaaababccccc	FALSE
aaccdddbdbdaa	FALSE
aacdacbccddab	FALSE
abbcbdcdabdac	FALSE
abbccacacaacd	FALSE
acaaadaacdaca	FALSE
acaaadcbbdbdb	FALSE
accccdcacbbab	FALSE
accccdccdadbb	FALSE
adbabaabbdcbc	FALSE
adbabbacadcca	FALSE
addbcdcbcdbac	FALSE
addbdabaccccb	FALSE
bacacdcbdaddd	FALSE
bacadaccaadda	FALSE
bbacddbdbbdaa	FALSE
bbadaabbcbbcb	FALSE
bbdacbcacccaa	FALSE
bbdacbcdacbbc	FALSE
bcbbddbcbdacd	FALSE
bcbcababccbaa	FALSE
bdabbccababab	FALSE
bdabbdcbbdbbc	FALSE
bdccdcccdccac	FALSE
bdccdcdbcbaaa	FALSE
cabaacbdcddab	FALSE
cabababcdaabc	FALSE
cadccbcdaddaa	FALSE
cadccbdbbadac	FALSE
cbcbccdbcadac	FALSE
cbcbcdcbbdabb	FALSE
ccacdddbcaccb	FALSE
ccacdddbcbddc	FALSE
ccdbacccdccad	FALSE
ccdbadcadcabd	FALSE
cdcabadadddca	FALSE
cdcabbacabddb	FALSE
daabbacbabdcc	FALSE
daabbbadddaba	FALSE
daccdccbbcdba	FALSE
daccdccdcbbda	FALSE
dbbadacbddbcb	FALSE
dbbadacdbcbcd	FALSE
dbddadcabddca	FALSE
dbddadccccdaa	FALSE
dccbdaccccabc	FALSE
dccbdacddbbcb	FALSE
ddbbbdbaddbac	FALSE
ddbbcaaddcbad	FALSE
adadadadadcbcc	TRUE
adadadadaddada	TRUE
adadccadcadada	TRUE
adadccaddbcada	TRUE
adbbadadadccad	TRUE
adbbadadadccbc	TRUE
adbdbcdbbbbada	TRUE
adbdbdadbbccad	TRUE
adccadbbadcdca	TRUE
adccadbbbadcba	TRUE
addadadcdbddbd	TRUE
addadaddadddbd	TRUE
addcdbaddddbba	TRUE
addcdbbaddaddd	TRUE
badbbdadaddcad	TRUE
badbbdbccdddbb	TRUE
bbadadadadcdad	TRUE
bbadadadbccdad	TRUE
bbcbdddcadaddc	TRUE
bbccadbbbdadbc	TRUE
bcbadcadadcdcc	TRUE
bcbadcadbaddcd	TRUE
bcdccbaddbaddd	TRUE
bcdccbdbccadcb	TRUE
bdcaddcdbcdadb	TRUE
bdcbadaddddbad	TRUE
cadaddbdbcadad	TRUE
cadaddbdbcaddc	TRUE
caddbccdcccbbd	TRUE
caddbdadcbbbad	TRUE
cbcbdadbaddbba	TRUE
cbcbdadbbbbadc	TRUE
ccadddadbcbcbc	TRUE
ccadddbdcdaddd	TRUE
ccdbbcddcbddcd	TRUE
ccdbcbdadadada	TRUE
cdbdddbcccddad	TRUE
cdbdddcadbbcad	TRUE
dadadbadadadba	TRUE
dadadbadadddbb	TRUE
daddadbbadddbc	TRUE
daddadbcadcbca	TRUE
dbbdadbadcadcb	TRUE
dbbdadcadadddb	TRUE
dcadbdcddbcbca	TRUE
dcadbddadccbba	TRUE
dccdcdbccccbbc	TRUE
dccddaddbbbadd	TRUE
ddbcdadbaddcbc	TRUE
ddbcdbbcadadba	TRUE
aaaaaaacacbcbb	FALSE
aaaaabdcdbccbd	FALSE
aacccbddbabbdb	FALSE
aaccdacdbadaca	FALSE
abbadacaccdcac	FALSE
abbadbaccacbdc	FALSE
abddaabbdabaaa	FALSE
abddaacdbcddbb	FALSE
accabddacaabaa	FALSE
accacadcbacdbc	FALSE
adacbabddbdacc	FALSE
adacbbabcacccc	FALSE
adcdcbcbadbcac	FALSE
adcdcbccacbccd	FALSE
babcbbbbadaccd	FALSE
babcbbbbbcdbca	FALSE
bbaaaaddcabbba	FALSE
bbaaadabcaaabd	FALSE
bbcbdddcabaddc	FALSE
bbccabcdbbbdac	FALSE
bcbabacdadbdaa	FALSE
bcbabcaabbdaac	FALSE
bcdccbabdbacdd	FALSE
bcdccbdbccaccb	FALSE
bdcaddcabcdacb	FALSE
bdcbaaacdddbab	FALSE
caaccdaddacbda	FALSE
caacdbaaacbddb	FALSE
cadbbdacabbadd	FALSE
cadbcbdbcaaddb	FALSE
cbcbdabbacdbba	FALSE
cbcbdabbbbbacc	FALSE
ccaddabbbdaccb	FALSE
ccaddadbbcadac	FALSE
ccdbbcddcbddac	FALSE
ccdbcbdabacaca	FALSE
cdbdddbcccddab	FALSE
cdbdddcacbbcab	FALSE
daaabdcababbdd	FALSE
daaabddaabbbbd	FALSE
dacdcdaadccbaa	FALSE
dacdcdcaadcbda	FALSE
dbbdabcbcdaacb	FALSE
dbbdabccdadcac	FALSE
dcacaaabdababc	FALSE
dcacaacabcdddb	FALSE
dccdcdbccccbab	FALSE
dccddaaadadbba	FALSE
ddbcdadbaadcbc	FALSE
ddbcdbbcacabba	FALSE
adadadadadadadd	TRUE
adadadadadadadd	TRUE
adadcbcccddbbad	TRUE
adadcbccddcbddd	TRUE
adbaddbdddcadba	TRUE
adbaddccdbadcad	TRUE
adbdbcdcadcbdcb	TRUE
adbdbcdcccbcadd	TRUE
adccaddaddbbadd	TRUE
adccaddcbaddadc	TRUE
addadcccbbcaddd	TRUE
addadccdadddadc	TRUE
adddaddbaddbddb	TRUE
adddaddcadcadcb	TRUE
badbdbbcdaddcbc	TRUE
badbdcbbdadcdad	TRUE
bbadbdbbbbcbbcb	TRUE
bbadbdcbcdcccca	TRUE
bbdadaddccdbadc	TRUE
bbdadbadadadcbb	TRUE
bcbbcadadcadbbd	TRUE
bcbbccccadcdadd	TRUE
bdadadddcdadadb	TRUE
bdadbadadadbadd	TRUE
bdcdbaddcdbaddd	TRUE
bdcdbbccadbdbad	TRUE
cadbbcdbdaddada	TRUE
cadbbdadadaddad	TRUE
cadddccbaddadba	TRUE
cadddccdcddcadc	TRUE
cbccdadadadbdcb	TRUE
cbccdadccadbada	TRUE
ccbadadcbbddadd	TRUE
ccbadadcbbddcca	TRUE
ccdbbdccadddcda	TRUE
ccdbbdcddcaddbb	TRUE
cdcbadbadcaddbd	TRUE
cdcbadbdbdadadc	TRUE
dadadcdbbdcbdcb	TRUE
dadadcddcbcdbbc	TRUE
dadcddcdcddcbbd	TRUE
dadcdddddcbadad	TRUE
dbbccddcbccbadd	TRUE
dbbcdadcadccbcc	TRUE
dcadadbdcdccadc	TRUE
dcadadbdddbbcdd	TRUE
dcccadddcdbbada	TRUE
dcccbbbdadcbbdb	TRUE
ddbadaddcadccca	TRUE
ddbadbbaddadcad	TRUE
aaaaabddcdcbabb	FALSE
aaaaacbdbbacbbb	FALSE
aacdccbcaccccaa	FALSE
aacdcdaccaaaccd	FALSE
abbbaaddcdbaaab	FALSE
abbbabbccbaabbd	FALSE
abdccdcdbbcbdcd	FALSE
abdcdbcdcdaaacd	FALSE
accbaadcacdcdbc	FALSE
accbabaadabaaab	FALSE
adacbddaabbadad	FALSE
adaccaddacbdabd	FALSE
addadcbabcbddca	FALSE
addaddccddacbdb	FALSE
bacacdacdbcdcac	FALSE
bacadacadacbaad	FALSE
bbabcdcabaacdcb	FALSE
bbabdbacddbbdac	FALSE
bbdaacbcdadbbac	FALSE
bbdaacddbdbcaba	FALSE
bcbbcadabcaabbd	FALSE
bcbbccccaccdaad	FALSE
bdaadbddcadadab	FALSE
bdaaddcdbdbdcda	FALSE
bdcdbaddbdbabdd	FALSE
bdcdbbccaadddba	FALSE
cabbddccacadaac	FALSE
cabbdddcbbbccbb	FALSE
caddbccbcbcabaa	FALSE
caddbcdbabddcdd	FALSE
cbccdacdcdadbdc	FALSE
cbccdadbcadbaca	FALSE
ccbaadacadabdad	FALSE
ccbabbccadabaab	FALSE
ccdbbdccadddcaa	FALSE
ccdbbdcddcaddaa	FALSE
cdcbadbaacaadbd	FALSE
cdcbadbdbdaaadc	FALSE
daadabcddbddada	FALSE
daadacacacacbbb	FALSE
dadacbccccaacad	FALSE
dadacbddcdcdddb	FALSE
dbbccddcbccbacd	FALSE
dbbcdabcadccbcc	FALSE
dcaacacabcdcaad	FALSE
dcaacbbcdaabdbc	FALSE
dcccadadcdbbaba	FALSE
dcccbbbdabcbbdb	FALSE
ddbaadadbdcabdc	FALSE
ddbaaddabcbadbb	FALSE
adadadadadadcdca	TRUE
adadadadadbadcdd	TRUE
adadcbccdcddbbdb	TRUE
adadcbdaddbbccbb	TRUE
adbaddcdadadadcd	TRUE
adbaddcdaddcadad	TRUE
adbdcaddadadbddc	TRUE
adbdcaddbdbddada	TRUE
adcbdbbadbadbddb	TRUE
adcbdbbadbdbbdbd	TRUE
addadcadadcdbbba	TRUE
addadcadadcdbbcc	TRUE
addcdcbaddadadba	TRUE
addcdcbdbcbadddb	TRUE
badbbdbbdbcbbbda	TRUE
badbbdcadbbbccad	TRUE
bbadadaddcdbcada	TRUE
bbadadbadaddcdbc	TRUE
bbcdadadcdaddadd	TRUE
bbcdadbcadbadbcc	TRUE
bcbbadbccadcbccb	TRUE
bcbbadbcddccccad	TRUE
bcddadbdcdadccca	TRUE
bcddadccdcbadbad	TRUE
bdcbbbadbbadbdcc	TRUE
bdcbbbbccdbcdcdb	TRUE
cadaddbdbbdadadb	TRUE
cadaddcbdcadbddb	TRUE
caddbbddddbadadb	TRUE
caddbcbbbcbcbbba	TRUE
cbcadcadcddbdcad	TRUE
cbcadcaddbcdccdd	TRUE
ccaddadbaddbcbdd	TRUE
ccaddbadcdbcadbb	TRUE
ccdbccdbadccadcd	TRUE
ccdbdadddbbdcadd	TRUE
cdbdcbbadbcadccb	TRUE
cdbdcbbcbbaddadd	TRUE
dadadcbadcadadcb	TRUE
dadadcbbbdccaddb	TRUE
daddcadadcdbbcba	TRUE
daddcadadddaddcb	TRUE
dbcadcbbadadadad	TRUE
dbcadcbbadaddcdc	TRUE
dcadcadcdcbdbdbd	TRUE
dcadcaddbdcccdbc	TRUE
dcdadadbddddbada	TRUE
dcdadaddccdcbadb	TRUE
ddbcbbccbaddadbd	TRUE
ddbcbcbadadbddbb	TRUE
aaaaaaadcbabbcdc	FALSE
aaaaaabbddcaaadc	FALSE
aacbbddadddbaaad	FALSE
aacbcbadaacbbcbd	FALSE
abbababacccdbdda	FALSE
abbabadcaccabcdc	FALSE
abdbaacbbcddccac	FALSE
abdbabbcbacaddcb	FALSE
acbdbbcbbbddadad	FALSE
acbdbbdcdabdacac	FALSE
adabaccbddaaadcd	FALSE
adabadbbbcccacdd	FALSE
adcccdcadaccdcda	FALSE
adcccddaabbabbdb	FALSE
babbddddbbbdbdac	FALSE
babcaaabacadacdc	FALSE
bbaacaaccdababba	FALSE
bbaacabcbddaddab	FALSE
bbcdadabdacdaddb	FALSE
bbcdadaddaabadbc	FALSE
bcbbaadcccbdbbca	FALSE
bcbbabaadddadccc	FALSE
bcddacddddcdadcc	FALSE
bcddadacdcbadbad	FALSE
bdcbbbacbbacbdcc	FALSE
bdcbbbbccdbcdcab	FALSE
caaccbabbcbcbddd	FALSE
caaccbdcaaadaadd	FALSE
cadbbddcbdaaccaa	FALSE
cadbcacdbcaccaac	FALSE
cbcababddcabcaac	FALSE
cbcabacacccadcba	FALSE
ccaccdbbdccbadbc	FALSE
ccaccdcacbcbcbcb	FALSE
ccdbccdbacccaacd	FALSE
ccdbdadddbbdcabd	FALSE
cdbdcbbaabcadccb	FALSE
cdbdcbbcbbaddabd	FALSE
daabcdaaacdbcdac	FALSE
daabcdbdbccbbacb	FALSE
dadbcddadcbabdaa	FALSE
dadbcddcddcaadaa	FALSE
dbcabcbbbcddbbda	FALSE
dbcacbbadaadcabc	FALSE
dcacadbaacacbcab	FALSE
dcacbaccdddddbbc	FALSE
dcdabaaacbcbdcac	FALSE
dcdabaabbadbcaba	FALSE
ddbcbbccbacdabbd	FALSE
ddbcbcbadabbddbb	FALSE
adadadadadbdbdbda	TRUE
adadadadadccadddc	TRUE
adadccadcbbbbadad	TRUE
adadccbadadadaddd	TRUE
adbaddccddbadbccd	TRUE
adbaddcdaddadcdad	TRUE
adbdbccccbbbcbbdd	TRUE
adbdbcdadbcccaddb	TRUE
adccadadbdccadadd	TRUE
adccadaddcdcaddad	TRUE
addbadadbcadbcdbb	TRUE
addbadadcdddbadad	TRUE
adddcbcddcadbbcad	TRUE
adddcbdbcadcbbadb	TRUE
badcbadbcadaddddc	TRUE
badcbadcbdddbdbad	TRUE
bbaddbdadbcdcbada	TRUE
bbaddcadadbbccadc	TRUE
bbdbcadadadcbbadd	TRUE
bbdbcadadccadaddb	TRUE
bcbdcaddadbdbcdda	TRUE
bcbdcadddadbdadad	TRUE
bdadbdcdcdadcbbbc	TRUE
bdadbdcddadccaddd	TRUE
bdcdadbddadbcddad	TRUE
bdcdbadcccadbddbc	TRUE
cadbbbaddcadcadcd	TRUE
cadbbbdadbbcdcdad	TRUE
cadddcdcaddbdadad	TRUE
caddddbadcbadadca	TRUE
cbcbbbcbcbbcbcbad	TRUE
cbcbbbcdcaddadbda	TRUE
ccbadbccdcbcbdcad	TRUE
ccbadbdbbbcadcbca	TRUE
ccdcadbcaddadcadb	TRUE
ccdcadbccbcbccbca	TRUE
cdcadbdadccdadadb	TRUE
cdcadbdcdbccadada	TRUE
dadadcaddbcadbadc	TRUE
dadadcaddccadbadb	TRUE
dadcdbadbaddadbdb	TRUE
dadcdbbadadcbbbca	TRUE
dbbbbdbcddbdcbadd	TRUE
dbbbbdcbadddbadba	TRUE
dbddcbadcadadddad	TRUE
dbddcbbbdccaddcdb	TRUE
dcccbccdaddadadbb	TRUE
dcccbddbdadadbdca	TRUE
ddbadbbbbcddcadad	TRUE
ddbadbbdadadcdada	TRUE
aaaaabadbdacbacca	FALSE
aaaaabbaacbbabcca	FALSE
aaccacaccadddbbab	FALSE
aacccabdbcdcdddaa	FALSE
abbaaddbcbdcddbaa	FALSE
abbaadddaacbbabdd	FALSE
abddcacbadccddbcc	FALSE
abddcacbbcadadadc	FALSE
accbadbbcacccbdac	FALSE
accbbacaadcabdcbc	FALSE
adbabccbadacbcbad	FALSE
adbabcccdcddacdcc	FALSE
addcbccbadcdcbacc	FALSE
addcbcccbcabbbbda	FALSE
bacacacaabcaaabbd	FALSE
bacacdacabbadabdb	FALSE
bbacaaccbcbbaadbd	FALSE
bbacabadbbbddabda	FALSE
bbcddbcdacbdbdbab	FALSE
bbcddcbdcabcbcbaa	FALSE
bcbcccccaacddaccb	FALSE
bcbcdbabbaacacadc	FALSE
bcddbccabcabcdbdd	FALSE
bcddbccddddcacaac	FALSE
bdcccdbabbdadbabd	FALSE
bdcccdbbaacdcadab	FALSE
cabaaabadabcbaaaa	FALSE
cabaabdbdccaadcba	FALSE
caddbaabacbaabdcd	FALSE
caddbaabcbcbbcaad	FALSE
cbcabddbadccdbdca	FALSE
cbcacabcbbddadcac	FALSE
ccaccbdacdacadcdc	FALSE
ccaccdbbbdbdbdddd	FALSE
ccdbdcbaababcacdc	FALSE
ccdbdcbbcabbccbac	FALSE
cdcacdaaaadacbbad	FALSE
cdcacdbdaabcbddcb	FALSE
daabdcddcdcabbada	FALSE
daabddbacacdacdda	FALSE
dadacbddadcbcabdb	FALSE
dadaccbaadcabccaa	FALSE
dbbccdbccabddbcdc	FALSE
dbbccdcccaaddddcc	FALSE
dcaadddbaabcdccba	FALSE
dcabaabbadbcdcdcc	FALSE
dccdbcddcbabbbcbd	FALSE
dccdbdbbacadbbcca	FALSE
ddbbddbbdcbdaabdb	FALSE
ddbbddcddbcdcddab	FALSE
adadadadadadcaddad	TRUE
adadadadadadcbdadc	TRUE
adadcdcddcadadbada	TRUE
adadcddbcadadadddb	TRUE
adbbcaddadaddbbcbb	TRUE
adbbcbadbadbdadadc	TRUE
adcadadadadcdddbcd	TRUE
adcadadadaddadadcb	TRUE
adcccadadadbcbcdad	TRUE
adcccadbdadbaddcbb	TRUE
addadddadcadadadca	TRUE
addadddbbdcaddadba	TRUE
adddccbaddcbdcbbcc	TRUE
adddccbbdcadcbcdcd	TRUE
badcadcdbaddcaddbd	TRUE
badcadcdcdadcaddad	TRUE
bbadccdcdcbbcadccb	TRUE
bbadccddbbcdbaddbb	TRUE
bbdaddbbbbbadbdcca	TRUE
bbdaddbcadadaddcdd	TRUE
bcbcadaddbbbddbdba	TRUE
bcbcadbadddbcddbad	TRUE
bcdddadadddadadadd	TRUE
bcdddadbadcbdbaddd	TRUE
bdcbdbcadadcccccdb	TRUE
bdccadadbdcdbadddd	TRUE
cadadddaddbdbcbadb	TRUE
cadaddddcccbbadada	TRUE
caddcaddadcddadadd	TRUE
caddcaddbdadbadccd	TRUE
cbcaddbadcbccadadc	TRUE
cbcaddcdcdddcadadb	TRUE
ccaddadbddaddcdbad	TRUE
ccaddadcddadadbada	TRUE
ccdaddadbcbaddcbdc	TRUE
ccdaddadcbbcbaddad	TRUE
cdbcddbbbcdccccddd	TRUE
cdbcddddbdbdadaddb	TRUE
dadadcadadbbbcccdc	TRUE
dadadcadbaddbadcdd	TRUE
dadcdddadadbbbbdbd	TRUE
dadcdddadadcdadadb	TRUE
dbbbddddbdddcdbbad	TRUE
dbbcadaddadbadadcd	TRUE
dcadbccbadbadcadad	TRUE
dcadbcdbdddccbdadc	TRUE
dccddaddbcaddbcddb	TRUE
dccddadddadcadaddd	TRUE
ddbcadadadcadbcbad	TRUE
ddbcadadbdbaddcada	TRUE
aaaaaaccdbcdaabaac	FALSE
aaaaabdacdacddccdc	FALSE
aaccbcaddcbdcdbcda	FALSE
aaccbccbbaddbcdbcd	FALSE
abadacdaabbaacccbb	FALSE
abadadcbbacaaddbbc	FALSE
abdbbdbcdddcacdcad	FALSE
abdbcaadbdccadccdd	FALSE
acbddcaccccaccdcac	FALSE
acbddcbdccddadcbdb	FALSE
adacadaddbadacbbad	FALSE
adacadcccadcacdbdb	FALSE
addacddcaaadbdbbad	FALSE
addadabdbddddccaca	FALSE
babdacbdcddcabdcac	FALSE
babdaddcadcadaadcd	FALSE
bbabccddadcbacdcad	FALSE
bbabcddadaadcdddbc	FALSE
bbcdaddaddadabdcad	FALSE
bbcdbaabdcdbbcbadb	FALSE
bcbdbadcdadbcbacdb	FALSE
bcbdbbdaaaaabdcbac	FALSE
bdaabdbcdcabcdbcda	FALSE
bdaabdcbbdbddbbdab	FALSE
bdccaacdbacadabcdd	FALSE
bdccabaccdacddddba	FALSE
cabadabbdcdcdcdcdc	FALSE
cabadbbdbbccdccaca	FALSE
caddcbaaabdaccdddb	FALSE
caddcdbbdaccabdabd	FALSE
cbccabccdcdabdcddd	FALSE
cbccabdcbbacbadadd	FALSE
ccbabbbdcdcbbcdbba	FALSE
ccbabcaadaccdaccbb	FALSE
ccdcbccacacdacdbaa	FALSE
ccdcbdabaadcddddbb	FALSE
cdcaacdccbccbdcaad	FALSE
cdcaadaaadcbaadacb	FALSE
daacbdcdbababcddac	FALSE
daacbdddbbacaacddd	FALSE
dadaacabccdcabbcaa	FALSE
dadababbadcbddabca	FALSE
dbbcbdadbbdbbaadba	FALSE
dbbcbdbdcabdbadbbb	FALSE
dcaadcdbdcaaddbddd	FALSE
dcaadcdcbdbaacddac	FALSE
dccdadbcccacdabdda	FALSE
dccdbdbaccadaaacdb	FALSE
ddbbbbabaddcbbdbda	FALSE
ddbbbbccbcaaaacbdc	FALSE
adadadadadbadbadcca	TRUE
adadadadadcadadbbda	TRUE
adadccdadaddbbdbcdc	TRUE
adadccdadccadadddad	TRUE
adbbaddadadadadbbbd	TRUE
adbbaddadadcadadcad	TRUE
adbdcbdadadccbadbad	TRUE
adbdcbdbccbadbbadcc	TRUE
adccaddcbadcccaddda	TRUE
adccaddcbbdbbcbbada	TRUE
addaddcbbbdbdcdadbb	TRUE
addaddccbcdcddddccd	TRUE
adddcadcdddadbadcba	TRUE
adddcaddadbaddbbadb	TRUE
badcadbdbadcadadcbc	TRUE
badcadbdbbadbdadadd	TRUE
bbadcbaddadcadddbad	TRUE
bbadcbdbbcdbdcdbcad	TRUE
bbdbaddcdbdadbbcccc	TRUE
bbdbadddadadaddcada	TRUE
bcbdbdadadadadcdcad	TRUE
bcbdbdadbadcadadadb	TRUE
bdadadbbdcdbadadadd	TRUE
bdadadbccddbcbdbadd	TRUE
bdccdbbadcadcadcadd	TRUE
bdccdbbcbadbdbdbcdc	TRUE
cadbcadcbadbbadadca	TRUE
cadbcaddadbdbcbdddd	TRUE
cadddccdcadadcadadb	TRUE
cadddccdcdcbbdbcada	TRUE
cbccdddbdcdbadadbdc	TRUE
cbcdadadddddadcbada	TRUE
ccbaddddddadcbadcca	TRUE
ccbbadadcdccdcbaddc	TRUE
ccddddcbccdaddaddcb	TRUE
cdadadadbcadcadadbc	TRUE
cdccdadadadbadbbcdc	TRUE
cdccdadadadcadadddc	TRUE
dadbccadbcddcdbdada	TRUE
dadbcccbdcadcccadad	TRUE
dadddddbcdbbbbcadca	TRUE
dadddddcdcdcddcadad	TRUE
dbcbbdaddadadadadcc	TRUE
dbcbbdbadaddadadbcb	TRUE
dcadcddcdbbcaddadad	TRUE
dcaddadbadcdaddcadc	TRUE
dcdadaddbadcbcbadad	TRUE
dcdadbbbcdaddddadad	TRUE
ddbcbadcaddddbbadad	TRUE
ddbcbbaddadbdbadbad	TRUE
aaaaaacabacbaacabcb	FALSE
aaaaaacaccbdbaacdca	FALSE
aaccbcbcabdddbdbbbd	FALSE
aaccbcdaadbaacadaac	FALSE
abbaadddbaabcdbaabb	FALSE
abbababbdbdbcacacab	FALSE
abdcdcbcddbabbcdadd	FALSE
abdcdcdabddaadaadda	FALSE
accbdaccbabdbaaaccc	FALSE
accbdcadcbcbbcbdcba	FALSE
adbacaddccadcbaacbb	FALSE
adbacbddcdacccbaccd	FALSE
addcbaacbdacbaacabb	FALSE
addcbabbabcdcdabbca	FALSE
babddbcadbabbccbcaa	FALSE
babddcaaabaacbddadd	FALSE
bbaccaccddadadbaacc	FALSE
bbaccbcbcccdacdcdca	FALSE
bbdbadcbadbdadbbcab	FALSE
bbdbadccaaacacaadca	FALSE
bcbdbdababababcdcaa	FALSE
bcbdbdabbadcaaabacb	FALSE
bdaacbadbbbadccddaa	FALSE
bdaacdadcdbbadbacdd	FALSE
bdccdbbaacadcaacaad	FALSE
bdccdbbcbadbdbdbcab	FALSE
cabbdabccdaadadacad	FALSE
cabbddbccddabbaadcb	FALSE
caddcacdbbdcbcaacad	FALSE
caddcadddbdddcbbdab	FALSE
cbccdddbdcdbabaabdc	FALSE
cbcdaabbbddddaccbad	FALSE
ccbaddbdddaccbaccca	FALSE
ccbbabbabcdccdcbaad	FALSE
ccddddcbccdaddacdcb	FALSE
cdaaabbaadbcbabaada	FALSE
cdccdaacdabaaaaadcb	FALSE
cdccdabcaadcccabaad	FALSE
dabbbdbbabdabbbacba	FALSE
dabbbddbdddacbccadb	FALSE
dadddbccaccdbbbbcaa	FALSE
daddddccdcdcddcabac	FALSE
dbcbbdacdabadadadcc	FALSE
dbcbbdbacaddadabbcb	FALSE
dcadacdabbcaadadabc	FALSE
dcadadbaaacccabbbcb	FALSE
dcdabaadbccbbbbcdba	FALSE
dcdabbaaaaccbbbbadd	FALSE
ddbcbaccacdddbbaaac	FALSE
ddbcbbaadadbdbadbac	FALSE
