ababababcb	TRUE
ababababdb	TRUE
abbdddcdad	TRUE
abcabacbab	TRUE
abdddabdba	TRUE
abdddacabb	TRUE
acbdacacca	TRUE
acbdacdacb	TRUE
acdcdcdddd	TRUE
acdcddadba	TRUE
adbdbcabca	TRUE
adbdbcbbbc	TRUE
addcdddaca	TRUE
addcdddbba	TRUE
bacccbcdcd	TRUE
bacccbcdda	TRUE
bbadbdcdba	TRUE
bbadcbabcb	TRUE
bbdacbdddb	TRUE
bbdaccacab	TRUE
bcbbbdcadc	TRUE
bcbbcacbac	TRUE
bcddcbccbb	TRUE
bcddcccccc	TRUE
bdcdacaccc	TRUE
bdcdacadcb	TRUE
cabdcccbac	TRUE
cabdcdcccb	TRUE
cbabacacbc	TRUE
cbabacdccc	TRUE
cbccbabbad	TRUE
cbccbadbcd	TRUE
ccbadbbabc	TRUE
ccbadbbaca	TRUE
ccdcacbcbc	TRUE
ccdcaccdac	TRUE
cdcaccdddd	TRUE
cdcacdacad	TRUE
dabcabbcba	TRUE
dabcabbccb	TRUE
dadbadcddb	TRUE
dadbbacdba	TRUE
dbbccdacbb	TRUE
dbbccdbddd	TRUE
dcabdcbabb	TRUE
dcabdcccba	TRUE
dcdabdbcdd	TRUE
dcdabdccdd	TRUE
ddbcdccbdd	TRUE
ddbdababdd	TRUE
aaaaadabab	FALSE
aaaaaddddb	FALSE
aacdbbccbc	FALSE
aacdbbdadc	FALSE
abbbacabaa	FALSE
abbbaccdaa	FALSE
abdcbcdbaa	FALSE
abdcbddbaa	FALSE
accccbabaa	FALSE
accccbcbaa	FALSE
adbbadbcaa	FALSE
adbbadddaa	FALSE
adddbaaacb	FALSE
adddbaacaa	FALSE
babdcbbbaa	FALSE
babdccbaab	FALSE
bbadcabcaa	FALSE
bbadcacaab	FALSE
bbdaccaada	FALSE
bbdaccabaa	FALSE
bcbbbdcaac	FALSE
bcbbcabbaa	FALSE
bcddcbccaa	FALSE
bcddccccaa	FALSE
bdcdabaabd	FALSE
bdcdabbaac	FALSE
cabadbacaa	FALSE
cabadccaad	FALSE
cbaaadcdba	FALSE
cbaabaabdd	FALSE
cbccbaabad	FALSE
cbccbadbaa	FALSE
ccbadbbaab	FALSE
ccbadbbaad	FALSE
ccdcabbcaa	FALSE
ccdcabcdaa	FALSE
cdcacbcdaa	FALSE
cdcaccadaa	FALSE
daacbbbbbd	FALSE
daacbccabd	FALSE
dadacdbaab	FALSE
dadacdbcaa	FALSE
dbbccdacaa	FALSE
dbbccdbdaa	FALSE
dcaadbddad	FALSE
dcaaddddbb	FALSE
dcdaadcdbc	FALSE
dcdabaddaa	FALSE
ddbcdccbaa	FALSE
ddbdaaaadd	FALSE
ababababcbd	TRUE
ababababdcb	TRUE
abbdddbddad	TRUE
abcabbbdbcb	TRUE
abddcddbcab	TRUE
abdddabadca	TRUE
acbcdcbcacc	TRUE
acbcdcbdbcd	TRUE
acdcdbbadac	TRUE
acdcdbcabad	TRUE
adbdcabcbbc	TRUE
adbdcadacdc	TRUE
addcddbbddd	TRUE
adddababbbd	TRUE
baccdacccab	TRUE
baccdbbdddd	TRUE
bbacdacdadd	TRUE
bbacdacdddd	TRUE
bbdadcdcdac	TRUE
bbdaddcacad	TRUE
bcbcbdbcbbb	TRUE
bcbcbdddccd	TRUE
bdabdabbcbc	TRUE
bdabdabdbca	TRUE
bdccccbacbd	TRUE
bdcccdbcabc	TRUE
cacacacabbc	TRUE
cacacbacbad	TRUE
caddbbbaddd	TRUE
caddbcadacb	TRUE
cbbdddcbadd	TRUE
cbcabadadbd	TRUE
ccbabdcbdac	TRUE
ccbabdddbbb	TRUE
ccdbcddadcd	TRUE
ccdbdabccba	TRUE
cdcabccccac	TRUE
cdcabddbddd	TRUE
dabcacbbbcb	TRUE
dabcaccccdd	TRUE
dadccadacbb	TRUE
dadccbbabad	TRUE
dbcacdaccbc	TRUE
dbcacdadbad	TRUE
dcaccabdacc	TRUE
dcaccaccadc	TRUE
dccdcbdabac	TRUE
dccdccbdddc	TRUE
ddbbbadbccb	TRUE
ddbbbcbbbbb	TRUE
aaaaadababb	FALSE
aaaaadddbad	FALSE
aacdadbabab	FALSE
aacdadbbbbd	FALSE
abbbaaabbdd	FALSE
abbbaabcbcc	FALSE
abdccbbbbaa	FALSE
abdccbbdaac	FALSE
accbccdadaa	FALSE
accbcdcbdaa	FALSE
adbaaaaddda	FALSE
adbaacadbdd	FALSE
addcdadddaa	FALSE
addcddcabaa	FALSE
bacbbdbdaad	FALSE
bacbbdcbdaa	FALSE
bbacbcaddaa	FALSE
bbacbccbdaa	FALSE
bbdadbbddaa	FALSE
bbdadccacaa	FALSE
bcbcbdbcbaa	FALSE
bcbcbdddcaa	FALSE
bdabaacabab	FALSE
bdabaaccabd	FALSE
bdccccbabaa	FALSE
bdcccdbcaac	FALSE
cabbaddddaa	FALSE
cabbbacdaac	FALSE
caddbaadcac	FALSE
caddbabccaa	FALSE
cbbdddcbaad	FALSE
cbcaaacadbd	FALSE
ccbabbaacac	FALSE
ccbabbdbbaa	FALSE
ccdbcddadaa	FALSE
ccdbdaaccba	FALSE
cdcaaddccca	FALSE
cdcabbdddaa	FALSE
daaccabdddc	FALSE
daaccacddcc	FALSE
dadbdccbaad	FALSE
dadbdddaaad	FALSE
dbcaccaccaa	FALSE
dbcaccaddaa	FALSE
dcacadaacbd	FALSE
dcacbbcadaa	FALSE
dccdcbdaaac	FALSE
dccdccbddaa	FALSE
ddbbbadbcaa	FALSE
ddbbbcbbbaa	FALSE
ababababcbdd	TRUE
ababababdbbd	TRUE
abbdddbcbdcd	TRUE
abcababcccca	TRUE
abdddaccdbcc	TRUE
abdddadbcbac	TRUE
acbcdcdbcaba	TRUE
acbcddadbaba	TRUE
acddadababac	TRUE
acddadadcabd	TRUE
adbdacdababd	TRUE
adbdadacdcdc	TRUE
adddacabbbdb	TRUE
adddadabaccb	TRUE
baccacbbccca	TRUE
baccacbdcabd	TRUE
bbacdbbacbda	TRUE
bbacdcacccdb	TRUE
bbdadcdadaba	TRUE
bbdaddbbcdac	TRUE
bcbdabdcdbbb	TRUE
bcbdadbdacba	TRUE
bdabccccbcdd	TRUE
bdabcccddcbd	TRUE
bdcccbacadda	TRUE
bdcccdadadab	TRUE
cacabddacaca	TRUE
cacacabdccab	TRUE
cbabbccabacc	TRUE
cbabbddbbbbc	TRUE
cbcdbabdbbcc	TRUE
cbcdbadbbcdc	TRUE
ccbaccccadda	TRUE
ccbacdcbdabc	TRUE
ccddabbbbacd	TRUE
ccddabdbcadc	TRUE
cdcbabdababc	TRUE
cdcbabdccadb	TRUE
dabbdddbdcbc	TRUE
dabcabadcabc	TRUE
dadbcaccacca	TRUE
dadbcaddabbb	TRUE
dbbcbccccbca	TRUE
dbbcbcddbbdc	TRUE
dcacacaddbbc	TRUE
dcacacbcbcbb	TRUE
dccdcddabcdc	TRUE
dccdcddaddcd	TRUE
ddbbdacbdabb	TRUE
ddbbdbacacdb	TRUE
aaaaadccaaad	FALSE
aaaabaabadac	FALSE
aacbbcacbccb	FALSE
aacbcbadbbac	FALSE
abadabdcabaa	FALSE
abadaccbddaa	FALSE
abdaadabcdcb	FALSE
abdaaddcbccb	FALSE
acbbcdabbaac	FALSE
acbbcdbdccaa	FALSE
acdddcadacaa	FALSE
acdddccbdaab	FALSE
adcbbcbbcdaa	FALSE
adcbbcddbcaa	FALSE
babaaabaabcb	FALSE
babaabdaaddc	FALSE
badbbcbbcaac	FALSE
badbbcddaaaa	FALSE
bbcadbccbaac	FALSE
bbcadbcdbcaa	FALSE
bcacdbacbaad	FALSE
bcacdbdabdaa	FALSE
bcdcaaaabcac	FALSE
bcdcaaddcbbd	FALSE
bdcaddacabaa	FALSE
bdcaddbdbbaa	FALSE
caadcdabcaaa	FALSE
caadcddcdbcd	FALSE
cadcdcbaaaba	FALSE
cadcddbaaddc	FALSE
cbbddabdbdaa	FALSE
cbbddadaabab	FALSE
ccabcaccacaa	FALSE
ccabcbadbbaa	FALSE
cccddacddaad	FALSE
cccddbaaddbc	FALSE
cdbcbdbbcbaa	FALSE
cdbcbdbbcdaa	FALSE
daaaddcbddcb	FALSE
daabaabdacbc	FALSE
daccbcaabdba	FALSE
daccbcbdbdaa	FALSE
dbbcbdadcbaa	FALSE
dbbcbdbbabaa	FALSE
dcabbbbbbcaa	FALSE
dcabbcccdaaa	FALSE
dccdacbdbaab	FALSE
dccdadbdadaa	FALSE
ddbaccbcbdaa	FALSE
ddbacdabbdaa	FALSE
abababcdcccbd	TRUE
ababacbdcdcdb	TRUE
abbdbabcabbab	TRUE
abbdbabcccdbc	TRUE
abdcdbbabdccd	TRUE
abdcdbbdddadc	TRUE
acbbccaddbbda	TRUE
acbbcccdcabdb	TRUE
acdaddbdaccdc	TRUE
acdbabdcbccbd	TRUE
adbabadcacabb	TRUE
adbabadddacbc	TRUE
adcdaccccbadb	TRUE
adcdadacabdbd	TRUE
babdabdaccbcb	TRUE
babdacddacadb	TRUE
baddcaddddccc	TRUE
baddcbabdabad	TRUE
bbcbaddabbbcd	TRUE
bbcbbadabbacc	TRUE
bcbabcbdaccdc	TRUE
bcbabccdacbdc	TRUE
bcdbdcddbdbad	TRUE
bcdbddabddccc	TRUE
bdcbadabadaca	TRUE
bdcbadcccabdd	TRUE
cabcbacdcbccc	TRUE
cabcbadddbacc	TRUE
cadbcdacbabad	TRUE
cadbcdcccbcac	TRUE
cbcabacddbcbc	TRUE
cbcabadbdddca	TRUE
ccacccbccccad	TRUE
ccacccdcabcab	TRUE
ccdabcbbacabb	TRUE
ccdabcdcbbbdb	TRUE
cdbdbaccdbadb	TRUE
cdbdbbabcdcbc	TRUE
dabadcdcababb	TRUE
dabaddbadaddc	TRUE
dadadddcccbcb	TRUE
dadbabcbdacdb	TRUE
dbbcacabdbcac	TRUE
dbbcacdadbdcd	TRUE
dcabacbddacdc	TRUE
dcabadbacccab	TRUE
dcccccbddadba	TRUE
dcccccddddabd	TRUE
ddbadacccdada	TRUE
ddbadadbacabc	TRUE
aaaaaacbdcdca	FALSE
aaaaaaddcbdba	FALSE
aacbadcdbaabc	FALSE
aacbbadabdcad	FALSE
abbabbdabdbaa	FALSE
abbabdabccdaa	FALSE
abdcdcdcdbaaa	FALSE
abdcddbadbcaa	FALSE
accbbacdabcaa	FALSE
accbbadbabaab	FALSE
adadcbbcdcdaa	FALSE
adadcbdaaddca	FALSE
addcaadaddbbc	FALSE
addcabbcdbdaa	FALSE
bacaaaddcdccb	FALSE
bacaabadccaca	FALSE
bbacbbbabbcaa	FALSE
bbacbbcdbcbaa	FALSE
bbdaccccbccaa	FALSE
bbdacddaacbda	FALSE
bcbcabbabbcaa	FALSE
bcbcabbcaccaa	FALSE
bcdcdcdddacaa	FALSE
bcdcdcddddbaa	FALSE
bdcbbbadddcaa	FALSE
bdcbbbcacddaa	FALSE
caadbcbadbbba	FALSE
caadccdcdadcd	FALSE
cadbdbbccbcaa	FALSE
cadbddbdadaab	FALSE
cbcbacccabcaa	FALSE
cbcbacdbacaac	FALSE
ccaddbbdaabcb	FALSE
ccadddbaadacb	FALSE
ccdbcccbbccaa	FALSE
ccdbccdddbdaa	FALSE
cdbdbddabbaac	FALSE
cdbdbdddaccaa	FALSE
daacbdabdcbba	FALSE
daacbddddddca	FALSE
dadbdbabdccaa	FALSE
dadbdbacdacaa	FALSE
dbbdbdccbdaad	FALSE
dbbdccdabcbaa	FALSE
dcabadbabacaa	FALSE
dcabadcadbbaa	FALSE
dcdaacdcaddbb	FALSE
dcdabbbbccbaa	FALSE
ddbbdccccdbaa	FALSE
ddbcaaaacdccd	FALSE
abababaccabdcb	TRUE
abababaccdbddb	TRUE
abbdbbddcbbbdb	TRUE
abbdbdcbdbddca	TRUE
abddadbabbbdbc	TRUE
abddadbcababcd	TRUE
acbdbccbabccba	TRUE
acbdbccbacdbab	TRUE
acdcdcccdcdcdc	TRUE
acdcddabbcacdc	TRUE
adbcbdddabaccb	TRUE
adbccacbacacdd	TRUE
addcbddbdcbcab	TRUE
addccbabbadccc	TRUE
bacbdbbaddadba	TRUE
bacbdbbbbbcadc	TRUE
bbabdcbcdbcccd	TRUE
bbabddaccadcdc	TRUE
bbcdbaddcccbbb	TRUE
bbcdbbabadcbbd	TRUE
bcbbcabddcbabc	TRUE
bcbbcaccdadadb	TRUE
bcdcdbadcaccad	TRUE
bcdcdbbdcadcdb	TRUE
bdcadcacabcdda	TRUE
bdcadcccacdcab	TRUE
cabccadaccbbda	TRUE
cabccadccbbbac	TRUE
cadccacccdccdd	TRUE
cadccbabaccddc	TRUE
cbcbadbbaccdba	TRUE
cbcbadcacbcbbb	TRUE
ccbacbbdadcdba	TRUE
ccbacbccdabadc	TRUE
ccdbacdbcdadcb	TRUE
ccdbbacdbbacac	TRUE
cdbdabbcacdccc	TRUE
cdbdabbdcbddbb	TRUE
dabcbdababdbbc	TRUE
dabccacbcdcccc	TRUE
dadcbaccdadabd	TRUE
dadcbbabdbcaba	TRUE
dbbdcbadccbdba	TRUE
dbbdccadcacccb	TRUE
dcabdacbccbbab	TRUE
dcabdbababcdad	TRUE
dccdbaddadcbab	TRUE
dccdbbbacdcadc	TRUE
ddbcbabccbbdab	TRUE
ddbcbbbbccbdcd	TRUE
aaaaaabacbacab	FALSE
aaaaaacabddabb	FALSE
aacbbcbdadacaa	FALSE
aacbcabaabcdaa	FALSE
abbaabcddbccba	FALSE
abbaacddbbccac	FALSE
abdbddabbdbbaa	FALSE
abdcaacbdbbacd	FALSE
accadcdbbbabaa	FALSE
accaddbdcbcaab	FALSE
adadcddcabbaac	FALSE
adaddcacacacaa	FALSE
addccdcccaddaa	FALSE
addccddcdaddaa	FALSE
bacccdbddbbaac	FALSE
baccdabcdacdaa	FALSE
bbbaccaddcbcaa	FALSE
bbbaccbaddccaa	FALSE
bbdbdcbbdadaad	FALSE
bbdbdccddacbaa	FALSE
bcbdddbabbddaa	FALSE
bccaaaaabbdacb	FALSE
bdaacdbcbdaddd	FALSE
bdaacdccaaccac	FALSE
bdcbddddbdcbaa	FALSE
bdccaaadacdabc	FALSE
cabaaacaabbddb	FALSE
cabaaacadcbacc	FALSE
caddbabccdccaa	FALSE
caddbabcdbbbaa	FALSE
cbcbbccdcbabaa	FALSE
cbcbbcdcdbadaa	FALSE
ccadacbdacacaa	FALSE
ccadadcadccbaa	FALSE
ccdcacbddcbdaa	FALSE
ccdcaccbaddcaa	FALSE
cdbdaabbcaabab	FALSE
cdbdabacbcbcaa	FALSE
daaacbcddacccb	FALSE
daaacdacdddbda	FALSE
dacdbbbbabcbaa	FALSE
dacdbbbdcdadaa	FALSE
dbbccdcdabdaad	FALSE
dbbccddadccaaa	FALSE
dcaadadbdbbacd	FALSE
dcaadbdbbbcadb	FALSE
dcdaadbdcbbddd	FALSE
dcdaadcacbcdcb	FALSE
ddbbdabdacadaa	FALSE
ddbbdaccacccaa	FALSE
abababbbdcccddb	TRUE
abababdaccbdcdb	TRUE
abbddcadabcadcd	TRUE
abbddcbabddbcac	TRUE
abdddbddcabbdcc	TRUE
abdddcacdacdbad	TRUE
acbdbdabbbcdddd	TRUE
acbdbdbbacbadcd	TRUE
acdcdbdbadcccad	TRUE
acdcdcbcabcabba	TRUE
adbccbadcabdddc	TRUE
adbccbaddcdcaba	TRUE
adddadaddbacbab	TRUE
adddadddbcabdcd	TRUE
baccdccbbaccbda	TRUE
baccddbcaddcbcd	TRUE
bbadcbddadcbaca	TRUE
bbadcbddbddcbcb	TRUE
bbdbabbabbcbcba	TRUE
bbdbabbabcbbcbc	TRUE
bcbcbddbdcdcadc	TRUE
bcbccbadccadcba	TRUE
bdacacacabadbdc	TRUE
bdacacbbbbbcabd	TRUE
bdccbdbabcdbbad	TRUE
bdccbdcbcdacacb	TRUE
cabdacdbcdadbcc	TRUE
cabdadddabdddab	TRUE
cadcccddcacacab	TRUE
cadccddcbacbdbc	TRUE
cbcadbdadbdbdba	TRUE
cbcadccadcadada	TRUE
ccaccbcbcbdbddc	TRUE
ccacccddccdcdad	TRUE
cccdbdadbabcbdc	TRUE
cccdbddabbadccb	TRUE
cdbcacacccbacdb	TRUE
cdbcacadcdcddbc	TRUE
dabadcbccdacdad	TRUE
dabadcdbdbbcdbb	TRUE
dadbabccabcabdb	TRUE
dadbabcdddddada	TRUE
dbbdabaddacabba	TRUE
dbbdabcaddadbba	TRUE
dcabccabbdcbcca	TRUE
dcabccacbdbdabc	TRUE
dcccdbdabadcdac	TRUE
dcccdcabcadcaba	TRUE
ddbbbcabddcbdca	TRUE
ddbbbcccbbcbcdb	TRUE
aaaaaababbababd	FALSE
aaaaabcbcdaaacb	FALSE
aacccddabbbbbda	FALSE
aaccdaaabddcdbc	FALSE
abbbbaadbadacdc	FALSE
abbbbabcdbdadaa	FALSE
abdccbbaccbdcaa	FALSE
abdccbdacbacaac	FALSE
accabccccccbcaa	FALSE
accabdcbdacddaa	FALSE
adadcacdabbddaa	FALSE
adadccdbbbdbbaa	FALSE
addbbdbadbaaddb	FALSE
addbbdcddcdbcaa	FALSE
babdcacddcdacaa	FALSE
babdccdcaccddaa	FALSE
bbadbacaadbcabc	FALSE
bbadbacbcbbbcaa	FALSE
bbdcaacbcdbaddd	FALSE
bbdcabacacddbaa	FALSE
bccabccbddddcaa	FALSE
bccabcccdadcdaa	FALSE
bdaaddbbccbdbca	FALSE
bdaaddbddaadacd	FALSE
bdcddacaadcbdad	FALSE
bdcddadbdddbaad	FALSE
cabbbbdcacddcaa	FALSE
cabbbcccbdbccaa	FALSE
cadcbaacacdddcb	FALSE
cadcbabcddddcaa	FALSE
cbcbabcaccccbaa	FALSE
cbcbabcdbaaaadc	FALSE
ccacdbbdccadcaa	FALSE
ccacdcbbcddcaac	FALSE
ccdbccabccaddaa	FALSE
ccdbcccbadcaacd	FALSE
cdbdccaacbcaadb	FALSE
cdbdccbabccddaa	FALSE
daaaddcdccbbbdc	FALSE
daabaabcddcddbd	FALSE
dacdcbcddcbdcaa	FALSE
dacdcbdcbaabdcb	FALSE
dbbcabcccbcdcaa	FALSE
dbbcacacbbbaadc	FALSE
dcabacdccdadbaa	FALSE
dcabacdcddaabca	FALSE
dccdaaadcccddaa	FALSE
dccdabbbadcbdaa	FALSE
ddbbccccddccdaa	FALSE
ddbbcdcbbacdcaa	FALSE
abababccadacdacd	TRUE
ababacadcccdcbdb	TRUE
abcabdbbbaddadcc	TRUE
abcabdcabccbdacc	TRUE
acabaccbcacabbcd	TRUE
acabacdacbccacba	TRUE
acbccdaccacdbdba	TRUE
acbcdaccbcadadbc	TRUE
acdcadbccdcbbcab	TRUE
acdcbabbdadcddbb	TRUE
adbbcdcdacabaccc	TRUE
adbbdabdbcbdaccb	TRUE
addcababcadacbac	TRUE
addcaccbcdabbabc	TRUE
baccdddabccbbddc	TRUE
bacdabbdabbbdbca	TRUE
bbadbacccabbabac	TRUE
bbadbacdbabdabca	TRUE
bbdbabdababcbadd	TRUE
bbdbacdacbdababc	TRUE
bcbccacacdcdabbb	TRUE
bcbccadacabbadab	TRUE
bdabbabdbcdddacb	TRUE
bdabbbacbabcadcb	TRUE
bdcdadcdbccbbdbd	TRUE
bdcdbabacdcacbac	TRUE
cabdcccabaccdbdb	TRUE
cabdcccccbcbcbbb	TRUE
caddabdbdadadabc	TRUE
caddacbadbbabdca	TRUE
cbcacbdbabacddbb	TRUE
cbcaccddcddbcdda	TRUE
ccaccadccbdaddba	TRUE
ccaccbdacdadddbd	TRUE
ccdabcbabdadadca	TRUE
ccdabcbcacbbbdac	TRUE
cdbcbbdadabbdbcb	TRUE
cdbcbbdbaccddcad	TRUE
dabbabbadcdaccca	TRUE
dabbabcadadbabdd	TRUE
dadbccdddccabacd	TRUE
dadbcdbccdcdbdcc	TRUE
dbbcdabdacaddbcd	TRUE
dbbcdbcbbddcbdcc	TRUE
dcadabbcdbbcdacc	TRUE
dcadabbdabbbdddd	TRUE
dcdbcbccddbbdcac	TRUE
dcdbccbddcdcadcc	TRUE
ddbdabbdadacdada	TRUE
ddbdabcccdabacbb	TRUE
aaaaaaabbacddaca	FALSE
aaaaaacacdccbacc	FALSE
aacbbbcbcbbbbbdc	FALSE
aacbbdaaccdccdac	FALSE
abadaacddadccbca	FALSE
abadabaaaccdabbb	FALSE
abdadcddbbabddaa	FALSE
abdaddaaaddcbabd	FALSE
acbddbcbbbdbbcaa	FALSE
acbddbdbdbbdddaa	FALSE
adabddbcabccdcaa	FALSE
adabdddccdbcdaaa	FALSE
addaacdddbbbbdcb	FALSE
addaadabcacaddca	FALSE
babcbbaabbcbbcac	FALSE
babcbbbbbdaabccb	FALSE
badddbdbcacdaaca	FALSE
badddcbcaaddabdd	FALSE
bbcbbcadcdcbacaa	FALSE
bbcbcacaacabbddc	FALSE
bcadcdcabbdbdbaa	FALSE
bcaddabcbbcdddaa	FALSE
bcdcbababbbacaad	FALSE
bcdcbadbbdadadaa	FALSE
bdcbbbccacdaabba	FALSE
bdcbbbcddbaaaddb	FALSE
cababcabadcdacaa	FALSE
cababddcaabdaddd	FALSE
cadccaddcaacccac	FALSE
cadccbbbcdccadaa	FALSE
cbcaddacaccbdcaa	FALSE
cbcbaaadbdbaaccb	FALSE
ccaccbbcbabaabba	FALSE
ccacdabccbddccaa	FALSE
ccdadbdbaabcacbb	FALSE
ccdadcacbacdcbaa	FALSE
cdbdadbdddacdaad	FALSE
cdbdadddbbcaddaa	FALSE
daacbacbccacbdda	FALSE
daacbadaaddccacd	FALSE
dadbbdcabbccbcaa	FALSE
dadbcbcdddbaddaa	FALSE
dbcbacabbcddadaa	FALSE
dbcbaccbccdcdaad	FALSE
dcacadaadcacddbd	FALSE
dcacbbdadcbdbbaa	FALSE
dcdacddcacacddaa	FALSE
dcdacdddaddcbaaa	FALSE
ddbccdbcbbacddaa	FALSE
ddbcdbbdaabacbcc	FALSE
ababababdacccddba	TRUE
abababbbadaddadcd	TRUE
abbdacccacdaddbbb	TRUE
abbdacdbcabacbbab	TRUE
abdcbababadbbabca	TRUE
abdcbbacbabcbdcbd	TRUE
acbbbdadcbcadacdc	TRUE
acbbbddccddacbcba	TRUE
acdbadadcacccdccc	TRUE
acdbadbcbddbcdbcd	TRUE
adbbdbacccdbdcdbd	TRUE
adbbddcacbdddbcbd	TRUE
addbdacbababbdabd	TRUE
addbdbababcabdcbc	TRUE
bacadbdbccdcdadcb	TRUE
bacadcabcbccbbbcb	TRUE
bbabcddbddcbbddca	TRUE
bbabdabddcdbcabca	TRUE
bbcdadcbddcbababc	TRUE
bbcdbabbcbabdbadb	TRUE
bcbcabdaddcbccabd	TRUE
bcbcadadababadcca	TRUE
bdabcccbcdbbdacba	TRUE
bdabcdbcdcdcbabca	TRUE
bdcccccbadacbbdda	TRUE
bdcccccdadcbabaca	TRUE
cabdacccddadbcadd	TRUE
cabdaccdbdacdabba	TRUE
cadcbcadcdaccbdac	TRUE
cadcbcbaddacbdadc	TRUE
cbcbadbabdbcbacab	TRUE
cbcbbabbccbddccac	TRUE
ccbacabddcacdbdcc	TRUE
ccbacbbccbaddcddd	TRUE
ccdbcddcaddccbddb	TRUE
ccdbdaddbcaddccca	TRUE
cdbdcbbabadadccbd	TRUE
cdbdcbcabdabccdda	TRUE
dabcacbadccbbdadb	TRUE
dabcaccabbadcacba	TRUE
dadbadbacbcabbcdb	TRUE
dadbaddccdabbbadc	TRUE
dbbcdbbbdcdabcdad	TRUE
dbbcdccbcbbdccdcd	TRUE
dcabcccacccadccda	TRUE
dcabccdadadbcadcc	TRUE
dccdcaddababaccdd	TRUE
dccdcbadbcdbdbbdd	TRUE
ddbadddabacbdabcd	TRUE
ddbadddacddbacabb	TRUE
aaaaaadbdcbddbcac	FALSE
aaaaacbcaaadadccb	FALSE
aaccaacccdcbbacba	FALSE
aaccabbaabdddaaac	FALSE
abbabddbdbcadacaa	FALSE
abbacabccdbbdcaad	FALSE
abddadcbabdadcaaa	FALSE
abddadddbccacacaa	FALSE
acccbcadaacbaacbd	FALSE
acccbdaddadabcaad	FALSE
adadcdadaaaadacca	FALSE
adaddbadadacddcaa	FALSE
addbbbbcaaaddbcda	FALSE
addbbdbddbaadddcc	FALSE
bacadbcabacbdcbaa	FALSE
bacaddcabcdaacdcb	FALSE
bbaddbbcbccdddcaa	FALSE
bbaddbdaaabaccbcd	FALSE
bbdcacbacccbcddaa	FALSE
bbdcaddbccccbdbaa	FALSE
bccaccbddbcbdbdaa	FALSE
bccacdabaadbbcdaa	FALSE
bdacabdaddcadcaaa	FALSE
bdacabddcbdcbacaa	FALSE
bddaacaacacbdbdac	FALSE
bddaaccaacdcbabaa	FALSE
cabccbdccaaddacdb	FALSE
cabccbddabddbcbaa	FALSE
cbabdcbbabcaccaac	FALSE
cbabddbaabaaaabaa	FALSE
cbcddacdaadcadcbb	FALSE
cbcddbbbbdabccdaa	FALSE
ccbbbbbdaaccaadab	FALSE
ccbbbcdddcbacdbaa	FALSE
cdaabdbdddbadbcdb	FALSE
cdaacaababaaababb	FALSE
cdcbdbdbaadadbbbc	FALSE
cdcbdcbdbaccccdaa	FALSE
dabaccdacccddbcaa	FALSE
dabacdbaaaadcdabd	FALSE
dadbddbcbaacbcddc	FALSE
dadbdddbacdabbaac	FALSE
dbbddcbbcaddddbaa	FALSE
dbbddcbddccdcadaa	FALSE
dcaaddbbdaadcdaaa	FALSE
dcaadddaddbcbbccb	FALSE
dccdcabaabbdaaadc	FALSE
dccdcacbacbbacbaa	FALSE
ddbadddbcbcadbaaa	FALSE
ddbbaacdddcbacaac	FALSE
abababadabcbcdadad	TRUE
abababdabbaddcddac	TRUE
abcabacabbaddcabbc	TRUE
abcabadabadbccdacd	TRUE
abdcdabadcadabdbcb	TRUE
abdcdaddabbadbbdbc	TRUE
acbcccdcccddccbcbb	TRUE
acbccdbabdbdadabbd	TRUE
acdcbccbadcabaddad	TRUE
acdcbdcdadbadcacab	TRUE
adbdabdddddabdcdca	TRUE
adbdacabdbdbabcccd	TRUE
adddacdadadaccbbac	TRUE
adddacdadaddbdbdda	TRUE
bacccdbddabdcbcdcc	TRUE
baccdacacadacbbadd	TRUE
bbadcadddaddcadadc	TRUE
bbadcbdabbcbbdacca	TRUE
bbdcabbbadbddacdcd	TRUE
bbdcabdccdcbaccdab	TRUE
bcbdbbbccccdcbbdac	TRUE
bcbdbcbbbaccdbacac	TRUE
bdacbcabbabdbadbab	TRUE
bdaccabbcdaccacbdc	TRUE
bdcdcbbdbdbddadcbb	TRUE
bdcdcbcddbadbdbdbc	TRUE
cabddcdacdccccddda	TRUE
cabddcdcabbcbbabcd	TRUE
cadcdacacdbabddcdb	TRUE
cadcdbabacadbaccdc	TRUE
cbcacadddcbddcaddb	TRUE
cbcaccabbadadadccc	TRUE
ccadbccdbbadbbcada	TRUE
ccadbdbbcbcbdddbdb	TRUE
ccdbcbdcbdcdbcabad	TRUE
ccdbcccaccbddadcbb	TRUE
cdcabadadddccadacc	TRUE
cdcabbacbbadcabbad	TRUE
dabbacabbcabadbabb	TRUE
dabbacabcbacdcbbcd	TRUE
dadbbdcbababbdbabb	TRUE
dadbbdcbdbdabdddac	TRUE
dbbdbcbacdddbdcdca	TRUE
dbbdbdbcabacabdddc	TRUE
dcacadccbbccdbcadd	TRUE
dcacbacadbabbbdadc	TRUE
dccdcddacdacbabddb	TRUE
dccddacadccaddaddc	TRUE
ddbcbbbacbdadcbacc	TRUE
ddbcbbcbccbdaddadc	TRUE
aaaaaadddcbdbabdac	FALSE
aaaaabadcadddcabda	FALSE
aaccaaacacbdabbdbb	FALSE
aaccaacacbdddbbbcc	FALSE
abbaacccbccdabcacb	FALSE
abbaacdacbcccadbcb	FALSE
abdbcddddabcabcdaa	FALSE
abdbdbbabadbddcaad	FALSE
accaddcacaaaaddddd	FALSE
accbaabccdacacdaaa	FALSE
adbacdacddcddcacaa	FALSE
adbadabadbccdccbaa	FALSE
addcddccccdacbdaaa	FALSE
addcdddccdbabdcbaa	FALSE
bacadaadacbdcddbcb	FALSE
bacadababddaaadaad	FALSE
bbadbbdbcddaddcaaa	FALSE
bbadbcacdabbcbbdaa	FALSE
bbdcaabbbadbddacdc	FALSE
bbdcabbdcbaccdaaba	FALSE
bcbdbbbccccdcbbdaa	FALSE
bcbdbcbbbaccdbabaa	FALSE
bdabccdcaacacadbab	FALSE
bdabccddcbcbcadcaa	FALSE
bdcdcbbdbdbddadcaa	FALSE
bdcdcbcddbadbdbdaa	FALSE
cabadddccbadaacbdb	FALSE
cabbaadbcccccabccd	FALSE
cadcbcbddacdbaaddc	FALSE
cadcbdbaadaaacadba	FALSE
cbcabddbcbadcbddaa	FALSE
cbcacadabadadaccaa	FALSE
ccadabbbcadaadbccd	FALSE
ccadabcdddbdbcabaa	FALSE
ccdbcbdcbdcdbcabaa	FALSE
ccdbcccabcbddadcaa	FALSE
cdcaaabcddddccadab	FALSE
cdcaabcbdcbbaccaab	FALSE
daabcacbdaabccabbc	FALSE
daabcaddadbcdbcdcc	FALSE
dadbaddaaabdbaabcd	FALSE
dadbbaacccbdddbccd	FALSE
dbbdbcbacdddbdcdaa	FALSE
dbbdbdbcaaacaadddc	FALSE
dcabcaababdbccdbca	FALSE
dcabcaabacdcddddcb	FALSE
dccdcddacdacbaaddb	FALSE
dccddabadccacdadaa	FALSE
ddbcbbbabbdaccbaac	FALSE
ddbcbbcbccbdaddaac	FALSE
abababddbdaddacdabd	TRUE
ababacdabbaccdcdada	TRUE
abcabcabacacccbadad	TRUE
abcabcabbbdbdbddcdd	TRUE
abdcddbabddabdadccc	TRUE
abdcddbacacccbcdcdb	TRUE
acbcbbacccdcaddbccd	TRUE
acbcbcadaddcbbcddab	TRUE
acdcacbbdbababccdda	TRUE
acdcaccacbcddbdacbb	TRUE
adbbdcddbcdabbaccca	TRUE
adbbddabdcccdbddcab	TRUE
addbcbbdbccdacccabb	TRUE
addbcbcadbaccddddbd	TRUE
bacacbabacbcccbdbcd	TRUE
bacacbacbcbccbcdcca	TRUE
bbabbabadcadbdabbbb	TRUE
bbabbadccdcdadacbda	TRUE
bbccccddddadbdbacac	TRUE
bbcccdcaccdccabdcac	TRUE
bcbbccddabdaddddddc	TRUE
bcbbcdbbdadbbdbddbd	TRUE
bcddadcbdabddbccbac	TRUE
bcddadcccbcdcccdcbc	TRUE
bdccbabadabcadacccb	TRUE
bdccbabbbbcbadbdacd	TRUE
cabdcdaccbadccdbbcb	TRUE
cabdcdbcabbbbdbadbd	TRUE
caddccbdcbbabbddacb	TRUE
caddccdbcabbcdabdda	TRUE
cbcadcdbddbcacdbadb	TRUE
cbcaddaddcdadadbccb	TRUE
ccadabccbcbcddcbbcc	TRUE
ccadacbbbacadcbcbbc	TRUE
ccdbbbabdddcdbabcab	TRUE
ccdbbccbadababbccdc	TRUE
cdbdaccabddabacbadc	TRUE
cdbdadcabcccabbbccd	TRUE
dabbcacdcbcdbadabcd	TRUE
dabbcbcaccdddaddcab	TRUE
dadbbacdcadcbabcbba	TRUE
dadbbadadcbacacbbbb	TRUE
dbbddadbbdccbbcccab	TRUE
dbbddbabbdddddabcdc	TRUE
dcacbadcbddcaddbabb	TRUE
dcacbadccbabddbdbbb	TRUE
dcdaccabdbddacddada	TRUE
dcdaccbacabadbddaca	TRUE
ddbcbbbdddbcdaccaca	TRUE
ddbcbcbccbbbcaddcca	TRUE
aaaaaaadcdbcadbaaaa	FALSE
aaaaaabbbdccbaadbdc	FALSE
aaccbbabbdacaddabda	FALSE
aaccbddcbabbdbadbdb	FALSE
abbbdabdbbccbddbcaa	FALSE
abbbdbbabcadbccddaa	FALSE
abddddbcddadacacaaa	FALSE
acaaaaddbbaddcdcdcc	FALSE
accbbdbbaabbddccbcc	FALSE
accbbdbbbcaddccacaa	FALSE
adacaddcdcbcdbadaab	FALSE
adacbacaaaccdcccdac	FALSE
addadabcacdabbadbaa	FALSE
addadacbdaccbadccaa	FALSE
babdadcbbacaccadbaa	FALSE
babdbaadabcabaacdac	FALSE
bbabcaadddddddacaba	FALSE
bbabcabddbcabdcaacd	FALSE
bbcdbdcdaabddabcbbc	FALSE
bbcdcaadabcabbaddcd	FALSE
bcbbcadabdcdadbcbaa	FALSE
bcbbcbbdaccacaabadb	FALSE
bdaaddbcdaabbddbaad	FALSE
bdabaacdcccaadcccbd	FALSE
bdccdcadabcdddddcaa	FALSE
bdccdcadbdcbbabdaac	FALSE
cabbbcadadbdcdadbaa	FALSE
cabbbcbadcdccdbdaaa	FALSE
cbaaabdabddccbdddaa	FALSE
cbaaacbdacdbabbcbca	FALSE
cbcdccacbaabcdcddca	FALSE
cbcdccbaadcdabbaada	FALSE
ccbaccabbdbdacabaaa	FALSE
ccbacdbddadacabcdaa	FALSE
ccdcacaaabcdbabcbab	FALSE
ccdcaccaaddaacacbbc	FALSE
cdbdbbdcdbadcbccbaa	FALSE
cdbdbcadbcadaabadbb	FALSE
daabcabccbbddcabbcb	FALSE
daabcbcdaababcababb	FALSE
dadabbaaaaadddbbaab	FALSE
dadabbdcacbabbdcdaa	FALSE
dbbcdcadddddcccbbaa	FALSE
dbbcdcbdcabddaddcaa	FALSE
dcabacbcbdabcaaacad	FALSE
dcabbaabaadbcadcccb	FALSE
dcdacddccccaddcbbaa	FALSE
dcdaddadcdcbdcdaacc	FALSE
ddbbbcabcdacaccbbaa	FALSE
ddbbbcaccbdbacaabba	FALSE
