abbbbbcccb	TRUE
abbbbbcddc	TRUE
abccccbdbc	TRUE
abcccccbdc	TRUE
abdddcbbdd	TRUE
abdddcccdc	TRUE
accbdbdccc	TRUE
accbdbdcdd	TRUE
adbbbbcdbc	TRUE
adbbbbdbdc	TRUE
adccccbccb	TRUE
adccccbdcb	TRUE
adddcdcbbc	TRUE
adddcdcccc	TRUE
bacdbbbbdb	TRUE
bacdbbbdbd	TRUE
bbacdbccdd	TRUE
bbacdcbbcd	TRUE
bbcdddabdc	TRUE
bbcddddbdc	TRUE
bcbcbddcac	TRUE
bcbcbddcbb	TRUE
bdabcdbcdd	TRUE
bdabdbbbbc	TRUE
bdccadbcbc	TRUE
bdccbacbdb	TRUE
cabdcbcbcd	TRUE
cabdcbdbbd	TRUE
cadddddccd	TRUE
cbabbbcdbd	TRUE
cbcbdcabcc	TRUE
cbcbdcbdcd	TRUE
ccaddcdcdb	TRUE
ccadddbbcb	TRUE
ccdcdabcdb	TRUE
ccdcdacdbc	TRUE
cdcacbcdcd	TRUE
cdcacbdcdd	TRUE
dabccbccdd	TRUE
dabccbcdcb	TRUE
dadbcbddcd	TRUE
dadbccbbbb	TRUE
dbbbcacbbc	TRUE
dbbbcbcadc	TRUE
dcabbbcdcd	TRUE
dcabbbdcbd	TRUE
dccdbdbbcc	TRUE
dccdcabbcc	TRUE
ddbbccdacb	TRUE
ddbbccdcad	TRUE
aaaaaabccb	FALSE
aaaaabbdcc	FALSE
aaccabddaa	FALSE
aaccbabaad	FALSE
abbbdabccb	FALSE
abbbdadbab	FALSE
abddaaaabc	FALSE
abddaaacda	FALSE
accbdbcbab	FALSE
acccaaddaa	FALSE
adadcdaabc	FALSE
adaddaacba	FALSE
addaddccad	FALSE
addbaababd	FALSE
babdabbcac	FALSE
babdadabaa	FALSE
bbacabccbc	FALSE
bbacabcddb	FALSE
bbdacdbbba	FALSE
bbdacddcac	FALSE
bcbcdddaba	FALSE
bcbcdddbaa	FALSE
bdabdadbba	FALSE
bdabdcacba	FALSE
bddaabbcda	FALSE
bddaabccca	FALSE
cabcabbabd	FALSE
cabcabcaad	FALSE
cadddcdcac	FALSE
caddddaabc	FALSE
cbcccaaabc	FALSE
cbcccacada	FALSE
ccbaaacabd	FALSE
ccbaaadbaa	FALSE
ccdbdabdab	FALSE
ccdbdadcda	FALSE
cdbdacdcab	FALSE
cdbdacddca	FALSE
daacdabbcb	FALSE
daacdadbcc	FALSE
dacdcdadcd	FALSE
dacddaacbc	FALSE
dbbdbddcaa	FALSE
dbbdbdddaa	FALSE
dcabcaabcb	FALSE
dcabcbbcda	FALSE
dccddcdaaa	FALSE
dccddcdbaa	FALSE
ddbbbdddaa	FALSE
ddbbcaaabd	FALSE
abbbbbbcbbc	TRUE
abbbbbbdcbb	TRUE
abcccbcbccb	TRUE
abcccbcbcdc	TRUE
abddcbcbbcc	TRUE
abddcbcdcbc	TRUE
accbdccddcb	TRUE
accbdcddddb	TRUE
acddcbbbdcb	TRUE
acddcbccbcc	TRUE
adcbcdcbdbc	TRUE
adcbcdcdddc	TRUE
addccccbddb	TRUE
addccccdbbb	TRUE
bacbcdccdcd	TRUE
bacbcddbdcb	TRUE
bbabddddbcc	TRUE
bbacbbbbbdd	TRUE
bbcdcadbccc	TRUE
bbcdcaddcbb	TRUE
bcbbbdbddcd	TRUE
bcbbbdddccc	TRUE
bcdddddbdbc	TRUE
bdabbbdbbdb	TRUE
bdcdbabbccb	TRUE
bdcdbabcbcd	TRUE
cabdcdbbbdb	TRUE
cabdcdbbccc	TRUE
cadccdbbcbd	TRUE
cadccdbdbcc	TRUE
cbcaccdccbb	TRUE
cbcacdbbbbb	TRUE
ccadbdbdddd	TRUE
ccadbdcdbbd	TRUE
ccdcabccbbd	TRUE
ccdcabdbbbd	TRUE
cdcbaddbddb	TRUE
cdcbaddcddc	TRUE
dabcddcbcdd	TRUE
dabcddccdcc	TRUE
dadcdbbbdcd	TRUE
dadcdbbcdcb	TRUE
dbcaccccdbd	TRUE
dbcaccdbbbd	TRUE
dcaccddccbc	TRUE
dcaccdddccc	TRUE
dccdcbabbdb	TRUE
dccdcbadbbc	TRUE
ddbbccbdcad	TRUE
ddbbccccbdb	TRUE
aaaaaabccbc	FALSE
aaaaabbcccd	FALSE
aacccddabdd	FALSE
aaccdcaadcb	FALSE
abbaadcddba	FALSE
abbababdddd	FALSE
abdccdaadca	FALSE
abdccdbcaba	FALSE
accacacbccc	FALSE
accacdbbbbd	FALSE
adacdacdadb	FALSE
adacdbdacab	FALSE
addacbbadbd	FALSE
addaccbcdbc	FALSE
babcbcddcad	FALSE
babcbddbacd	FALSE
bbabcaabadb	FALSE
bbabccbbcad	FALSE
bbcdcadabcc	FALSE
bbcdcaddbaa	FALSE
bcbbbdbddaa	FALSE
bcbbbdddcaa	FALSE
bcdddddbdaa	FALSE
bdaaaababcb	FALSE
bdcdbaaacca	FALSE
bdcdbaabbbd	FALSE
cabadacdcaa	FALSE
cabadadcddb	FALSE
cadbdacccca	FALSE
cadbdbcbaca	FALSE
cbcacaccaab	FALSE
cbcacbaadbc	FALSE
ccadacbaddd	FALSE
ccadacbbacd	FALSE
ccdcabbacaa	FALSE
ccdcabbbdad	FALSE
cdcbaddaddb	FALSE
cdcbaddcdda	FALSE
daacddcabcb	FALSE
daacdddbdda	FALSE
dadbbbacbba	FALSE
dadbbdadaac	FALSE
dbcabccdadb	FALSE
dbcabcdbaaa	FALSE
dcacaabbacb	FALSE
dcacabbabad	FALSE
dccdcbaaada	FALSE
dccdcbadabc	FALSE
ddbbccbdcaa	FALSE
ddbbccccbaa	FALSE
abbbbbbcbbcc	TRUE
abbbbbbdbcdb	TRUE
abccbddcbbcd	TRUE
abccbddccbbd	TRUE
abddcbdbcbdb	TRUE
abddcbdbdcbc	TRUE
accbddbbcbdb	TRUE
accbddbcdbbb	TRUE
acddcdbbdcdd	TRUE
acddcdbccbdd	TRUE
adcbcdbcddbb	TRUE
adcbcdcddcbd	TRUE
addcdcbcdcdb	TRUE
addcdcbdbbcc	TRUE
bacbdddddccd	TRUE
baccbbbccdbc	TRUE
bbaccccbddcb	TRUE
bbacccdbcdcb	TRUE
bbcddddbbddc	TRUE
bbdabbddcbcd	TRUE
bcbcdadddcdd	TRUE
bcbcdbccbbad	TRUE
bdacbdccdcdb	TRUE
bdaccbcccddb	TRUE
bdcdcbcaddcd	TRUE
bdcdccbbbdba	TRUE
cacbcccbdcbd	TRUE
cacbcdcbbddb	TRUE
caddddcccddd	TRUE
cadddddbccdc	TRUE
cbcadcdcdbbc	TRUE
cbcaddcbbbbc	TRUE
ccbadcccdbdb	TRUE
ccbaddbcdbdd	TRUE
ccdcddbdabdd	TRUE
ccddabcbdbdb	TRUE
cdcbcdcdcccb	TRUE
cdcbdadcdccc	TRUE
dabcbdbccdbb	TRUE
dabcbdbddbdb	TRUE
dadbbdbdbdbd	TRUE
dadbbdcbbdcd	TRUE
dbbabcbcccbc	TRUE
dbbabccbcccc	TRUE
dbdddcbacdcb	TRUE
dcabbbbbcccb	TRUE
dcccbdbbdbcc	TRUE
dccccbdcadcb	TRUE
ddbbcaddbdbb	TRUE
ddbbcbbbdacc	TRUE
aaaaaadccdaa	FALSE
aaaaabcaccbd	FALSE
aaccaddcbcdc	FALSE
aaccbbddcadc	FALSE
abbbaccdccbd	FALSE
abbbacdaaaab	FALSE
acaaaaaaddcd	FALSE
acaaaabacdba	FALSE
accbbcbdbcba	FALSE
accbbccdcabc	FALSE
adadacbbaacd	FALSE
adadadbaccdb	FALSE
addacabaaacd	FALSE
addacabbbcba	FALSE
babccdaabdca	FALSE
babcdababaad	FALSE
bbabacbadaba	FALSE
bbabadbbdabc	FALSE
bbccdababacb	FALSE
bbccdadbdbba	FALSE
bcbacdcaddad	FALSE
bcbadaacbbdd	FALSE
bdaaabbaaaab	FALSE
bdaaacacbcca	FALSE
bdccaacadddb	FALSE
bdccaaccabaa	FALSE
cabaabbbdaba	FALSE
cabaabbdbada	FALSE
cadcadbaccbb	FALSE
cadcadddcaaa	FALSE
cbcabcadbdda	FALSE
cbcabcbbddba	FALSE
ccacbcdbccba	FALSE
ccacbdacbabb	FALSE
ccdaccbbdaaa	FALSE
ccdaccdcacaa	FALSE
cdbdbbbcdbaa	FALSE
cdbdbbdcdbaa	FALSE
daaccdacbdbb	FALSE
daacdaaacdca	FALSE
dadbbbcbbaaa	FALSE
dadbbbccbabd	FALSE
dbbdacdbcbca	FALSE
dbbdacdcdaac	FALSE
dcaadbbbcbcc	FALSE
dcaadbbddbbb	FALSE
dccdcbabacdb	FALSE
dccdcbabddda	FALSE
ddbbbbadaccd	FALSE
ddbbbbcaccac	FALSE
abbbbbbbbbcbc	TRUE
abbbbbbbbdbdc	TRUE
abcccbdbdbbcb	TRUE
abcccbdbddcdb	TRUE
acbbbcbcccccc	TRUE
acbbbcdcdbcbd	TRUE
acccbddbcbbdb	TRUE
accccbccdddcb	TRUE
acddcdbdbbcbc	TRUE
acddcdbddcbcd	TRUE
adcbdbdcbdcdd	TRUE
adcbdbddcbcdd	TRUE
addccdbcbcccd	TRUE
addccdcbcbcbd	TRUE
baccccbddcbdb	TRUE
bacccccbccbbd	TRUE
bbacdbdccddcb	TRUE
bbacdbddbdccb	TRUE
bbdaccbbcbccc	TRUE
bbdaccbcddbcb	TRUE
bcbcbdcdacbcd	TRUE
bcbccabdbdddb	TRUE
bdabbdcddbbbb	TRUE
bdabbddddbbbd	TRUE
bdcbdcbccbdac	TRUE
bdcbdcdbbddcc	TRUE
cabdccbbcbdcd	TRUE
cabdccbcccdcb	TRUE
caddddbdcbbbb	TRUE
caddddbdcbbbc	TRUE
cbccacbcdbdbd	TRUE
cbccaccbdccdd	TRUE
ccbadbdcccbdb	TRUE
ccbadcbbdcdcd	TRUE
ccdcbbadcbdbc	TRUE
ccdcbbbcbbacd	TRUE
cdcacbdbddcbb	TRUE
cdcacdbbbcddd	TRUE
dabcbddcbddcd	TRUE
dabcbddcddcbc	TRUE
dadbcddbdbbcd	TRUE
dadbcddcdbcbb	TRUE
dbbadbddccbdd	TRUE
dbbadcbcbdbcb	TRUE
dbddccbbbdcac	TRUE
dbddcdddccdac	TRUE
dccccabdbcbdb	TRUE
dccccacbdccbc	TRUE
ddbbbdbccbdcd	TRUE
ddbbbddabbdbb	TRUE
aaaaaadccdaab	FALSE
aaaaabaccbdaa	FALSE
aaccabcbabbbd	FALSE
aaccbddcdccac	FALSE
abbbcddbcbdda	FALSE
abbbdaabdaabc	FALSE
acaaabaabaaac	FALSE
acaaabbababca	FALSE
accbccbddbdaa	FALSE
accbcccbdbcba	FALSE
adadbddcaadab	FALSE
adadcaaababac	FALSE
addbabdbbbacb	FALSE
addbadbabdcaa	FALSE
babdcdcbbabda	FALSE
babdcddaacabd	FALSE
bbabdddcbcdda	FALSE
bbacabdabacbd	FALSE
bbdabbbcdadad	FALSE
bbdabbcacdbbd	FALSE
bcbcbdcdacacd	FALSE
bcbccaacadcda	FALSE
bdaabcdaaaaaa	FALSE
bdaabcdbadadc	FALSE
bdcbdcbccbdaa	FALSE
bdcbdcdbbddaa	FALSE
cabacbbdadddb	FALSE
cabacbbddcadc	FALSE
cadddacccdadd	FALSE
cadddadccacac	FALSE
cbccabacdadad	FALSE
cbccabcadbcdd	FALSE
ccbadcddccadb	FALSE
ccbaddacccccd	FALSE
ccdcbbaddadac	FALSE
ccdcbbbcbbaba	FALSE
cdcabbdcaddba	FALSE
cdcabccbcaabc	FALSE
daabddaacaabc	FALSE
daacabcdddacb	FALSE
dacdcdcdbabba	FALSE
dacddabbabdcc	FALSE
dbbadbdcbcdba	FALSE
dbbadbddadbba	FALSE
dbddccbbbdcaa	FALSE
dbddcdddccdaa	FALSE
dccccaadabaca	FALSE
dccccacacbbac	FALSE
ddbbbdbccbdaa	FALSE
ddbbbddabacaa	FALSE
abbbbbbbbdbdcb	TRUE
abbbbbbcdcbdbc	TRUE
abccccbbcdbbdb	TRUE
abccccbccdbbcc	TRUE
abdddbcbdbdddd	TRUE
abdddbcbddbdcc	TRUE
acccbbccbbdbbb	TRUE
acccbbccddcccc	TRUE
acddcbdddbdcdc	TRUE
acddccbcbdcbbb	TRUE
adcbdcddbcbcbd	TRUE
adcbddbbcccbcb	TRUE
adddcbddcbcccb	TRUE
adddcbddccddcb	TRUE
baccddcddbdccb	TRUE
bacdbbbbcddbdd	TRUE
bbadcccbbccdbc	TRUE
bbadccdcbccccd	TRUE
bbdbdbddbccdad	TRUE
bbdbdcdbddbacc	TRUE
bccbbacdbbdddc	TRUE
bccbbbbcdcadcc	TRUE
bdadbbdddcbcdd	TRUE
bdadbcbcdcddbb	TRUE
bddabbdcddcdbc	TRUE
bddabcbdcbcdbd	TRUE
cacbdbdbbbcddc	TRUE
cacbdbdcbdcbbb	TRUE
cadddddcdcbbdc	TRUE
cbabbbdccddbcb	TRUE
cbcccabcbbddbb	TRUE
cbcccacdbcddcd	TRUE
ccbbccbcaddbcc	TRUE
ccbbccddccaddc	TRUE
cdabbbbddcdcbb	TRUE
cdabbbdcddddbb	TRUE
cdccacbccbddcb	TRUE
cdccaccddcccdc	TRUE
dabdbbddccdbdc	TRUE
dabdbcbbbcbdbb	TRUE
daddbdcbccbcbd	TRUE
daddbdcbcccbdc	TRUE
dbcabcdbcbbbdd	TRUE
dbcabdcbbcbdbc	TRUE
dcacbbbbdbbbcc	TRUE
dcacbcbbbcdcbb	TRUE
dcdabbdcdcbccb	TRUE
dcdabcdcbccbbb	TRUE
ddbbcdadcddbbb	TRUE
ddbbcdbdddbbbb	TRUE
aaaaaabbcbbdab	FALSE
aaaaacaaccdbca	FALSE
aaccccbabbaadd	FALSE
aacccdaabaabba	FALSE
abbaddcbbcccbd	FALSE
abbaddddcaaaba	FALSE
abdcdbddadbacd	FALSE
abdcdcaabcbcda	FALSE
accbdcddbdabcc	FALSE
accbddcacdbadc	FALSE
adbabddcaacbda	FALSE
adbabddcdcbcdd	FALSE
addcbdbdddaabd	FALSE
addcbdcddddbda	FALSE
bacbabdcaabdbc	FALSE
bacbaddccadaac	FALSE
bbadbdbbcdabbc	FALSE
bbadbddaaabddb	FALSE
bbdbdbddbccdaa	FALSE
bbdbdcdbddbaca	FALSE
bccbbacdaadccc	FALSE
bccbbbbcdcadca	FALSE
bdacdadcbbbddb	FALSE
bdacdbdadbddab	FALSE
bddaacdddaabab	FALSE
bddaadaaaaaddb	FALSE
cabccabdcadbcd	FALSE
cabccbbbacdbcd	FALSE
caddddadcbbacb	FALSE
cbaaaaccbcccdd	FALSE
cbcccaacabcdaa	FALSE
cbcccacdacddbd	FALSE
ccbbccbcaddacc	FALSE
ccbbccddccadda	FALSE
cdaaabbbccabad	FALSE
cdaaabdabbcacb	FALSE
cdccacabbaddbb	FALSE
cdccacbddbccca	FALSE
daadcdabbabbab	FALSE
daadcdbcbbadaa	FALSE
dadbdadaaabbcd	FALSE
dadbdadadcbdab	FALSE
dbcaacdababadd	FALSE
dbcaadbaabacab	FALSE
dcabbdaaaadaad	FALSE
dcabbdbcccabac	FALSE
dcdaaadbbddbcc	FALSE
dcdababbaaaaac	FALSE
ddbbcdadbcdaba	FALSE
ddbbcdbdddbbaa	FALSE
abbbbbbddcbbcbb	TRUE
abbbbbdbbbbcddb	TRUE
abcccccdcbbccdc	TRUE
abcccccdcbcccdd	TRUE
acbbbcdbccccbcb	TRUE
acbbbcddcddbbcc	TRUE
acccdcbdbddbcdb	TRUE
acccdccbddccccd	TRUE
adbbccbdccccbbd	TRUE
adbbcccbdcbdcbc	TRUE
adccdbcbcdcdbdc	TRUE
adccdbdbcbcdccc	TRUE
babbbdbdbbdbddc	TRUE
babbbdccbbdcdbc	TRUE
bacddbbbbbbbdcd	TRUE
bacddbbbcbddbcc	TRUE
bbbbbcdccdadcdd	TRUE
bbbbcabcbcbbbcd	TRUE
bcabbcddbcdbbcd	TRUE
bcabbdbbccdbdbc	TRUE
bccdbbbbbbdbcbb	TRUE
bccdbcbccdaccdd	TRUE
bdbbabbdbbbcbcc	TRUE
bdbbabcbbdccddb	TRUE
bddddbdbdddcbca	TRUE
bddddcbdabbcbdd	TRUE
cacddddbbcdbbcb	TRUE
cadbbbbbbcccccb	TRUE
cbbaddcbdbbdbcc	TRUE
cbbbabbbdcccccc	TRUE
cbdccbdbadccbcb	TRUE
cbdccbdbdacbcdc	TRUE
ccccabcdcbbcbcd	TRUE
ccccacbbbcdbcdd	TRUE
cdbacbccdccccbc	TRUE
cdbacbdbdbdccbb	TRUE
cddbbadbcddbdbd	TRUE
cddbbadcddcbcdb	TRUE
dacbddcdbccdbdc	TRUE
dacbdddbcbddcdb	TRUE
dbabcbcbbccdbdc	TRUE
dbabcbccbbdbdcd	TRUE
dbcbccabbbdcddb	TRUE
dbcbccacbdbdccb	TRUE
dcadcdcbbcbcdcd	TRUE
dcadcdddbcdbbcc	TRUE
dcdabdbbbdcbbcc	TRUE
dcdabdbbdcdbbcc	TRUE
ddbcbbadcbcccbb	TRUE
ddbcbbdbacbbdbb	TRUE
aaaaaaadbdccdca	FALSE
aaaaabbcabdcccb	FALSE
aaccdccbbaaabbd	FALSE
aaccddabbddccad	FALSE
abbbababdbaadab	FALSE
abbbacabddccaca	FALSE
acababacdbdbaac	FALSE
acabaccbaaaabaa	FALSE
accdaddadbdcadb	FALSE
accdbaabccccdab	FALSE
adbcbdabbcaadbd	FALSE
adbcbdbdbbdbaad	FALSE
baaabbccdcdaacd	FALSE
baaabdddacdaaba	FALSE
bacbdddadadaaba	FALSE
baccaaabadcaaca	FALSE
bbbbbcdccdadbda	FALSE
bbbbcaabdababab	FALSE
bcaaadddbbbaccd	FALSE
bcaaadddcdacccc	FALSE
bccdbbbbbbdbcaa	FALSE
bccdbcbccdacbda	FALSE
bdbbaababbcbcda	FALSE
bdbbaabaddcbdda	FALSE
bddddbdbdddcbaa	FALSE
bddddcbdaabbbdd	FALSE
caccabdbabcbbda	FALSE
caccadbddabaddd	FALSE
cbbadcdddbbdabb	FALSE
cbbbaaacbaaddcb	FALSE
cbdccbdbadbbbba	FALSE
cbdccbdbdacabdb	FALSE
ccccaabdcaacabc	FALSE
ccccabcccaaabca	FALSE
cdbabdbcabddbad	FALSE
cdbabdcacacbcbb	FALSE
cddbbadabddacad	FALSE
cddbbadbddcbbda	FALSE
dabcddddacdbaca	FALSE
dabdaacadabbaad	FALSE
dbaacbcddabdbda	FALSE
dbaaccadbcccddb	FALSE
dbcbccaaaadbdcb	FALSE
dbcbccabadadbca	FALSE
dcadbcbbbaadccd	FALSE
dcadbdacdaaccba	FALSE
dcdaacdacbadadb	FALSE
dcdaacdcccadbda	FALSE
ddbcbbadbabbbaa	FALSE
ddbcbbdbacaacaa	FALSE
abbbbbbbccbbbbdc	TRUE
abbbbbbcdbbdccbc	TRUE
abcccdbddbbccddd	TRUE
abcccdcdbdbbdcdc	TRUE
abdddccbcdddbbdb	TRUE
abdddccbdbcbbdbc	TRUE
acccbddbccbbdbbd	TRUE
acccbddddcbcdbbd	TRUE
acdcddbcbccbcdcd	TRUE
acdcddcdbccbbddc	TRUE
adbdddbdbbbcdcdb	TRUE
adbdddbdddcdcddd	TRUE
addcbddbbcdddddd	TRUE
addcbddbcbbcdbdc	TRUE
bacbcbdbbbcddbbc	TRUE
bacbcbddbbbcdbbd	TRUE
badddccbbdddcbdc	TRUE
badddccccdccddbc	TRUE
bbcbcdacbddccccb	TRUE
bbcbdadcdbcddcbd	TRUE
bcbadcbdcdbbbbbc	TRUE
bcbadcdbbdcbbbdb	TRUE
bcddcdcbcddcddad	TRUE
bcdddbbacbcbccbb	TRUE
bddabbbdddcbcdbc	TRUE
bddabbcbdbcdccbd	TRUE
cacbcbcbbcccdbbb	TRUE
cacbcbcccbcdcddd	TRUE
caddddccdbdbdbdb	TRUE
cadddddcbcbcbdcb	TRUE
cbcbabdddcbdcdcc	TRUE
cbcbaccdccbddcdd	TRUE
ccadbbdbdccddbbd	TRUE
ccadbbdbdcdcbdcb	TRUE
ccdacddbdccbdcbd	TRUE
ccdacdddbdbdcccc	TRUE
cdbcadcbdddbbbcc	TRUE
cdbcadccccbdbdcb	TRUE
dabbdcbbcdbbbdbd	TRUE
dabbdcbbcdbbdbbd	TRUE
dadbcccdbbbcccdc	TRUE
dadbcccdddbcbcbb	TRUE
dbbbbdcccbdbabbb	TRUE
dbbbbddabbcbcdcd	TRUE
dcabbbbbbddbcbdc	TRUE
dcabbbbdbbcdbccd	TRUE
dccdbdcdacdddccd	TRUE
dccdcabbbcbcdbbb	TRUE
ddbaddddccbcddcd	TRUE
ddbbacbcbddccddb	TRUE
aaaaabadbbcdcdaa	FALSE
aaaaacbdccbddaad	FALSE
aacdbbdaabcdadda	FALSE
aacdbcacadcacbda	FALSE
abbacdbccbbbcddd	FALSE
abbadbcaadbcbdac	FALSE
abdcaabbbdcbbdad	FALSE
abdcaadadadbadac	FALSE
accadbbbcbcaaacc	FALSE
accadbdaacdcdaaa	FALSE
adacbcbacbaaabaa	FALSE
adaccbbacdddbcaa	FALSE
adcdcccbaacaccad	FALSE
adcdcdadaabbbcda	FALSE
babbbddbadaacbac	FALSE
babbcbcaadcdabca	FALSE
badddbccbbdccaac	FALSE
baddddabddbdcbdd	FALSE
bbcbcdabadcbbbca	FALSE
bbcbdadbcabddbad	FALSE
bcbadacdadccaaaa	FALSE
bcbadadcbbadadca	FALSE
bcddcdcbcddcddaa	FALSE
bcdddbbacababbaa	FALSE
bddaaacadcaddcca	FALSE
bddaaacddbacadac	FALSE
cabbdbbddabddcdc	FALSE
cabbddccbbcbdcda	FALSE
caddddcbcbdbdaca	FALSE
cadddddcbbabacba	FALSE
cbcbabbccbdbcbba	FALSE
cbcbabcdcbaddcdd	FALSE
ccaccbbacbbcbcdb	FALSE
ccacdaacabaaccaa	FALSE
ccdaccacbdbbccbb	FALSE
ccdacccacbcccbac	FALSE
cdbcadcabdacaaac	FALSE
cdbcadcddbcbcadc	FALSE
daabcabcdbaabcca	FALSE
daabcbbacadadada	FALSE
dacdadcabdcdaaba	FALSE
dacdbaacbbadccaa	FALSE
dbbbbdcccbdbaaab	FALSE
dbbbbddaaababdcd	FALSE
dcaaaabbdddcabbd	FALSE
dcaaaacaccacbdac	FALSE
dccdbdcdacdcdcba	FALSE
dccdcaaaabacdaba	FALSE
ddbaddcbccabdccd	FALSE
ddbbacacacdcbdda	FALSE
abbbbbbbccdbbccdc	TRUE
abbbbbbcbcbdbbcbc	TRUE
abccccbdccdbdcbbd	TRUE
abccccbddbbddcbbb	TRUE
abdddbbdcbdbbdcdc	TRUE
abdddbcbcbbbdbdbc	TRUE
acccbbbcccdcdbbbb	TRUE
acccbbccdbcdcbbbb	TRUE
acddbcbdbbcbcbccc	TRUE
acddbcbdcbddcdccd	TRUE
adccbbbbbbbdbdbdd	TRUE
adccbbbbcdddbbbcd	TRUE
adddcbcbbbcbddddb	TRUE
adddcbcbbcbdddcbb	TRUE
bacdbbbbdbdccdbdc	TRUE
bacdbbbccbdbcbccd	TRUE
bbadbbdbddbddccbc	TRUE
bbadbbdcdcbdccddb	TRUE
bbdbbcbcbdccbbcda	TRUE
bbdbcccbbcbbccbcd	TRUE
bcbdbccabcdcccddd	TRUE
bcbdbdadcbccbdbbd	TRUE
bdacbbbbbbbdddbbc	TRUE
bdacbbbbccdcbdbcb	TRUE
bddabcccbddbbccdc	TRUE
bddacbccccbcbbddd	TRUE
cacbdcbcbbcdbcdbb	TRUE
cacbdcbcbdddbccbb	TRUE
cadddcbbddcccdcbc	TRUE
cadddcbcbccdbbcbd	TRUE
cbccabdcddbbbbdbb	TRUE
cbccacdcbbbdcbddd	TRUE
ccadccbddccbbdbbd	TRUE
ccadcdbcccdddbbbc	TRUE
ccdbabcbccddcccbd	TRUE
ccdbabcbcdbbccbdc	TRUE
cdbccabccbccdbdbc	TRUE
cdbccabdbcdcdcdcd	TRUE
dabbccbdbbcbcbbdc	TRUE
dabbccccccbbbbbcb	TRUE
dadbcddddbcbcbbdb	TRUE
dadbdbcbccbbbcdbb	TRUE
dbbcaccccbccdbbcc	TRUE
dbbcadbbbcdddddbd	TRUE
dcabdcbbcddbbddcc	TRUE
dcabdcbdcbdbcdbdd	TRUE
dccdadbcdddddcdcb	TRUE
dccdadcddbdcbdbcc	TRUE
ddbbdcccbdcbacbcd	TRUE
ddbbddbadddcbdcdd	TRUE
aaaaaaacbbcadddcd	FALSE
aaaaabdbddabbbdaa	FALSE
aacbbbdacaabccacd	FALSE
aacbbcaabbcbababb	FALSE
abadabcadcbcbbcbd	FALSE
abadabdbaabcdbdab	FALSE
abcddbcacaaacccbd	FALSE
abcddcaadddabdacd	FALSE
acbccdbdabbbacccd	FALSE
acbccdccacbdbbadc	FALSE
adabbcbcacbdcacbc	FALSE
adabbccbccaadcadc	FALSE
adcdbdadabbabdabd	FALSE
adcdbdbbcabdbcbcc	FALSE
babadaadcdaaaaccd	FALSE
babadabadbbcbabac	FALSE
badcdbaaaabbbaaba	FALSE
baddabadabacdaacb	FALSE
bbcadbdaaaacdbadd	FALSE
bbcadcabddcbccbdd	FALSE
bcacacdcadbdacbcd	FALSE
bcacaddacabaccdcc	FALSE
bcdaccbcabdabcdca	FALSE
bcdaccdbcbbdaadbb	FALSE
bdbcdbbbacaddabcc	FALSE
bdbcdcbcdbbaacdab	FALSE
caabdaacacdaaaabd	FALSE
caabdbbcabbbbaaaa	FALSE
cacdbcdbbcacbbbbb	FALSE
cacdbddabacacbcda	FALSE
cbbbbbcddcadddadc	FALSE
cbbbbcdccabdbcbca	FALSE
ccaabdbadccddbbba	FALSE
ccaacbdaaaddbdabb	FALSE
ccdadbccbcabaacbc	FALSE
ccdadccdadcaccbcc	FALSE
cdbdbcbdabccdbabb	FALSE
cdbdcaadbacbcbcca	FALSE
daabbaabbbbaccdbb	FALSE
daabbbdcdddccbacd	FALSE
dacdccbbadddabcac	FALSE
dacdccbccabacdbda	FALSE
dbbdaaccdbbdbcbaa	FALSE
dbbdabcdaadbcbcaa	FALSE
dcabbdaadbcdbbbdd	FALSE
dcabbdacbdddbaaad	FALSE
dccdbdcadacabcbca	FALSE
dccdbdcccababdabb	FALSE
ddbbcbbbaaaadcccc	FALSE
ddbbcbdbdcbddacad	FALSE
abbbbbbbbbcbcdcbcb	TRUE
abbbbbbddccbbdbdcc	TRUE
abccbbbcdbbdbbbdcd	TRUE
abccbbbddbbbddcddd	TRUE
abdcdccbddccbbcddb	TRUE
abdcdcccbdcbccbdbb	TRUE
acbddcbcdbbdcccdcc	TRUE
acbddccddbbddddbbd	TRUE
acdcbcdbbcccbcbbbd	TRUE
acdcbcdcdcbdddcddd	TRUE
adcbbcbcbdbccddbdb	TRUE
adcbbcbcbdcbbdddbb	TRUE
addcbdbddcbbbdbcdd	TRUE
addcbdbddddbcdccbc	TRUE
bacbbbbdbbbccdddbd	TRUE
bacbbbdbcbcdbcbddc	TRUE
bbabbbbbbbddcbdccc	TRUE
bbabbbcccbbdcdcccb	TRUE
bbcadcbdddbdbcdcdd	TRUE
bbcadcdcdcbcbbdbdc	TRUE
bcaddccbbbcdbbbcbc	TRUE
bcaddccbbdbbbbdddd	TRUE
bcdbbbbddabddbbcdb	TRUE
bcdbbcacddbcbdcbbd	TRUE
bdbcbccbadcdddbcbd	TRUE
bdbcbcdadcdccccbdd	TRUE
cabbddcdcbbccddcbc	TRUE
cabbdddbbcdbddddcc	TRUE
cadbbddccbccbcccdd	TRUE
cadbbddddddcbcbbcd	TRUE
cbbcacbcdcccdcddbb	TRUE
cbbcadccddbcdbcdcc	TRUE
ccacdcbcbdccbcbdbb	TRUE
ccacdccbdcbccbbbcb	TRUE
cccddbbdcadddccdcb	TRUE
ccdabbbbcdbdcdbddc	TRUE
cdbbdcddcdadbcdbdb	TRUE
cdbbddabdddcbccbcc	TRUE
dabbdbbddcddcbbdbc	TRUE
dabbdbdcbcddcdddbb	TRUE
dadbdcbdcbbbbdbddc	TRUE
dadbdccbdcdcbcbbcb	TRUE
dbbcacbccddcbcccdc	TRUE
dbbcadbdbbbdcdcddd	TRUE
dcacbbcdccdccdbcbb	TRUE
dcacbbddcdddbdbccb	TRUE
dcccdbabcddbcdcbbb	TRUE
dcccdbdabdbdbcdcdc	TRUE
ddbbabbcdccbbccbcc	TRUE
ddbbabbddbbbcbbcbb	TRUE
aaaaaaacbbcaadadcb	FALSE
aaaaaadddbbbbbbaab	FALSE
aacdadcccdccabdcab	FALSE
aacdbacdacaabdabcc	FALSE
abbbccccbdbdbcccab	FALSE
abbbcdacbabaaadbba	FALSE
abddddbdacbaddadda	FALSE
acaaaabbddaadcaaac	FALSE
accbbddaddbcbadcbc	FALSE
accbbddcbdaccbcadb	FALSE
adbbacadcabbabccab	FALSE
adbbacbaababbaadca	FALSE
baabbdcacadabddabd	FALSE
baabcaacdbcdddabbc	FALSE
bacdbdbccbbadcdcbc	FALSE
bacdbdbddbdcacbadd	FALSE
bbbbbadccadcabbbdc	FALSE
bbbbbcaaaacabcdaca	FALSE
bbddbbbdbbbacbacdb	FALSE
bbddbcbadadbacdccd	FALSE
bccadbdcaadcdbaabd	FALSE
bccadcdcdbbbabcaca	FALSE
bdacbbbacdccdccdca	FALSE
bdacbcbabbbdbcbaaa	FALSE
bdcdcdcdaacabccbdc	FALSE
bdcddaadddbaabbcdc	FALSE
cabcbbdabadcaababc	FALSE
cabccabcabcacccbdc	FALSE
cbabcccabcaddccddd	FALSE
cbabcccadabaadacaa	FALSE
cbccdcbbdcdcaddcca	FALSE
cbccdcccabbcdcadbd	FALSE
ccbaacdbcbddcddddb	FALSE
ccbaaddcbdddcbbbaa	FALSE
ccdcaccbddbdbbbbca	FALSE
ccdcadbdacaaacdaab	FALSE
cdcadabdacbaccdabc	FALSE
cdcadacdbcccaabcbb	FALSE
daacadadbdbbacabba	FALSE
daacadcbbbbcbddbbb	FALSE
dadaaacadbadabbaab	FALSE
dadaacabaddcdcaaba	FALSE
dbbcdaadabddabcacc	FALSE
dbbcdbcbcaccbbdaba	FALSE
dcaacbbdcaaccdcabc	FALSE
dcaacbbddacccdcbaa	FALSE
dccdccbbcddbccbdaa	FALSE
dccddacabaabcbddba	FALSE
ddbcbbcaccadcaabcb	FALSE
ddbcbcabbbbcdbabcc	FALSE
abbbbbbdddcdbcbbcdc	TRUE
abbbbbcbdbcccbddccb	TRUE
abccbcbbccccbbdbccc	TRUE
abccbccdbddddddbdbd	TRUE
abdcdccddccbcccbcbc	TRUE
abdcdcdbbdcdccbbccd	TRUE
accbbbccbddcdddcccb	TRUE
accbbbcdbdbcdbcdbdd	TRUE
acdcdcdccdbbcdbcdcd	TRUE
acdcdcddcccbbbcbbbd	TRUE
adbdddcccdcdbbcddbd	TRUE
adbdddcccdcdcbbcccd	TRUE
addbddbcccbdcbddbdc	TRUE
addbdddbbccbddccccc	TRUE
bacbddbdcdcbbcccccc	TRUE
bacbdddbbddccccbbcd	TRUE
bbadbbcbbbccbbdddcd	TRUE
bbadbbdbbbbbbbdcbcb	TRUE
bbdadbddcdcccdbdcdb	TRUE
bbdadcbcbcdcddbccbd	TRUE
bcbcdaccccccddcdcdb	TRUE
bcbcdbccadddbcbcbdc	TRUE
bdacdcbddccdbdbddbd	TRUE
bdacdcccbbccccdbcdd	TRUE
bddabcbbbbcdbccdcbd	TRUE
bddabcccdcdcdcddddc	TRUE
cacbcbbcdbdbdcbbbdb	TRUE
cacbcbcbbcbdccbdcbc	TRUE
caddccddcbdbbbbdddc	TRUE
cadddbbddcddbbccdcd	TRUE
cbcadccbcbdbbdbdbbd	TRUE
cbcadcdddddbcbcdcdc	TRUE
ccadbdddbdbbdcbdddd	TRUE
ccadccdcbcdccdbbbdb	TRUE
ccdcbbdddddcbbbcdbd	TRUE
ccdcbccbbccbabbbbcb	TRUE
cdcabddbbddccbbbbcd	TRUE
cdcabddddbcdcbbcddc	TRUE
dabcdcbcdddccbcddbd	TRUE
dabcdccbbdccdcbcbcc	TRUE
dadcccddbccccbbddcb	TRUE
dadcdbbdddcbcbcbbcb	TRUE
dbbcddabbbcddbdcdbc	TRUE
dbbcddabbcdbcccdbcd	TRUE
dcaccbccddbddcdbddd	TRUE
dcaccbcddcdccbccbdb	TRUE
dcdabbdcbdcbcbdbdbb	TRUE
dcdabbdccdbddbccbcd	TRUE
ddbabdcddddbdbbbbcb	TRUE
ddbacbcdbdbddddbcbb	TRUE
aaaaaaabddadbcbbcdd	FALSE
aaaaaabbbabcaadbdcc	FALSE
aaccabdcccddccddcbc	FALSE
aaccaccdadbcddbcacb	FALSE
abadbddacbdccbdaabd	FALSE
abadcaaadaacbdcbaaa	FALSE
abdbaabbadbacdcbdbb	FALSE
abdbaabcdbdbccacaca	FALSE
acbdcbccbcadbadabcc	FALSE
acbdcbdaacadcdbbcab	FALSE
adacaadccddaacdbcbc	FALSE
adacabbdcaacabddccd	FALSE
adcddaabbdcacaaddbc	FALSE
adcddacacdaacdabbda	FALSE
babdaabcdbdadbadccb	FALSE
babdacbaccddddacccb	FALSE
bbaccdbacbabacdbbba	FALSE
bbaccdcddbccadaddcc	FALSE
bbdadcddcdcbcdadbdb	FALSE
bbdaddaabdbddabcbda	FALSE
bcbcdacbbcccddccbda	FALSE
bcbcdbccadcdbcacacb	FALSE
bdacaddadacdaddcbac	FALSE
bdacbacabcacaaacaaa	FALSE
bddaacdabcaaabbcacc	FALSE
bddaadabcdbccdbdddd	FALSE
cabbccaaabaabdaaddb	FALSE
cabbdbcdabdccacbddb	FALSE
caddbbabaabdccbbabd	FALSE
caddbbdcbbbbcdbcaad	FALSE
cbcadbbbbbadbdbadba	FALSE
cbcadbbbcddbcacdcdc	FALSE
ccadabccacaadbacddd	FALSE
ccadbbbcbbabddacdcb	FALSE
ccdcbbdddddcbbbcdaa	FALSE
ccdcbccbbccbaaabaca	FALSE
cdcabacbaaabdbbadbb	FALSE
cdcabadbccdccbdbada	FALSE
daadacadbddbcdbaabb	FALSE
daadadcdbddbdbadbbc	FALSE
dadbcadcbbabddcbacb	FALSE
dadbcadddcdbcabbaca	FALSE
dbbcddaacadbbdcadbc	FALSE
dbbcddabcbcaccccabd	FALSE
dcabdbbaaccccdbaacc	FALSE
dcabdcaddbdaddadcda	FALSE
dcdaabdcdbcaaabcdba	FALSE
dcdaaccbbabdadcabba	FALSE
ddbabcaaaabbacaaacc	FALSE
ddbabcbcdcdbdaddddb	FALSE
