aaaaaaadaa	TRUE
aaaaaaccdc	TRUE
aacccdaadd	TRUE
aacccdaadd	TRUE
acaaaccddc	TRUE
acaaacddda	TRUE
accdcadaaa	TRUE
accdcadaca	TRUE
adaacccada	TRUE
adaaccddcc	TRUE
adcdcadaaa	TRUE
adcdcccaac	TRUE
baaadacdca	TRUE
baaadadadd	TRUE
badadacdda	TRUE
badadcaddc	TRUE
bbbcaaccdc	TRUE
bbbcaacdcc	TRUE
bbddbdadac	TRUE
bbddbdccaa	TRUE
bccbdcacdc	TRUE
bcccaccacc	TRUE
bdadaaaacc	TRUE
bdadaadcda	TRUE
bdcdbcbbad	TRUE
bdcdbcccdc	TRUE
caadcaccda	TRUE
caadcacddc	TRUE
cadddcccdc	TRUE
cadddcccdd	TRUE
cbcccdbaad	TRUE
cbccdacccc	TRUE
ccbacccdaa	TRUE
ccbacccdcc	TRUE
ccdcbaacca	TRUE
ccdcbacdca	TRUE
cdcaacdada	TRUE
cdcaadcdcd	TRUE
daacdadaca	TRUE
daacdcaacd	TRUE
dadadccdaa	TRUE
dadadccddc	TRUE
dbbcbadaaa	TRUE
dbbcbbdaca	TRUE
dcaacdcddd	TRUE
dcaacddcaa	TRUE
dcccccbcda	TRUE
dccccccdba	TRUE
ddbbbddacd	TRUE
ddbbcacadd	TRUE
aaaabcacdb	FALSE
aaaabdaccc	FALSE
aaccbcaadb	FALSE
aaccbcbdba	FALSE
abbaddcdba	FALSE
abbadddcab	FALSE
acaadabbbd	FALSE
acaaddaddb	FALSE
acdabcbcbd	FALSE
acdaccddab	FALSE
adbdbddccc	FALSE
adbdcbcccd	FALSE
baabaddddd	FALSE
baabbbabaa	FALSE
badaacadbd	FALSE
badaacbbac	FALSE
bbbcaaddab	FALSE
bbbcabbadd	FALSE
bbddbdadab	FALSE
bbddbdccab	FALSE
bccbdcabdc	FALSE
bcccabccbc	FALSE
bdacccbaad	FALSE
bdaccdbbba	FALSE
bdcdbcbbab	FALSE
bdcdbcccab	FALSE
cababadadc	FALSE
cababcdabb	FALSE
caddcadddb	FALSE
caddcbcbdd	FALSE
cbcccdbabd	FALSE
cbccdacbcc	FALSE
ccbabdbdcc	FALSE
ccbabdcccc	FALSE
ccdcbaabba	FALSE
ccdcbacdcb	FALSE
cdcaaccbca	FALSE
cdcaadddcb	FALSE
daadabccbc	FALSE
daadabdcad	FALSE
dadaabcbbb	FALSE
dadaacbcac	FALSE
dbbcbadaab	FALSE
dbbcbbdacb	FALSE
dcaadaaabd	FALSE
dcaadbcaab	FALSE
dcccccbcab	FALSE
dccccccdab	FALSE
ddbbbddacb	FALSE
ddbbcabadd	FALSE
aaaaaaadaac	TRUE
aaaaaacccad	TRUE
aaccdcadcca	TRUE
aaccdccdcca	TRUE
acaaacdacac	TRUE
acaaacdadcd	TRUE
acccdddddaa	TRUE
accdaaacacd	TRUE
adaadccaaad	TRUE
adaadccaccc	TRUE
adcdcacdacc	TRUE
adcdcadcadd	TRUE
baaadaadcac	TRUE
baaadaadddc	TRUE
badaadadcaa	TRUE
badaadccdda	TRUE
bbbbbdbaddd	TRUE
bbbbcaaadac	TRUE
bbdddcbdada	TRUE
bcaaaaccadd	TRUE
bccacccacac	TRUE
bccacdaadda	TRUE
bdacaaddaca	TRUE
bdacacacaac	TRUE
bdcdcbccddc	TRUE
bdcdccdddaa	TRUE
cacaccadcad	TRUE
cacacccaaad	TRUE
cadddcaccdd	TRUE
cadddcddada	TRUE
cbcbcbccaca	TRUE
cbcbccadccc	TRUE
ccbadcaaacc	TRUE
ccbadcacacd	TRUE
ccdcbcddcba	TRUE
ccdccacaadc	TRUE
cdcaaaccdad	TRUE
cdcaaadacdc	TRUE
daaccdcaaaa	TRUE
daaccddacda	TRUE
dadccddccca	TRUE
dadccddccdc	TRUE
dbbdbadccda	TRUE
dbbdbadccdc	TRUE
dcaccccaaac	TRUE
dcaccccadac	TRUE
dcdacdddacc	TRUE
dcdacddddaa	TRUE
ddbcacadcad	TRUE
ddbcacdadca	TRUE
aaaaaaaabcb	FALSE
aaaaaaacacb	FALSE
aacbcadddba	FALSE
aacbcbbacba	FALSE
abaddbdacdd	FALSE
abaddcabcac	FALSE
abdbcddbbcb	FALSE
abdbdabdbdd	FALSE
acbdcabacdc	FALSE
acbdcbbbadb	FALSE
adaccaaaadb	FALSE
adaccaabccd	FALSE
addadcdcdbb	FALSE
addaddadadb	FALSE
babdbdbabbb	FALSE
babdbdbbacc	FALSE
bbabaccbccc	FALSE
bbabadbccbb	FALSE
bbccbcdabbd	FALSE
bbcccbcbabb	FALSE
bcbbdccacbd	FALSE
bcbcaababba	FALSE
bcddbddabcb	FALSE
bcddcadcabd	FALSE
bdccbaddbca	FALSE
bdccbaddccb	FALSE
cabbabbdbbd	FALSE
cabbabcacdc	FALSE
cadcadaaacb	FALSE
cadcadaacab	FALSE
cbbdbccacbc	FALSE
cbbdbccdaab	FALSE
ccacbabccbd	FALSE
ccacbabdcac	FALSE
ccdaddadaab	FALSE
ccdbaaacbbc	FALSE
cdbdadbcbda	FALSE
cdbdbadabdb	FALSE
daabbcccacd	FALSE
daabbdabbda	FALSE
daccdbbcacc	FALSE
daccdcbbbad	FALSE
dbbbcaaaaab	FALSE
dbbbcbbccab	FALSE
dbdddadbaab	FALSE
dbdddbddabc	FALSE
dcccadadbac	FALSE
dcccbaaddcb	FALSE
ddbacaaabad	FALSE
ddbacabcdbb	FALSE
aaaaaaaaaccd	TRUE
aaaaaaacdcac	TRUE
aaccadcdcdad	TRUE
aaccaddcddaa	TRUE
aadddaacdadd	TRUE
aadddaccadcd	TRUE
acccaadddadc	TRUE
acccacaaccdd	TRUE
acdcdcdddaac	TRUE
acdcddaacadc	TRUE
adaddcdaacca	TRUE
adaddcdcadcd	TRUE
addccddddaca	TRUE
addcdaaacada	TRUE
bacaddcaccad	TRUE
bacaddccaaca	TRUE
bbacaaacaccd	TRUE
bbacaaadaadc	TRUE
bbccdaadaaac	TRUE
bbccdbcddcdc	TRUE
bcbbdddaddac	TRUE
bcbcaaaccada	TRUE
bcdddbbadcda	TRUE
bcddddcbccac	TRUE
bdccccbcdbdc	TRUE
bdccccdbcccc	TRUE
caadddccdaac	TRUE
cacaaaaacacd	TRUE
cadddaaaaacc	TRUE
cadddaadaada	TRUE
cbccbbadcada	TRUE
cbccbbccbdcc	TRUE
ccadcdcdcdaa	TRUE
ccadcddaadac	TRUE
ccdbcaddccda	TRUE
ccdbcbdcccbd	TRUE
cdbdadcaaadc	TRUE
cdbdadccccad	TRUE
daaadcddadad	TRUE
daaaddaadaad	TRUE
dadadacdddaa	TRUE
dadadadaddcc	TRUE
dbbcbadaacdd	TRUE
dbbcbbadccaa	TRUE
dcaaaaddcddd	TRUE
dcaaacaccdaa	TRUE
dccbdbcdaccc	TRUE
dccbdcaadacc	TRUE
ddbacadddcda	TRUE
ddbacaddddcd	TRUE
aaaaaaaabcbd	FALSE
aaaaaaaccdcb	FALSE
aacbccdaadab	FALSE
aacbcdbdbcbb	FALSE
abbabcddcbbb	FALSE
abbabdacddcd	FALSE
abdcabddabcb	FALSE
abdcbaadabcc	FALSE
accabadcbdcd	FALSE
accabdadcabb	FALSE
adacbcddddab	FALSE
adacbdcaabdd	FALSE
adcdccccccab	FALSE
adcddcaccccb	FALSE
babdbadaddca	FALSE
babdbadbdabb	FALSE
bbabbcbcdcac	FALSE
bbabcaabdcca	FALSE
bbccdaadbaac	FALSE
bbccdbcddcab	FALSE
bcbbdddaddab	FALSE
bcbcaaabdbba	FALSE
bcdddbbadbda	FALSE
bcddddcbccab	FALSE
bdccccbcdbab	FALSE
bdccccdbccab	FALSE
cabbabbcdbdb	FALSE
cabbadcadddc	FALSE
cadcddbabdac	FALSE
caddabbdbadd	FALSE
cbccbbadbadb	FALSE
cbccbbccbdab	FALSE
ccadbbcccaab	FALSE
ccadbccbadab	FALSE
ccdbcadccbdb	FALSE
ccdbcbdcccab	FALSE
cdbdacdabcab	FALSE
cdbdacddbddc	FALSE
daabbcdddddd	FALSE
daabbdaddbcb	FALSE
dadaabdcccac	FALSE
dadaadcaccab	FALSE
dbbcbadaabcd	FALSE
dbbcbbadbbaa	FALSE
dcaaacbbbddd	FALSE
dcaaadbbcbdd	FALSE
dccbdbcdabcb	FALSE
dccbdcaadabb	FALSE
ddbacadccbad	FALSE
ddbacaddadbc	FALSE
aaaaaacadaaca	TRUE
aaaaaaddccaad	TRUE
aaccdaaccdaca	TRUE
aaccdacacddac	TRUE
aaddcdadddcdc	TRUE
aaddcddaddccd	TRUE
acccadaddcadc	TRUE
acccadaddddda	TRUE
acddaddcdaadc	TRUE
acddadddcacda	TRUE
adcadaaddccdc	TRUE
adcadadacaccc	TRUE
addcdccddcdad	TRUE
addcdcdacdacc	TRUE
baccaaccddcad	TRUE
baccaaddccadc	TRUE
bbacaacacadcd	TRUE
bbacaadccccad	TRUE
bbcdaaaacadcd	TRUE
bbcdaadccaacd	TRUE
bcbbcadcdacaa	TRUE
bcbbcdbdcbbcc	TRUE
bcddcacadaddd	TRUE
bcddcdadadada	TRUE
bdccbcaaaaaad	TRUE
bdcccbbacccca	TRUE
cacacaadcdada	TRUE
cacacacdcadca	TRUE
caddadaddcaad	TRUE
caddadccaaddc	TRUE
cbcaddcddacca	TRUE
cbcaddddccaaa	TRUE
ccbaaacaccccc	TRUE
ccbaadaccddaa	TRUE
ccdcbaddddcdd	TRUE
ccdcbbbdbdcbd	TRUE
cdcacddccddcd	TRUE
cdcacddcdadad	TRUE
daadcdaacdccd	TRUE
daadcdacddcda	TRUE
dadcdcdcadddd	TRUE
dadcddadcadcc	TRUE
dbbdbaadcdddc	TRUE
dbbdbacdcaddc	TRUE
dcacadaadadca	TRUE
dcacadcadaacc	TRUE
dccdddaaacddd	TRUE
dccdddacccaac	TRUE
ddbcadccaaaaa	TRUE
ddbcbbacacdad	TRUE
aaaaabcbdcbcd	FALSE
aaaaabdbbddcb	FALSE
aaccadabddadb	FALSE
aaccadcacdcbc	FALSE
abbaddacbcbaa	FALSE
abbaddbbbbacc	FALSE
abdcdabddbbab	FALSE
abdcdcdddadab	FALSE
accacdbdccaad	FALSE
accacdbddbdcb	FALSE
adaccadbbcdcb	FALSE
adaccbababdba	FALSE
addbbcbcdabdc	FALSE
addbbcdbaacad	FALSE
babdcbbdddbaa	FALSE
babdcdbacaaaa	FALSE
bbabbccabdbaa	FALSE
bbabbdabbbdaa	FALSE
bbcdaaaabadbc	FALSE
bbcdaadcbbacd	FALSE
bcbbcadcdbbaa	FALSE
bcbbcdbdcbbab	FALSE
bcddcabadbdcd	FALSE
bcddcdadacadb	FALSE
bdccbcaabaabd	FALSE
bdcccbbabbbba	FALSE
cabbdaabcaacd	FALSE
cabbdaacbcdba	FALSE
cadccacbddabb	FALSE
cadccccaadabb	FALSE
cbcadcdaddbcc	FALSE
cbcaddddccbaa	FALSE
ccbaadaabbbcc	FALSE
ccbabbaccddaa	FALSE
ccdcbadccdcdb	FALSE
ccdcbbbdbdcab	FALSE
cdcaccdbccbdc	FALSE
cdcacdbadadcc	FALSE
dabacbacbcdbb	FALSE
dabacbcabbcbc	FALSE
dadcabcccdddd	FALSE
dadcabdbacaaa	FALSE
dbbdbabcbdcdb	FALSE
dbbdbacdcacdb	FALSE
dcabcaabdadba	FALSE
dcabcabbdabbb	FALSE
dccdddaaabcdd	FALSE
dccdddabbcaab	FALSE
ddbcadbcaaaab	FALSE
ddbcbbababdad	FALSE
aaaaaacadaacac	TRUE
aaaaaadccaadaa	TRUE
aaccccdcdcddda	TRUE
aaccccddacccda	TRUE
aadddacdaaddcd	TRUE
aadddadcdccadd	TRUE
accadaaadddaca	TRUE
accadaacccccda	TRUE
acddaaadaddaac	TRUE
acddaaccccddca	TRUE
adcaccccaacaca	TRUE
adcaccccadddaa	TRUE
addccdcdcdaddc	TRUE
addcdaaadacdda	TRUE
bacadddcadddaa	TRUE
bacadddddcadaa	TRUE
bbacccaadcacad	TRUE
bbacccdaddddca	TRUE
bbdaadcddadccd	TRUE
bbdacaadadaaad	TRUE
bcbbdbadddcada	TRUE
bcbbdbbcaddcda	TRUE
bdaaacddddddca	TRUE
bdaaadcdcaadaa	TRUE
bdcddaadcddacd	TRUE
bdcddadcccdaac	TRUE
caadddcdcdadac	TRUE
caadddddadaaca	TRUE
caddcaaaccddca	TRUE
caddcaadaccccd	TRUE
cbcbbddaadccad	TRUE
cbcbbddadddccc	TRUE
ccbacddaaaddaa	TRUE
ccbacdddadddac	TRUE
ccdbdbbbdbadcc	TRUE
ccdcaacdaaadac	TRUE
cdcbaaadaaadcd	TRUE
cdcbacccacaaad	TRUE
daadaaaadcacad	TRUE
daadaaacdcdcdd	TRUE
daddaacdadaadd	TRUE
daddacaaccadac	TRUE
dbcaaddacacdca	TRUE
dbcaaddacccada	TRUE
dcaccadcdcaadd	TRUE
dcacccaadcdadd	TRUE
dcdbacaaadddad	TRUE
dcdbaccadddddc	TRUE
ddbdbbaddaacaa	TRUE
ddbdbbddddccdd	TRUE
aaaaaabddcbadb	FALSE
aaaaaadbbdbbaa	FALSE
aaccdacbcdcccd	FALSE
aaccdbacddddda	FALSE
abbabadaadacca	FALSE
abbabadbbbbdcb	FALSE
abdcaccaacadda	FALSE
abdcbaacdbbaaa	FALSE
acbdacdababbdb	FALSE
acbdbadbddacba	FALSE
adabadcbcccbcd	FALSE
adabcaadcbbcda	FALSE
addacccdbddbbc	FALSE
addadaadaddcbc	FALSE
babdbbdccabaca	FALSE
babdbccdacdcbb	FALSE
bbabaabdcdbbab	FALSE
bbabaacdadccda	FALSE
bbcddbacdcbcbd	FALSE
bbcdddabdcbbba	FALSE
bcbcbacbaddada	FALSE
bcbcbbaddbcdbb	FALSE
bcddcbddadcbbb	FALSE
bcddccbaaacbcb	FALSE
bdccabadbaccdb	FALSE
bdccabdbaddbac	FALSE
caadcbacbacbdd	FALSE
caadccadcaadab	FALSE
cadccdbccdacba	FALSE
cadcdaabdacddb	FALSE
cbcbabadbccaca	FALSE
cbcbabbccaccbc	FALSE
ccacddacdacdcb	FALSE
ccacddbbbcbadd	FALSE
ccdbaddbadaccd	FALSE
ccdbbaaadcbbda	FALSE
cdbdaacdddabaa	FALSE
cdbdacbadcdadc	FALSE
daaabdcabcbcac	FALSE
daaabdcadbbcca	FALSE
dacdddacdacdcb	FALSE
dacdddadbdcbac	FALSE
dbbcaacadaacbb	FALSE
dbbcabdabbbacd	FALSE
dbdddaababcbab	FALSE
dbdddbabccbcda	FALSE
dccbbbbaabaada	FALSE
dccbbcabacdcac	FALSE
ddbaccdbbbbcaa	FALSE
ddbacdacbcddcd	FALSE
aaaaaaaadcaadda	TRUE
aaaaaaacaadcadc	TRUE
aaccadddcaacacd	TRUE
aacccacacdaaddd	TRUE
aaddcaaaccccada	TRUE
aaddcacadcdccad	TRUE
accadacaaaddccd	TRUE
accadaccccddccd	TRUE
acddacacacddcdc	TRUE
acddacadcaaccac	TRUE
adcacdddaadccac	TRUE
adcadaacaaccdca	TRUE
addcdcacadcacaa	TRUE
addcdccaadadcca	TRUE
bacccdccdccdacd	TRUE
bacccdcdacaccda	TRUE
bbaaddddccadddc	TRUE
bbacaaacaacaccd	TRUE
bbcdacccccaddcc	TRUE
bbcdbbcbdbcbaaa	TRUE
bcbbdbcbdcdbacc	TRUE
bcbbdcbacddaacd	TRUE
bcdcdcddbccbcdc	TRUE
bcdcddddccbaccd	TRUE
bdccbbdaccdddda	TRUE
bdccbcaadaaacaa	TRUE
caadadaadcdadca	TRUE
caadadadacacccd	TRUE
cadcddcccdadaaa	TRUE
cadcdddaaccdaac	TRUE
cbcaaaaadadddaa	TRUE
cbcaaadaaccccdc	TRUE
ccaccdddcccdcac	TRUE
ccacdaacccaccaa	TRUE
ccdbaadcaacddaa	TRUE
ccdbacdcccddcaa	TRUE
cdbcdadccdddccc	TRUE
cdbcdadcdcaacac	TRUE
daaacaaadcdaccc	TRUE
daaacaaadcdacdc	TRUE
dadadacaadaadac	TRUE
dadadacccdaacdc	TRUE
dbbacadccdddcac	TRUE
dbbacdcaaadddac	TRUE
dbdcccbdcaaccca	TRUE
dbdcccbddcacddd	TRUE
dcccaacaaacaaaa	TRUE
dcccacaadcaccca	TRUE
ddbacccadcdccca	TRUE
ddbacdacadcdada	TRUE
aaaaaaddbbbadcd	FALSE
aaaaabbabbcbcca	FALSE
aaccccccddbacca	FALSE
aacccdbabdcbbbc	FALSE
abbbbddcbdccdac	FALSE
abbbcaccabcdccb	FALSE
acaacccdacbbddc	FALSE
acaacdaaadccbcd	FALSE
accdabbbcbccdbd	FALSE
accdabdccaacdaa	FALSE
adbbccdaadbbcdc	FALSE
adbbcdabdcdbaad	FALSE
adddbabbccdacbb	FALSE
adddbbaaccdbdad	FALSE
bacaddcddabcddd	FALSE
bacbaacbdbdabcd	FALSE
bbbabbbabdbadcd	FALSE
bbbabcbadcbdacd	FALSE
bbdcbbbdbadcddb	FALSE
bbdcbccbabaaaac	FALSE
bccababaddadbbd	FALSE
bccabbacdbbaaca	FALSE
bdadadaaccdbcbb	FALSE
bdadcaabababbac	FALSE
bddcaabdadbbcba	FALSE
bddcaadaccbbdbd	FALSE
cacaabcabadadcb	FALSE
cacaabcccbacbab	FALSE
cbabdcdbabcdcaa	FALSE
cbabddbbbadcdcb	FALSE
cbdadaaacdaccbd	FALSE
cbdadaadbddbbdb	FALSE
ccbcccddcccbcab	FALSE
ccbccdadaaabdcb	FALSE
cdaaabacaddbaad	FALSE
cdaaacabdbacbdd	FALSE
cdcccccddbaaccb	FALSE
cdcccdcdabdacac	FALSE
daadbbdabdbcaaa	FALSE
daadbbdaddaddcc	FALSE
dadadddabbbbdad	FALSE
dadbaabbdbadbdb	FALSE
dbbcabaacdbcbdd	FALSE
dbbcacadacbacdc	FALSE
dcaaacdcbabacaa	FALSE
dcaaacdccabbacd	FALSE
dcccdcacacbaaca	FALSE
dccdabbbaccdbbc	FALSE
ddbadbcbbabaaab	FALSE
ddbadcbbacbccbb	FALSE
aaaaaaaadaaacadd	TRUE
aaaaaaaccddcddda	TRUE
aacccdadadddddaa	TRUE
aacccdadcddcdaac	TRUE
acaaaacdaacadada	TRUE
acaaacadadacdcad	TRUE
acccdacaacaacacd	TRUE
acccdaccacaddcca	TRUE
acddddaacccddcac	TRUE
acddddccdaacddda	TRUE
adcccdaccccacdaa	TRUE
adcccdaddcdaccac	TRUE
addddaaddcdcddca	TRUE
addddacaadacccaa	TRUE
bacdacaadacaadac	TRUE
bacdacaccdcdcacc	TRUE
bbbadaaacaddadcd	TRUE
bbbadaacacccddda	TRUE
bbddcbbdbdbcdbaa	TRUE
bbddcbdaddddddad	TRUE
bccaddccadcaccdd	TRUE
bccadddcccccdcdc	TRUE
bdadcaacaacdadac	TRUE
bdadcadddaaaccdc	TRUE
bddbcddcbbbdccdb	TRUE
bddbdaaacacdaada	TRUE
cacdaaacaaddcada	TRUE
cacdaacadcadacac	TRUE
cbacaddcccdaaacd	TRUE
cbacadddcddcddac	TRUE
cbdbbacacaaddaad	TRUE
cbdbbbccaaacaaac	TRUE
ccbdaccdacaaaaac	TRUE
ccbdadacdaadcadd	TRUE
cdaaccaddcadaccc	TRUE
cdaacccadaaddcaa	TRUE
cdccbadcccaccaaa	TRUE
cdccbbcadadcaadc	TRUE
daacdcdadcdccdac	TRUE
daacddaaaaccadaa	TRUE
dadcddaadccddaad	TRUE
dadcddcaadadddcc	TRUE
dbbddcadaccddcac	TRUE
dbbddcaddcaaccaa	TRUE
dcaadaccaddaaacc	TRUE
dcaadacccdadadaa	TRUE
dcccdcbaadccccdd	TRUE
dcccdcbaccdcdadd	TRUE
ddbbcccdcdcbacac	TRUE
ddbbccdaaaddcdca	TRUE
aaaaaadadbbaccdd	FALSE
aaaaabdaddbccccb	FALSE
aacbcbcdddcbddaa	FALSE
aacbcbdbbdcdcacb	FALSE
abbabccacbadccdc	FALSE
abbabcccaccdbacd	FALSE
abddacbdcbccbacb	FALSE
abddbccddcddbcda	FALSE
accbbbdcacdbdbbc	FALSE
accbbcbaaaabcdbd	FALSE
adbabacdbcccbaac	FALSE
adbabadbaacddcdb	FALSE
addcdbbabdadabca	FALSE
addcdcbbabaaabca	FALSE
bacbbaacbcacaaca	FALSE
bacbbadbccdddacd	FALSE
bbadbbbbcccadbad	FALSE
bbadbbcccdcacccb	FALSE
bbdcacbdccbaddaa	FALSE
bbdcacdabcadabca	FALSE
bcbdcbdbccbbdbab	FALSE
bcbdcbddbddddcab	FALSE
bdabaabcccbaccba	FALSE
bdabaaddacadbaac	FALSE
bdccbbdcbbdbcbab	FALSE
bdccbcbdbddbbdab	FALSE
caadbbcbbcccddad	FALSE
caadbbdccccdbbcc	FALSE
cadbcccacbdcbddc	FALSE
cadbcccadbcbabda	FALSE
cbbddcbabbacbbbd	FALSE
cbbddcbddaadabcd	FALSE
ccabcbdaaaaadadb	FALSE
ccabdaabbabdccda	FALSE
cccddbbdcbadaacb	FALSE
cccddbdcaccaaabb	FALSE
cdbdbbbbdddadcdb	FALSE
cdbdbcbdaccabbab	FALSE
daabcdadadbabccd	FALSE
daabcdcdcaaaccbb	FALSE
dacdcbcdbaadbdbb	FALSE
dacdccabcacaadbb	FALSE
dbbbdabbcccacccc	FALSE
dbbbdbddbddcdcab	FALSE
dcabaacdbcdbbaad	FALSE
dcabbaabbbbaadbd	FALSE
dcdaacdcadadbcda	FALSE
dcdabacccaddbcbb	FALSE
ddbcddccbaadbdaa	FALSE
ddbdaacaacbccaaa	FALSE
aaaaaaaaacdaccacd	TRUE
aaaaaaaccdccdacda	TRUE
aaccaccddadddcddc	TRUE
aaccacdcaacddddad	TRUE
aaddccacdcaacaada	TRUE
aaddcccccdadaccca	TRUE
acccaacaaadccaaaa	TRUE
acccaacdacdaaadaa	TRUE
acddaddcaadddddad	TRUE
acddadddadddcdcda	TRUE
adcacdcdccddacdcd	TRUE
adcacddccadcaaada	TRUE
addcdaaacaaccadad	TRUE
addcdaaacaadccaca	TRUE
bacadadaadaaadcca	TRUE
bacadadcdccacaccd	TRUE
bbacaadcdacadaacc	TRUE
bbacacaacdaadcdcd	TRUE
bbcdbdaaddcdaaacc	TRUE
bbcdcbaacacaddadc	TRUE
bcbbdaaaacdcaaaad	TRUE
bcbbdadcadadaaaac	TRUE
bdaaaccdcaccacdda	TRUE
bdaaadaccdacadadd	TRUE
bdccdaacddaadcccc	TRUE
bdccdaccaccccacad	TRUE
caadcdadadccccddc	TRUE
caadcdcadcaadcdcd	TRUE
cadddcddcadacadac	TRUE
cadddddadddcadadc	TRUE
cbccccaccaaccacdc	TRUE
cbccccccbbddaaddd	TRUE
ccbbbdcbdbbccadda	TRUE
ccbbcaacaddaaccaa	TRUE
ccddddaaaaaccccca	TRUE
ccddddacaaccadcdc	TRUE
cdcbbbdbdccaccdcd	TRUE
cdcbbcbdccbcbaadd	TRUE
daacccacdccacacaa	TRUE
daacccadaccacadac	TRUE
dadcaaacaaaaaacac	TRUE
dadcaaacdacadaccc	TRUE
dbbcdcddacacaaadc	TRUE
dbbcddbcaaaadccdd	TRUE
dbddcdcdbadcadcca	TRUE
dbddcddcaaccacdcc	TRUE
dccbccbdbaddddada	TRUE
dccbcdcbccbacacdc	TRUE
ddbaaddaddddcadcc	TRUE
ddbacacddadcdccca	TRUE
aaaaaaacacbbdcbcc	FALSE
aaaaaacdcdabcbbba	FALSE
aacbcbbbabaacccaa	FALSE
aacbccdbadbbcbbab	FALSE
abbababdaacbcbdaa	FALSE
abbabbcadccbcddba	FALSE
abdcccacccadabdac	FALSE
abdcccbbdbcdccbcb	FALSE
acbddcccadbbabbcb	FALSE
acbdddbadccddddca	FALSE
adacabbdbcaadddba	FALSE
adacabcccbbccdcdd	FALSE
addaacbaaccbcdcbb	FALSE
addaacbabdabaccbd	FALSE
babcdcacbbdababdb	FALSE
babcdddaddbbdccdc	FALSE
bbabcaacddaddcbca	FALSE
bbabcacacdbdcdbab	FALSE
bbcdbdaaddccaabbc	FALSE
bbcdcbaabacaddadb	FALSE
bcbbdaaaacdbabaac	FALSE
bcbbdadbacbdbaaab	FALSE
bdaabbbbbbadbacdb	FALSE
bdaabdbbacbdabccb	FALSE
bdccdabdabcbccddc	FALSE
bdccdabdadcbbbbbd	FALSE
cabbadbabbdcaacac	FALSE
cabbadcbaadcbbcdc	FALSE
caddcdcbacadabada	FALSE
cadddcdadddbbdacb	FALSE
cbccccabbbaccacdc	FALSE
cbccccccbbddaaddb	FALSE
ccbbbdcbdbbccacdb	FALSE
ccbbcaabbbddbabca	FALSE
ccddddaaaaabbbbba	FALSE
ccddddabaacbadcdc	FALSE
cdcbbbdbdccacbccd	FALSE
cdcbbcbdccbcbabcd	FALSE
daaccdcdacabacccd	FALSE
daacdaabacbdabbbd	FALSE
dadacacbcdabacdbb	FALSE
dadacbdbcccadadab	FALSE
dbbcdcddababaaadc	FALSE
dbbcddbcabaadcbdd	FALSE
dbddcdcdbadcadccb	FALSE
dbddcddcaabcacccc	FALSE
dccbccbdbadddcadb	FALSE
dccbcdcbccbacabdc	FALSE
ddbabbcccadccdcab	FALSE
ddbabbdcddadcdccc	FALSE
aaaaaaaaadaddcccdd	TRUE
aaaaaaaadcccddcaad	TRUE
aacccaaddadcacdddc	TRUE
aacccacaaddccadaac	TRUE
acaacaccadaacdccad	TRUE
acaaccaadcaaadddcc	TRUE
accdaccccddacccacc	TRUE
accdaccdddcadcddaa	TRUE
adacaadacdddadacdd	TRUE
adacaadadccccdccaa	TRUE
adcdaacdaccdaaacac	TRUE
adcdaacdadcaaaddca	TRUE
baaaadcacdcadadaaa	TRUE
baaaadddadcacccada	TRUE
bacdcaacadcdddaacc	TRUE
bacdcacacdadcdcdaa	TRUE
bbadccdccdddcdcadd	TRUE
bbadcdadadcccdcacc	TRUE
bbdcaaccacdccaadcc	TRUE
bbdcaadcadccdddaac	TRUE
bccaaccaadddaccdcd	TRUE
bccaaccdddaadccacc	TRUE
bdaddadcdccacaacac	TRUE
bdaddaddcacadadddd	TRUE
bddadcaaddddadadda	TRUE
bddadcadccdcdcaddc	TRUE
cacadddacdcdcaaccc	TRUE
caccaaaaadadcadcac	TRUE
cbaadddaddccdadccc	TRUE
cbaadddddcdaaaaacc	TRUE
cbccdcacadcacdadcd	TRUE
cbccddaadcdadccdda	TRUE
ccbcadadaddaccccca	TRUE
ccbcaddccacaacaada	TRUE
cdaaddccadcddaaaaa	TRUE
cdaaddcdaddddcadda	TRUE
cddacacaaacdcdcddd	TRUE
cddacadcaadddacdda	TRUE
dacadaadcdcdcdcaaa	TRUE
dacadadaaccacddacd	TRUE
dbaacaaaacdcccacac	TRUE
dbaacaaacddcdacdda	TRUE
dbcadcaaccacdcccda	TRUE
dbcadcddcddadccdaa	TRUE
dcacaddaaaccacdcaa	TRUE
dcaccacccaacacdcca	TRUE
dcdacacccaadcacddd	TRUE
dcdacaddaacacadccd	TRUE
ddbbcbcbccacadccad	TRUE
ddbbcbdbadccdacdac	TRUE
aaaaaabcccdccaddba	FALSE
aaaaaacaddabcabbab	FALSE
aacbcbbaaccccbbcac	FALSE
aacbcbdaaabcacbadb	FALSE
abadabdcbbbdacbdab	FALSE
abadacaabdbbccabab	FALSE
abdcbbddbdccacccab	FALSE
abdcbcbbadbababdbc	FALSE
acbdcadabbdccdcdba	FALSE
acbdcbabdcbddacccb	FALSE
adaaabdbbccaccdcdd	FALSE
adaaadddcdbddbdada	FALSE
adccbbdbbaaddcaccb	FALSE
adccbcaccabadbacab	FALSE
bababacdabbbcbdbda	FALSE
bababdcccabbbbabca	FALSE
badddcdacdadcbcccd	FALSE
baddddbddaaadbaaac	FALSE
bbcccaaccadabdbccb	FALSE
bbcccdabdbbdbcdaac	FALSE
bcaddccccdaabddacb	FALSE
bcadddbdcabddbbabc	FALSE
bcdbdabcdcadcdcdac	FALSE
bcdbdacabaabdadccb	FALSE
bdbcdcacabdcbaadba	FALSE
bdbcdcadadbdaccaad	FALSE
caacacabcdbcccaadb	FALSE
caacadbcbbcbdbdacc	FALSE
cadacbddcbacbadcad	FALSE
cadaccbdcabccaabcd	FALSE
cbbcdbdabdddcbdaca	FALSE
cbbcdbddcadcdcabac	FALSE
ccabbabdcbdbaadbda	FALSE
ccabbadddaadcdcaac	FALSE
ccccdcbaabccacaaad	FALSE
ccccdddcbaddabaaaa	FALSE
cdbbcbdcacaccaddab	FALSE
cdbbccababbcbadcad	FALSE
cdddddcaaaabbbddca	FALSE
cdddddddabbcabbdcc	FALSE
dadaacdccabbdbcdca	FALSE
dadaadbbacabddaddb	FALSE
dbbcddadcdbdababbd	FALSE
dbbcddbaccdcdababa	FALSE
dcababacbabbabcdac	FALSE
dcababbbdcdbdbacaa	FALSE
dccdccbcaadaabacac	FALSE
dccdccdcdbaabccddc	FALSE
ddbbccacaddbbcbbca	FALSE
ddbbcccdcbcdccdadb	FALSE
aaaaaaacacdacacddda	TRUE
aaaaaaacccacddadacc	TRUE
aacadccccacacdcdacd	TRUE
aacadcdacaddaadadac	TRUE
aaddadcddcccdcdcccd	TRUE
aaddaddccddcdaaacac	TRUE
accaccaaadadccdacca	TRUE
accaccacacaddcaacac	TRUE
acdccacddaacddadccc	TRUE
acdcccaaaccccadcccc	TRUE
adadcdacaacdddadacc	TRUE
adadcdacaadadcdddca	TRUE
addacddddcddaaccaca	TRUE
addadaaaddcadcdacdc	TRUE
baacddddcccdaacaaca	TRUE
baadaaaaaaacaccaaca	TRUE
badcdaaacaadddaacdd	TRUE
badcdacaccadaacdcda	TRUE
bbcadadddcaaacadaca	TRUE
bbcadcaaadddaccaccd	TRUE
bcadaccdadaaccdaccc	TRUE
bcadaccdccddccacaaa	TRUE
bcdbacadcccaacdacad	TRUE
bcdbaccdccacdacdcca	TRUE
bdbdddadddadacdccdc	TRUE
bdbdddccdbacacccaca	TRUE
caacadaacdaaccaddcd	TRUE
caacadadacdccdcaddd	TRUE
cadcaaaccadddccaaac	TRUE
cadcaacadacddcacacd	TRUE
cbbdacadadadcdccdcd	TRUE
cbbdaccacccacdccdcd	TRUE
ccacadaddcdccaaaadc	TRUE
ccacadcdcdcccacacdc	TRUE
ccdaadcadcaaccccaac	TRUE
ccdacaacaacdcdadada	TRUE
cdbbdbdbddcbccdbcdc	TRUE
cdbbdcbaddddadaaddd	TRUE
cdddddaaaccaaaaccac	TRUE
cdddddcbbacaadacaaa	TRUE
dacdddcccaadcaddcdc	TRUE
dadaaaaddadccdccaac	TRUE
dbbbacddadcacadcddc	TRUE
dbbbadddddccdcadaca	TRUE
dcaaaacacccadacccad	TRUE
dcaaaacdcddacdcadad	TRUE
dccdcccaacdccccddca	TRUE
dccdddadcdadaacacdc	TRUE
ddbbbacaadaaacdcdaa	TRUE
ddbbbadcdcccdaacccd	TRUE
aaaaaabbdcddaaaccca	FALSE
aaaaaabbdddccdbbaad	FALSE
aaccddaaaadcabbcbdc	FALSE
aaccddbbbbbcdbddcdc	FALSE
abadddabddcabdcaccd	FALSE
abadddbbcaabbcbdcdd	FALSE
abdbdddddbbdaadcdba	FALSE
abdcaccdbdbabbdbdcd	FALSE
accbaacaaabdaaacadb	FALSE
accbaadbbbabddddbdb	FALSE
adadabcccacbaaaadac	FALSE
adadadabddaddacadac	FALSE
addacccbbbdbdddabbb	FALSE
addacdacbadaacbddaa	FALSE
babdbddaacaabbdcada	FALSE
babdcbcadbdaacddccc	FALSE
bbaccdcbbcbacddccba	FALSE
bbacdacddccabcabdaa	FALSE
bbdaacdaabdababbaaa	FALSE
bbdaacdcdaccbabbaaa	FALSE
bcbccdddcbaaadbccbc	FALSE
bcbcdcacaccbccbadbc	FALSE
bdaadabbbcddcdabbbc	FALSE
bdaadacacacbdabcdda	FALSE
bdcdcaaacddaccabcbb	FALSE
bdcdcacababddadabbb	FALSE
cabbbdbdaacbdddbdbc	FALSE
cabbcbaaaccabbacdad	FALSE
cbaabccaddadbbdbabd	FALSE
cbaabdaddabcddadcac	FALSE
cbcdbabbdabbacdddba	FALSE
cbcdbabdbdcdaccddad	FALSE
ccbbaaacccaabcadcdc	FALSE
ccbbaaadabbacccccdd	FALSE
ccddaabbabddbaccbba	FALSE
ccddabcaccbdcbaccab	FALSE
cdcacdcdbaddcbcdbdb	FALSE
cdcadbadccaccddacbc	FALSE
daadaabddaaabbcaadc	FALSE
daadaadcdbbcbacadca	FALSE
dadbdabddcbbcdddaba	FALSE
dadbdbcadaacccabddd	FALSE
dbbdadbdcaaaaabcabb	FALSE
dbbdaddbacacdccabab	FALSE
dcabadcdcbbdabadabd	FALSE
dcabbbbabcaccadcabd	FALSE
dcccccbacccddbdccbb	FALSE
dccccccdccadaadcbac	FALSE
ddbadaadaccadcccdcb	FALSE
ddbadacdbbbdccddccd	FALSE
