aaaaacadab	TRUE
aaaaacbaac	TRUE
aaccabdcac	TRUE
aaccacdbca	TRUE
abacddadac	TRUE
abacddccac	TRUE
abdccdacad	TRUE
abdccdadad	TRUE
acbddcccdc	TRUE
acbdddaada	TRUE
adaccaaabd	TRUE
adaccabada	TRUE
addbaaccdc	TRUE
addbaacdcd	TRUE
baaddaaddd	TRUE
baaddaccdd	TRUE
badcccaddc	TRUE
badccccccc	TRUE
bcadcacdda	TRUE
bcadcadaca	TRUE
bcdadaaddd	TRUE
bcdadacaaa	TRUE
bdadadaccc	TRUE
bdadadadca	TRUE
bddacadcaa	TRUE
bddaccacaa	TRUE
caadcabdad	TRUE
caadcacbaa	TRUE
cadbdddccc	TRUE
cadbddddac	TRUE
cbcccdddac	TRUE
cbccdadcda	TRUE
ccacadbdcc	TRUE
ccacbaadca	TRUE
ccdbaccaad	TRUE
ccdbcaaaad	TRUE
cdbdccccdd	TRUE
cdbdccddcd	TRUE
daabcdcdcc	TRUE
daabdaaccc	TRUE
daccdabcca	TRUE
daccdbcaad	TRUE
dbcaccccda	TRUE
dbcacdadcc	TRUE
dcaabaaaaa	TRUE
dcaabaccdd	TRUE
dccdbaacdd	TRUE
dccdbacdda	TRUE
ddbcdcddda	TRUE
ddbcdcdddc	TRUE
aaaaacadad	FALSE
aaaaacbbbb	FALSE
aaccabccbc	FALSE
aaccacdbbb	FALSE
abadbbcbac	FALSE
abadbcbcdb	FALSE
abdbacdadd	FALSE
abdbadbcbd	FALSE
acbdddacbc	FALSE
acbdddcadb	FALSE
adaccaaabb	FALSE
adaccabadb	FALSE
addbaabcdc	FALSE
addbabbdbb	FALSE
babdacddcc	FALSE
babdbabbdd	FALSE
bbabbacaab	FALSE
bbabbbcbbd	FALSE
bbcdcacbab	FALSE
bbcdcadacc	FALSE
bcbbccbdbc	FALSE
bcbbcdacdb	FALSE
bcdcdcccdb	FALSE
bcdcddbdab	FALSE
bdcbbcbadc	FALSE
bdcbbcdaaa	FALSE
caadcabdab	FALSE
caadcacbab	FALSE
cadbddbdcb	FALSE
cadbddddab	FALSE
cbcabdacbb	FALSE
cbcabdcdbd	FALSE
ccacadbdcb	FALSE
ccacbabddb	FALSE
ccdbbbaacb	FALSE
ccdbbcbbbb	FALSE
cdbdbcbbba	FALSE
cdbdbcddbb	FALSE
daabcccccb	FALSE
daabcdcaba	FALSE
daccdabccb	FALSE
daccdbbadb	FALSE
dbbcbdaaab	FALSE
dbbcbdcaaa	FALSE
dcaabaaaba	FALSE
dcaababccd	FALSE
dccdbaaccb	FALSE
dccdbacddb	FALSE
ddbcbdbddb	FALSE
ddbcbddbac	FALSE
aaaaacadadb	TRUE
aaaaacbacad	TRUE
aaccbcccccd	TRUE
aaccbcdcaac	TRUE
abadadaaaca	TRUE
abadadadaad	TRUE
abdccacdcac	TRUE
abdccacdcda	TRUE
acbdaacadad	TRUE
acbdaaddddc	TRUE
adacddcbdaa	TRUE
adadaacdcdb	TRUE
addaccbacaa	TRUE
addacdabccc	TRUE
baadddadccc	TRUE
baadddcacad	TRUE
badccdccaaa	TRUE
badccdcccaa	TRUE
bcadcccaadd	TRUE
bcadcccadac	TRUE
bcdcaacdacc	TRUE
bcdcaacdddd	TRUE
bdadaccdcda	TRUE
bdadadacddc	TRUE
bddacadacca	TRUE
bddacadcadd	TRUE
caadcdcacdb	TRUE
caaddbadcad	TRUE
cadbaccdccc	TRUE
cadbadadadc	TRUE
cbccaddaadc	TRUE
cbccaddaccc	TRUE
ccacaadccab	TRUE
ccacabdcadc	TRUE
ccdbdcdcccd	TRUE
ccdbdcddaac	TRUE
cdbddacdaca	TRUE
cdbddaddaaa	TRUE
daabcccdaaa	TRUE
daabcddcaad	TRUE
dadadbacccd	TRUE
dadadcabaac	TRUE
dbcacdaccca	TRUE
dbcacdccccc	TRUE
dcaaaadbdaa	TRUE
dcaaabaccca	TRUE
dcccbaacada	TRUE
dcccbaccacc	TRUE
ddbcaaccaaa	TRUE
ddbcaadccda	TRUE
aaaaabaddab	FALSE
aaaaaddadbb	FALSE
aacbddcbabc	FALSE
aaccaaaabbc	FALSE
abbaabacacd	FALSE
abbaabcdadb	FALSE
abdcacbcdbc	FALSE
abdcadbadaa	FALSE
accbacdbdab	FALSE
accbacdcdcb	FALSE
adadcaaadbb	FALSE
adadcaabccb	FALSE
addbdaabadd	FALSE
addbdcadcba	FALSE
bacabbcccab	FALSE
bacabcabcaa	FALSE
bbbaacadcca	FALSE
bbbaacdbcbc	FALSE
bbdcacababb	FALSE
bbdcadaddcc	FALSE
bccbaadbddb	FALSE
bccbaaddcda	FALSE
bdadabdbcdb	FALSE
bdadabdddac	FALSE
bddabcbcbcb	FALSE
bddabcdbccd	FALSE
cabccaaacbc	FALSE
cabccabcdba	FALSE
cadddbcbacd	FALSE
caddddaaccd	FALSE
cbcccacbcbc	FALSE
cbcccbaadcd	FALSE
ccbacdcccbb	FALSE
ccbadabcbba	FALSE
ccddbbbdbdd	FALSE
ccddbcbcbaa	FALSE
cdcbbcccaba	FALSE
cdcbbcdbcdd	FALSE
daadabbdaba	FALSE
daadacbaabc	FALSE
dadacddcbab	FALSE
dadadccccbb	FALSE
dbcabcbabda	FALSE
dbcabcbacaa	FALSE
dcacaddddac	FALSE
dcacbababdd	FALSE
dcdacdbabcb	FALSE
dcdacdccdac	FALSE
ddbcacccadb	FALSE
ddbcbbdbdcb	FALSE
aaaaabaddaca	TRUE
aaaaadaabdad	TRUE
aacbdcdacaca	TRUE
aacbdcdaccda	TRUE
abacdddcadda	TRUE
abadaacaddca	TRUE
abdcdccdccaa	TRUE
abdcdcdcdaac	TRUE
accadbcdacca	TRUE
accadcdddcbc	TRUE
adadadcbccaa	TRUE
adadbaacccad	TRUE
addcadaadbcd	TRUE
addcadbcddcc	TRUE
bacacaccacdd	TRUE
bacacadacdcc	TRUE
badcddcadacd	TRUE
badcddcccdcd	TRUE
bccaddcaacaa	TRUE
bcccaacadddc	TRUE
bcddacdaacad	TRUE
bcddacdcacaa	TRUE
bdcacdccaaac	TRUE
bdcacdccadac	TRUE
bddcdcaadcca	TRUE
bddcdcacacca	TRUE
cabdaccdcaaa	TRUE
cabdaccdccdd	TRUE
cbaaadadcaac	TRUE
cbaaadadcdac	TRUE
cbcddcccdcca	TRUE
cbcddcddccaa	TRUE
ccbadddddccd	TRUE
ccbcaaaacacd	TRUE
ccddcbdcaddd	TRUE
ccddccaaadbc	TRUE
cdcbcccaaaac	TRUE
cdcbcccaaada	TRUE
daaddbacaaca	TRUE
daaddbacccad	TRUE
dadbdaadccdd	TRUE
dadbdacacddc	TRUE
dbcccdcdcacc	TRUE
dbcccddaacda	TRUE
dcacbddccccd	TRUE
dcaccbcaaada	TRUE
dcdabcacccca	TRUE
dcdabcdadcda	TRUE
ddbcddcccdad	TRUE
ddbcdddddccd	TRUE
aaaaabaddabb	FALSE
aaaaadaabdbd	FALSE
aacbdbaabbba	FALSE
aacbdbcadaad	FALSE
abadcbaddcac	FALSE
abadcdbcbcad	FALSE
abdcbacbcaab	FALSE
abdcbbdabbcc	FALSE
accadbccabca	FALSE
accadcdddcbb	FALSE
adadadcbbcaa	FALSE
adadbacabccb	FALSE
addcadaadbbd	FALSE
addcadbbdccc	FALSE
bacabcaccdba	FALSE
bacabcbdacad	FALSE
bbadcdddcabc	FALSE
bbaddcacbbdb	FALSE
bbdbaabaabaa	FALSE
bbdbabbdccbd	FALSE
bccacbbcdbad	FALSE
bccacbbdcdbc	FALSE
bdaccaacbbbb	FALSE
bdaccbbaadcd	FALSE
bddabdaddaad	FALSE
bddabdcddbad	FALSE
cabcdabbdbac	FALSE
cabcdbccaabc	FALSE
cbaabbdccbcc	FALSE
cbaabcdcaaaa	FALSE
cbccacdadcdb	FALSE
cbccbabaaddc	FALSE
ccbbbbccabdc	FALSE
ccbbbccbddaa	FALSE
ccddcbdbadcc	FALSE
ccddccaaadbb	FALSE
cdcbcabdbddb	FALSE
cdcbcbcbbaaa	FALSE
daaddbabdabb	FALSE
daaddbacdbad	FALSE
dadbcdbdcddc	FALSE
dadbcddcbada	FALSE
dbcabccdabda	FALSE
dbcabdadabdb	FALSE
dcacbdbcbccd	FALSE
dcaccbbaabda	FALSE
dcdabcaccbcb	FALSE
dcdabcdadccb	FALSE
ddbcbdcbaddd	FALSE
ddbccabdabdd	FALSE
aaaaaacbdaccd	TRUE
aaaaaacdbdacd	TRUE
aaccddcbdcaca	TRUE
aaccdddbaadaa	TRUE
abadccadcaccc	TRUE
abadccadcdaca	TRUE
abddacacadadd	TRUE
abddacdcddaaa	TRUE
accbaadadaccd	TRUE
accbaccccaadd	TRUE
adadcdddbcdad	TRUE
adaddabcdcddc	TRUE
adddacdacacdb	TRUE
adddadcbadacc	TRUE
baccaaccaadcc	TRUE
baccaacdccdcd	TRUE
baddcdccdcdca	TRUE
baddcdcdccacd	TRUE
bccacdccccdad	TRUE
bccacdccdcacc	TRUE
bcddaaaaccddc	TRUE
bcddaaaacdacc	TRUE
bdaddcdacdcaa	TRUE
bdadddcdcccdd	TRUE
bddadacadacac	TRUE
bddadadaaaaca	TRUE
cabcccddcccac	TRUE
cabccdaaadaac	TRUE
cbaaadccadacd	TRUE
cbaaadddcacdd	TRUE
cbcddadcddaad	TRUE
cbcddcacaaacd	TRUE
ccbaadcdcddad	TRUE
ccbaadcddadcd	TRUE
ccdccbacacacc	TRUE
ccdccbacccdca	TRUE
cdcaaddbaacda	TRUE
cdcabcaaaaaad	TRUE
daaccabcadadc	TRUE
daaccbaccccda	TRUE
dadbadaaacddc	TRUE
dadbadacdadda	TRUE
dbcaaddcddccc	TRUE
dbcacaaacacca	TRUE
dcaadbaddaaac	TRUE
dcaadcbdaaaaa	TRUE
dcdaabaacadac	TRUE
dcdaabadccaad	TRUE
ddbdaadcdddcd	TRUE
ddbdacaaaaacc	TRUE
aaaaaacbdacbd	FALSE
aaaaaacdbdacb	FALSE
aaccddcbcbbba	FALSE
aaccdddbaadab	FALSE
abbaacaccdbcd	FALSE
abbaacacdcbdc	FALSE
abdcaddccadab	FALSE
abdcaddcdbdbd	FALSE
accbabcbcadac	FALSE
accbacccbdcab	FALSE
adadcdddbbcbd	FALSE
adaddabcdcccb	FALSE
adddacdacacda	FALSE
adddadcbadabc	FALSE
bacbcaaabccdc	FALSE
bacbcadbdadcd	FALSE
bbadcdaaccdaa	FALSE
bbaddbabccbbd	FALSE
bbdbdddbdaabb	FALSE
bbdcaabbccaab	FALSE
bccabacbcdaab	FALSE
bccabbdcdcada	FALSE
bdabdcacadbab	FALSE
bdabdcadbcddc	FALSE
bdcddddddadab	FALSE
bddaaacdabcab	FALSE
cabcaadcbdbdc	FALSE
cabcabbbbbdac	FALSE
cbaacbcddadbb	FALSE
cbaacbdccdbcb	FALSE
cbccadbacddcd	FALSE
cbccadbccbacc	FALSE
ccbaadbdadacb	FALSE
ccbaadddadbab	FALSE
ccdccbabdccac	FALSE
ccdccbacaccbb	FALSE
cdcaaddbaacdb	FALSE
cdcabbbccadbd	FALSE
daaccabbadadc	FALSE
daaccbacbccca	FALSE
dadbadadbdabb	FALSE
dadbadccbdbcc	FALSE
dbbcbbabbbcbc	FALSE
dbbcbcdcdaadd	FALSE
dcaadbaddaabc	FALSE
dcaadcbdaaacb	FALSE
dcdaabababada	FALSE
dcdaabbdccbad	FALSE
ddbcccaacbddd	FALSE
ddbccdcabdadd	FALSE
aaaaaaccabaccc	TRUE
aaaaadbdcddddc	TRUE
aacbdcaaaadaac	TRUE
aacbdcadcddccc	TRUE
abaddcacddacaa	TRUE
abaddcadccacca	TRUE
abddcdcacaaada	TRUE
abddcddcaaccac	TRUE
acccbdacddaaad	TRUE
acccbdacddcddd	TRUE
adbacaadcccdaa	TRUE
adbacacdcddcca	TRUE
addcdcbcdacaca	TRUE
addcdcddddcdab	TRUE
baccaadccdcaac	TRUE
baccaaddaacddd	TRUE
baddacdaadccca	TRUE
baddacdcccaacd	TRUE
bccaacaccaadcc	TRUE
bccaacadcdcdac	TRUE
bcdcacdccadaca	TRUE
bcdcacdddccacd	TRUE
bdadcccdddddca	TRUE
bdadcdaadcadad	TRUE
bddaccdcdcdcca	TRUE
bddaccddadddda	TRUE
cabaddaddaccdd	TRUE
cabadddccccaad	TRUE
caddaadbccaddc	TRUE
caddacbadaacaa	TRUE
cbcdacddcdaadd	TRUE
cbcdaddcddcddc	TRUE
ccaccaddcbaccc	TRUE
ccaccbdcdddcdd	TRUE
ccdbdcadaaccad	TRUE
ccdbdcdacdacca	TRUE
cdcabadcdaccdd	TRUE
cdcabcaadddaad	TRUE
daacaccdccbdda	TRUE
daacacddbddcda	TRUE
dadadabaacdcac	TRUE
dadadbcdacddaa	TRUE
dbccdcaaaaddcc	TRUE
dbccdcaaddaacc	TRUE
dcacacdddbddda	TRUE
dcacbacaadaacc	TRUE
dccdcdadcddbcd	TRUE
dccdcddacdadcb	TRUE
ddbaddcacaccca	TRUE
ddbcaadcccddda	TRUE
aaaaaaccabaccb	FALSE
aaaaadbdbddcdc	FALSE
aacbdcbcdabdab	FALSE
aacbdcdbcccbcc	FALSE
abbacccbacdbbd	FALSE
abbaccdccabadc	FALSE
abddaadccdabab	FALSE
abddacbcbbbdba	FALSE
acccbdcbbdbcca	FALSE
acccbdcdbcbdcd	FALSE
adbacdccabccbd	FALSE
adbadbabdddcdd	FALSE
addcdcbbdacaba	FALSE
addcdcddddcdaa	FALSE
bacbccbbbbbcbc	FALSE
bacbccbdbcccab	FALSE
bbadaaddcbddcd	FALSE
bbadacbbdbadcb	FALSE
bbdadcccbdadca	FALSE
bbdadcdcadbbac	FALSE
bcbcdbbdddabcb	FALSE
bcbcdbcaacdbbb	FALSE
bdaacbbdcdabdb	FALSE
bdaaccbadbcdba	FALSE
bdcccacabdbdaa	FALSE
bdcccbccacacda	FALSE
cabbbbdcbabbdb	FALSE
cabbbcdabbacad	FALSE
caddaadbbcacdc	FALSE
caddacbbdabbaa	FALSE
cbcbbdbdcbcbdd	FALSE
cbcbbdcdddbacc	FALSE
ccaccaddcbabbb	FALSE
ccaccbccdddccb	FALSE
ccdbdacccdabcb	FALSE
ccdbdaddcbacbc	FALSE
cdcabadccaccdb	FALSE
cdcabbdbadddab	FALSE
daacaccdccbdcb	FALSE
daacacddbdcbda	FALSE
dadadabaacdcab	FALSE
dadadbbdabdcbb	FALSE
dbcaadcabddbca	FALSE
dbcabadabddcda	FALSE
dcacacdddbddcb	FALSE
dcacbaccdaabac	FALSE
dccdcdadcddbcb	FALSE
dccdcddacdadca	FALSE
ddbbbabccbabba	FALSE
ddbbbbccaacdcc	FALSE
aaaaaaabcccccaa	TRUE
aaaaaaaddbcddaa	TRUE
aacbcaddcaddccd	TRUE
aacbccaacdaaccd	TRUE
abadccdadadacca	TRUE
abadccdccaacadc	TRUE
abddcaccdddaacd	TRUE
abddccacccaaacd	TRUE
accddbdccaddaca	TRUE
accddcbacddadcd	TRUE
adbccacdccaaccd	TRUE
adbcccaacadddaa	TRUE
addddcabccdcaca	TRUE
addddcddacbdcac	TRUE
bacccadccddccac	TRUE
baccccacddcaaaa	TRUE
baddcddddcccddd	TRUE
badddacacdccadc	TRUE
bccaccdcacdddca	TRUE
bccaccdccdcdcaa	TRUE
bcdcadccaddcada	TRUE
bcdcaddadaddada	TRUE
bdadacdcacdccaa	TRUE
bdadadaadaaaddc	TRUE
bddadacddaacaac	TRUE
bddadacddadaacd	TRUE
cabaaaccddcdcac	TRUE
cabaaccccaaddda	TRUE
cadcabaccdacacd	TRUE
cadcabadcdcadca	TRUE
cbccddcddcdcadd	TRUE
cbccdddaacaccaa	TRUE
ccadadbaadacdaa	TRUE
ccadadcdddbdccc	TRUE
ccdbdaddcdadcad	TRUE
ccdcabcaacadddd	TRUE
cdcadcbddccadca	TRUE
cdcbaaddaaaaacd	TRUE
daadaabcaccccdc	TRUE
daadaaccaabaacd	TRUE
dadbccdcccaaaca	TRUE
dadbccdcccdaddc	TRUE
dbccadadcdaacad	TRUE
dbccaddddaccddd	TRUE
dcaaddbaacaddaa	TRUE
dcaaddbaaccddad	TRUE
dcccbaddcacccda	TRUE
dcccbdccaaccaad	TRUE
ddbadadcddacdca	TRUE
ddbadcaaadaddad	TRUE
aaaaaaabccbcbba	FALSE
aaaaaaaddbcddba	FALSE
aacbcabaddbcdda	FALSE
aacbcbacaabbcbb	FALSE
abbadabdacabcca	FALSE
abbadbacddcddba	FALSE
abddcaacdbabdaa	FALSE
abddcadbbbaaacd	FALSE
accddbdbbadcaba	FALSE
accddcbbbdadbdd	FALSE
adbbdaaabddbaac	FALSE
adbbdadbdcbbcdd	FALSE
addddcabbccbaca	FALSE
addddcddacbcbac	FALSE
baccddabbcdbada	FALSE
baccdddcccabccc	FALSE
bbbadcddbbbabdc	FALSE
bbbadddbbcdbdab	FALSE
bbdbcbbcbaddbaa	FALSE
bbdbccbcaccbcdd	FALSE
bcbdaabcadadcac	FALSE
bcbdacabdaccdba	FALSE
bdaacdccacccdab	FALSE
bdaadbabaaadcdb	FALSE
bdccdbbcccbaaab	FALSE
bdccdbdbaadcddd	FALSE
cabaacddacaaaab	FALSE
cabaadaabdadbbd	FALSE
cadcabacbabbcdb	FALSE
cadcabaccdbbcba	FALSE
cbcaddaadccddbc	FALSE
cbcaddabacccdbb	FALSE
ccadadbaadabdaa	FALSE
ccadadcdddbdbcc	FALSE
ccdbdadcddadcab	FALSE
ccdcabbbabadcdc	FALSE
cdcadcbddcbadba	FALSE
cdcbaadddbaaaab	FALSE
daadaabbaccbbdc	FALSE
daadaaccaabbbcd	FALSE
dadbcaccccababa	FALSE
dadbcaccccdaddb	FALSE
dbbdbadcccdbacb	FALSE
dbbdbbdadacddcc	FALSE
dcaaddbaacbaadc	FALSE
dcaaddbabaaddad	FALSE
dcccbadcbacbcca	FALSE
dcccbdbbddacbab	FALSE
ddbadccbbdcbddb	FALSE
ddbaddadbcadaac	FALSE
aaaaaaadcdacabdc	TRUE
aaaaaacaadcabcdc	TRUE
aacbccdddddccacc	TRUE
aacbcddccdacdccc	TRUE
abacacccccddddda	TRUE
abacaccccddadaac	TRUE
abdccacccdcaadad	TRUE
abdccaddadaadcda	TRUE
acbdccacaaaaaaac	TRUE
acbdcccacccadacd	TRUE
adaccabddccdccad	TRUE
adaccaccbcdcdaca	TRUE
adcdbaddddcdadcc	TRUE
adcdbccaaddacccc	TRUE
baadcaddcadacadc	TRUE
baadccaaaacaddac	TRUE
badacdaaaadaddda	TRUE
badacdaaaaddaddc	TRUE
bcacdddccccaaaca	TRUE
bcacdddccddcaada	TRUE
bcdacccaadddddaa	TRUE
bcdacccacddadcdd	TRUE
bdadaaddacdcdddd	TRUE
bdadaadddacadcdc	TRUE
bddaadddcdaccdda	TRUE
bddaadddcddacdad	TRUE
caadbcddadaadcad	TRUE
caadcadbcccaccaa	TRUE
cadacbddaaadaacd	TRUE
cadaccadddcabaac	TRUE
cbcaccddcacaadcc	TRUE
cbcacdadadcdaddd	TRUE
ccadacccdbcacdca	TRUE
ccadbcaacaadcacc	TRUE
ccdcacbaccadcccc	TRUE
ccdcbcaaaaadacca	TRUE
cdbddadccdaddacd	TRUE
cdbddadcdaccaaca	TRUE
daabcaccaaaadadd	TRUE
daabccadaadccada	TRUE
dacdcaccdcaaadba	TRUE
dacdcbcdcadadddc	TRUE
dbcacccaccacddca	TRUE
dbcaccccdddddacc	TRUE
dcaabcaaacdccccc	TRUE
dcaabcaaddcacdcc	TRUE
dccbdadacccdacac	TRUE
dccbdadccadaacda	TRUE
ddbacccaadaddddd	TRUE
ddbaccddcaadacda	TRUE
aaaaaaadcdacabdb	FALSE
aaaaaacaadcabcdb	FALSE
aacbccddbcacbadc	FALSE
aacbccddccdcdbcd	FALSE
ababddbdabdabcbb	FALSE
ababddccdcbbabcd	FALSE
abdbbaadabbbdcca	FALSE
abdbbadcdcccbbdc	FALSE
acbdbccdacbaaabb	FALSE
acbdbdbacbcadacc	FALSE
adaccabcdbbdbbac	FALSE
adaccaccbcdccacb	FALSE
adcdbbddddcdadcc	FALSE
adcdbcbadaddaccb	FALSE
babbcdbbbccadccd	FALSE
babbcdccadcaddba	FALSE
baddbadcbdababac	FALSE
baddbdabcbaabada	FALSE
bbcbcdaccbccaccb	FALSE
bbcbdaaddddbbbcb	FALSE
bcbaabbcabbbbcda	FALSE
bcbaacbaabbadcac	FALSE
bcdcdadbadcccddc	FALSE
bcdcdbbaacdbbabc	FALSE
bdcbcdbabdcccbcb	FALSE
bdcbcddacdabccbd	FALSE
caadbcdcadaadcbc	FALSE
caadcadbcccabcaa	FALSE
cadacbcdaaadaacb	FALSE
cadaccadddcabaab	FALSE
cbbbdcbcbccacdab	FALSE
cbbbdcdbbabbacca	FALSE
ccadacccdbbabdbb	FALSE
ccadbbbacabdbabc	FALSE
ccdcacbbccacbccb	FALSE
ccdcbbaadbaacddb	FALSE
cdbdcbddaccbdbbd	FALSE
cdbdcdcadbcbdcaa	FALSE
daabbbcbbcaabada	FALSE
daabbccdabddaadc	FALSE
dacdcaccdcaaadbb	FALSE
dacdcbbcbacbddcb	FALSE
dbbcbcbaaacccadd	FALSE
dbbcbcbbdbadccab	FALSE
dcaabbdbddabdcdb	FALSE
dcaabcbbdcacdcbc	FALSE
dccbcdbdcdacdcbc	FALSE
dccbdacadaacdbcd	FALSE
ddbadcaddbcbabac	FALSE
ddbaddcabcabdbab	FALSE
aaaaaabadadccdadd	TRUE
aaaaaacccdcdbddda	TRUE
aacbddacaacacdaca	TRUE
aacbddadadaddddcd	TRUE
abadaddacdadaaadc	TRUE
abadcacadaaadcdcd	TRUE
abddadccaddcccdac	TRUE
abddcaaddcccccdad	TRUE
accbdcdccacdaddda	TRUE
accbddddcaaaacdcd	TRUE
adbaaadccacddadad	TRUE
adbaacaccaacccaca	TRUE
addcdbcdcadaadacd	TRUE
addcdddcadcbccdcc	TRUE
bacadadcadaadacac	TRUE
bacadadcaddcdcdac	TRUE
baddaaadaccdaaadc	TRUE
baddaaaddcdaccaaa	TRUE
bccaadcaddaaddcdd	TRUE
bccaadcddaaddddda	TRUE
bcdcccaccaadadcaa	TRUE
bcdcccccadaaccaca	TRUE
bdaddaadccdddacaa	TRUE
bdaddacaccadaacdd	TRUE
bddccacdaccdcdddc	TRUE
bddccadcdaaccdccd	TRUE
cabdaaadadacdcaca	TRUE
cabdaaccdaacdcaaa	TRUE
cbaacdddadaaccaca	TRUE
cbaadacaaaaddaada	TRUE
cbdaddddddcdacacc	TRUE
cbdcacaaaaadacaca	TRUE
ccbcddaaaddaddccc	TRUE
ccbcddaddcddadacd	TRUE
cdabcacdddadcdcaa	TRUE
cdabcadaacaadccdd	TRUE
cdcdbccaccadaaada	TRUE
cdcdcaaaccdccbcaa	TRUE
dabccdaadccdcdaac	TRUE
dabccdcaaaddcccda	TRUE
dadddbaccadaaaadc	TRUE
dadddcacddadbccdc	TRUE
dbcddacddacadacdd	TRUE
dbcddadaadadaaacc	TRUE
dcbaadcdaddadddaa	TRUE
dcbaaddaadddcaaca	TRUE
dcdccacdcaadbaaca	TRUE
dcdccbaaddcdcacca	TRUE
ddbcddacdccaadddc	TRUE
ddbdaaccadadcadcd	TRUE
aaaaaaabcadaccacb	FALSE
aaaaaabdcdaccdddb	FALSE
aacadcddccbcabddb	FALSE
aacaddbbdddababbb	FALSE
abbaadbccddbdbaab	FALSE
abbaadcaaddbdaaba	FALSE
abdbcdabdcadddaba	FALSE
abdbcdbcbcaabcbab	FALSE
acbddcbdacbaadccd	FALSE
accaaacccbcbdaabb	FALSE
adabcbdaabcaccdbd	FALSE
adabccaaaaaddccba	FALSE
adcddccdddbbcbbcb	FALSE
adcdddaccbdcbbbdd	FALSE
babdabdbccbdddddd	FALSE
babdacbcbdcbdddac	FALSE
bbaadbbaaabdaacab	FALSE
bbaadcacbdabaccbc	FALSE
bbccabbdcdaaacbbd	FALSE
bbccadabddccccdcd	FALSE
bcbabdcadcacbacbc	FALSE
bcbabddacbccdddac	FALSE
bcdcabaddcaacadca	FALSE
bcdcadbdddccbbdaa	FALSE
bdbdddcbadccbddda	FALSE
bdbddddacaabdbdbb	FALSE
caacdddabbbddaddd	FALSE
caadaadbbccddcbdc	FALSE
cadaadabbdcccccba	FALSE
cadababadcbbbccdd	FALSE
cbbcaccadabcdccdb	FALSE
cbbcadcbbbaadddcc	FALSE
ccabdadcdcaccabba	FALSE
ccabdbdcbcacbccad	FALSE
cccdcabdadccddadb	FALSE
cccdcacdddcdcdada	FALSE
cdbdbcbdcbdbbbaac	FALSE
cdbdbcddddddacdcd	FALSE
daaacccdacbadbaad	FALSE
daaacdccabacadadb	FALSE
daccdcdbcccbacdbb	FALSE
dacdaaabadddabbcd	FALSE
dbbbacbaabcbbbaaa	FALSE
dbbbaccbabcadabda	FALSE
dbddbacbbbaabdbbd	FALSE
dbddbbbbddbacbabb	FALSE
dcccabcaaaddabcdc	FALSE
dcccbccadbabdcdab	FALSE
ddbbdcdbbcabbcaba	FALSE
ddbbddaaabcaadbbc	FALSE
aaaaaaabcadadcaccc	TRUE
aaaaaabddaccddddac	TRUE
aacbadddcdaccadcad	TRUE
aacbcacddddaacacac	TRUE
abadaddaadccdcadda	TRUE
abadcaadaddaaacada	TRUE
abdcddddacddddcadc	TRUE
abddaacdddacdacddd	TRUE
accacdaaabaaaddaca	TRUE
accacdddbaaacdcacc	TRUE
adabadcaacdaaccdad	TRUE
adabcaacacccdddcaa	TRUE
adcddadcdabadcddca	TRUE
adcddaddaaaaabadac	TRUE
baadcdadcdcdaaccdd	TRUE
baadcdcaddcdacadaa	TRUE
badadcdcdcccdcddad	TRUE
badadcddccaccadcdd	TRUE
bcadaacdaddcccddac	TRUE
bcadaadadaddcdcacc	TRUE
bcdaddcadacccccccc	TRUE
bcdaddccadaddadaaa	TRUE
bdacdacddadaadcdaa	TRUE
bdacdaddddadccddcc	TRUE
bdcdddcaccddaddacc	TRUE
bdcddddcadcadacaaa	TRUE
caacdbaaadacaadcdd	TRUE
caacdbaddacdaacdda	TRUE
cadbdccaddadcaaacc	TRUE
cadbddcddacddaacdc	TRUE
cbccacaadddccccdca	TRUE
cbccacacddaaddcaad	TRUE
ccabaacdaccdaaccca	TRUE
ccabaadaacdcdaacdc	TRUE
ccccdbddadcadadcdc	TRUE
ccccdbddccddadddaa	TRUE
cdbccacdaddaadaccd	TRUE
cdbccadcadadcaddac	TRUE
daaadbacaaaaccacdd	TRUE
daaadbdacdddacacac	TRUE
daccdbcdcaaaaccadd	TRUE
daccdcccccabaaaddc	TRUE
dbadcccacddcaddaaa	TRUE
dbadcccadcddccccca	TRUE
dbddadcaddddadcdcc	TRUE
dbddcaadaaadddaccc	TRUE
dccbcdacdadcaccccc	TRUE
dccbcdacddaacdcadd	TRUE
ddadaadcdcbdccaadc	TRUE
ddadacadabcccacaac	TRUE
aaaaaccdcbcbcbcaaa	FALSE
aaaaacdcbbdaaccacc	FALSE
aacbcccccbbbbdaaba	FALSE
aacbcdcbadcccbccac	FALSE
abbacbabbacbdcdbca	FALSE
abbacdaacddbbdacdb	FALSE
abdbdcbadccbaabaad	FALSE
abdcadbcabdbdcdbaa	FALSE
accbcacabbabbddccb	FALSE
accbccddbbcccacaac	FALSE
adbabccaadcbacadbc	FALSE
adbabcdaaacacadbcc	FALSE
addccbbddaaadcaaaa	FALSE
addccbcdbbcaaabcba	FALSE
babddaadadacbbcabc	FALSE
babddabcacacdacddd	FALSE
bbacccacbddbdcaadb	FALSE
bbacdcaaabadbdbbac	FALSE
bbdacadbcabbaccddc	FALSE
bbdacddccacbababaa	FALSE
bcbcbacaaacccacddc	FALSE
bcbcbbaacadccdbcdc	FALSE
bdababadaccccbdabb	FALSE
bdababbbccdbdcabdd	FALSE
bdcccadadbbadabaaa	FALSE
bdcccbbdcbcccccbba	FALSE
cabbadcbacacbbcbaa	FALSE
cabbaddcddcdbddbbb	FALSE
cadddabcddddcbbdbc	FALSE
cadddadbacaaaddacb	FALSE
cbcbdbacdbccdcabca	FALSE
cbcbdcadabcdbbbdaa	FALSE
ccacdcdddcabddcdbb	FALSE
ccacddccdcacbdbcaa	FALSE
ccdbadbbcaaadbcdcd	FALSE
ccdbbbaaabaabdaaac	FALSE
cdcabbadbdcbadccda	FALSE
cdcabdababdbaabbdb	FALSE
daabbbadcbabaaabbc	FALSE
daabbdbbccdcddbbcb	FALSE
daccdaaccbddcdcaab	FALSE
daccdabddadbddcaca	FALSE
dbbbcadccabadbaabb	FALSE
dbbbcbbcbbaadcaddc	FALSE
dbdcbcbadacdabaaac	FALSE
dbdcbcbdaacacdaccb	FALSE
dccbaaddbbdaabbdcb	FALSE
dccbabaacaacaaccdd	FALSE
ddbaacdbcdaddadccd	FALSE
ddbabaadbdaadaddaa	FALSE
aaaaaaabadcdaaaccaa	TRUE
aaaaaadddcccacdbdcc	TRUE
aaccccdbaccdcdadadd	TRUE
aacccdcddbcaddadacd	TRUE
abaddccdcdacdddccaa	TRUE
abaddcdddaccddadacd	TRUE
abddcadcdccaaadadad	TRUE
abddccacacdaadcdcac	TRUE
accbaacddadcacccccc	TRUE
accbaccaccccacdadcc	TRUE
adadccdacaabcadccac	TRUE
adadcdadccbcdcaaadc	TRUE
addbcaaddaaadcdccaa	TRUE
addbcdadcdcacdcadac	TRUE
bacaadccacacccdadaa	TRUE
bacaadccadaccccdaad	TRUE
badcdaaaadcacacccaa	TRUE
badcdaaccdaccdcddac	TRUE
bccaadccacccaccdccc	TRUE
bccaadcccdcccaddadd	TRUE
bcddaacadcdcaacccdc	TRUE
bcddaacadddcadccdad	TRUE
bdcaccddacaaddcdcaa	TRUE
bdcaccddcadacdaaaaa	TRUE
bddcdaaacddcdadadcd	TRUE
bddcdaadddcacadadac	TRUE
cabdaaddadaacccccaa	TRUE
cabdacaccacadcdddac	TRUE
caddcaadadcdacddabc	TRUE
caddcbcdddcddaacddd	TRUE
cbcddadcdcccaadacad	TRUE
cbcddcaadddaaacadca	TRUE
ccbaaccdaddaddacacd	TRUE
ccbaacdaaadddcddddc	TRUE
ccdbdccccdcaaacadaa	TRUE
ccdbdccccdddcadddaa	TRUE
cdbdaadddcddadcdadc	TRUE
cdbdacaacdaacddaccc	TRUE
daabdaacddaccaddaac	TRUE
daabdcaaddcdcccdcca	TRUE
dacdcbcddccdcddddac	TRUE
dacdccaaddaadcccbca	TRUE
dbcaaadddddacdcdcdc	TRUE
dbcaaccccddccaaccca	TRUE
dbddcacdddacdcccccd	TRUE
dbddcaddaccaccdaddc	TRUE
dccbddaadaaccaddccd	TRUE
dccbddacaaadcdadcaa	TRUE
ddbadaadadcccccddda	TRUE
ddbadaddacddaadacac	TRUE
aaaaaaaccaddadaaccd	FALSE
aaaaaaccdbccddcdcab	FALSE
aacbccdcdcbbacaadda	FALSE
aacbcdbdcdbbacdacaa	FALSE
abbacbcbddaaccdacbb	FALSE
abbaccacbddaacbcbcb	FALSE
abddcbabbdaabbacbdb	FALSE
abddcbaddacadbccbca	FALSE
acccbacbdbbdabbccbc	FALSE
acccbbacabaaacbcbbc	FALSE
adbaababdcadcbabbba	FALSE
adbaabaccaaccabdbbd	FALSE
addbccdacabbcacbcbb	FALSE
addbccdbcdbcdcbcbad	FALSE
babdcccddacdbdbabca	FALSE
babdcdabcbabbddaacc	FALSE
bbacaccbbcddbbbdcab	FALSE
bbacacdacdacddcacdb	FALSE
bbcdcacdcaadccabadc	FALSE
bbcdcbaaabbddcacdcd	FALSE
bcbbbadabababbacccd	FALSE
bcbbbcbcacaadacaaac	FALSE
bcddcdcacbdbcababdc	FALSE
bcddcddddaabdddabdb	FALSE
bdccdcabdacdddbcacc	FALSE
bdcdaabcdaaaaabbcab	FALSE
cabcabaccdbccbdddad	FALSE
cabcabbdbdacaaaccbc	FALSE
cbaacaccbbccabadaaa	FALSE
cbaacadcaadacdbcbdb	FALSE
cbcdcbabacdbbaaaccb	FALSE
cbcdcbbddddcaabcadc	FALSE
ccbbbcaadcbdcaabaca	FALSE
ccbbccacbdababcdacc	FALSE
cdaababcaaacacbaaab	FALSE
cdaabccccdabbcbcdcc	FALSE
cddaabbababaaabdddc	FALSE
cddaabbcddbadaccacd	FALSE
dabccbcbbcabaddcdbb	FALSE
dabcccabcaabbddbbac	FALSE
dbaacbddaaddbacddca	FALSE
dbaaccbcbadabdcbaac	FALSE
dbccaccabadccbbdbbc	FALSE
dbccbabdcddbbcaabdc	FALSE
dcadcbabadcaacdbddd	FALSE
dcadcbabddaabadcbdb	FALSE
dcdacbdbbbdaacddddb	FALSE
dcdaccacabdadbddcca	FALSE
ddbcbbabdcdaaccdaba	FALSE
ddbcbbadabbbacbbdcb	FALSE
