aaaaaaacda	TRUE
aaaaaacdcd	TRUE
aacccddada	TRUE
aaccdaadab	TRUE
abaacccadd	TRUE
abaaccdadd	TRUE
abcdcaadaa	TRUE
abcdcaadcd	TRUE
acaacadddc	TRUE
acaaccccda	TRUE
acccdadadb	TRUE
acccdcacad	TRUE
adaacadddc	TRUE
adaacadddc	TRUE
adccdddddd	TRUE
adcdaaccad	TRUE
caaaacdddc	TRUE
caaaadadaa	TRUE
cacaaccccb	TRUE
cacaaccdcc	TRUE
cadacddaad	TRUE
cadacddaad	TRUE
ccaaccdcdc	TRUE
ccaacdaaab	TRUE
cccaccdccb	TRUE
cccaccddda	TRUE
ccdadaccab	TRUE
ccdadacdca	TRUE
cdaaddcdda	TRUE
cdaadddaab	TRUE
cdccaccada	TRUE
cdccacccaa	TRUE
cddcadccdc	TRUE
cddcadccdd	TRUE
daaccddddd	TRUE
daacdaacca	TRUE
dacccccdcd	TRUE
daccccdaaa	TRUE
dadcdaccaa	TRUE
dadcdaccac	TRUE
dcadaaadda	TRUE
dcadaacadb	TRUE
dccdadddab	TRUE
dccdadddcd	TRUE
dcddcaaccb	TRUE
dcddcacaab	TRUE
ddadcdcadc	TRUE
ddadcdcdcc	TRUE
ddcdddcaad	TRUE
ddcdddcadd	TRUE
aaaaaaaaba	FALSE
aaaaaacdbc	FALSE
aacdbcdbdc	FALSE
aacdbdbcdb	FALSE
abbbdbaaab	FALSE
abbbdcaddc	FALSE
abdddccaab	FALSE
abdddcdcbd	FALSE
accbcdaddb	FALSE
accbdbaccd	FALSE
adbacbabbb	FALSE
adbacbcbab	FALSE
addddcbcbb	FALSE
addddcdabb	FALSE
bacbccbddc	FALSE
bacbdabcaa	FALSE
bbadddccca	FALSE
bbadddcdda	FALSE
bbddbaadad	FALSE
bbddbbbbcb	FALSE
bccbddabaa	FALSE
bccbddbbcd	FALSE
bdbacdbdbd	FALSE
bdbadacdac	FALSE
bddcdbcbac	FALSE
bddcdcbacc	FALSE
cacabbacbb	FALSE
cacabcdccb	FALSE
cbacbaacba	FALSE
cbacbbbbba	FALSE
cbcdbccccd	FALSE
cbcdbcdaac	FALSE
ccbbccabba	FALSE
ccbbccdabb	FALSE
cdaaadcdbc	FALSE
cdaabadacd	FALSE
cdccaacabc	FALSE
cdccabccbc	FALSE
daadaaadbd	FALSE
daadaadbbb	FALSE
dadbccdcba	FALSE
dadbcddcaa	FALSE
dbbcdadadc	FALSE
dbbcdbabdd	FALSE
dcabbabbad	FALSE
dcabbbacbd	FALSE
dcdaacbccd	FALSE
dcdaacdcbc	FALSE
ddbbbdbbbb	FALSE
ddbbcabdbc	FALSE
aaaaaaacdab	TRUE
aaaaaaccddb	TRUE
aaccccadaac	TRUE
aaccccadcdb	TRUE
abaaccddaad	TRUE
abaaccddddc	TRUE
abccdcaadaa	TRUE
abccdcaddac	TRUE
acaaccdcddb	TRUE
acaaccdddad	TRUE
accdadaccaa	TRUE
accdadadacd	TRUE
adaacadcacb	TRUE
adaacaddccd	TRUE
adcdacadacc	TRUE
adcdaccadcc	TRUE
caaaaccaada	TRUE
caaaacccdda	TRUE
cacaaccaccd	TRUE
cacaaccddca	TRUE
cadaadcacab	TRUE
cadaaddacaa	TRUE
ccaaccddccc	TRUE
ccaacdaaadb	TRUE
ccccaaacaca	TRUE
ccccaaacacc	TRUE
ccdadcaacdd	TRUE
ccdadcadacc	TRUE
cdaadcddadb	TRUE
cdaaddaaccd	TRUE
cdcadccdaac	TRUE
cdcadccdaad	TRUE
cddcacccdcc	TRUE
cddcacdaaaa	TRUE
daaccddcdab	TRUE
daacdaaacdc	TRUE
daccdcaadda	TRUE
daccdcacaab	TRUE
dadcddcadcc	TRUE
dadcddccada	TRUE
dcacdddadaa	TRUE
dcadaaaacaa	TRUE
dccdacacaac	TRUE
dccdacacaad	TRUE
dcddcddadda	TRUE
dcddcddadda	TRUE
ddaddadaaca	TRUE
ddaddadcdcb	TRUE
ddcddaaadcd	TRUE
ddcddacdcdd	TRUE
aaaaaaaacbb	FALSE
aaaaaabcacc	FALSE
aaccacdabdc	FALSE
aaccadabaca	FALSE
abbbadcdcac	FALSE
abbbbabdaad	FALSE
abddddaaabd	FALSE
abddddabbbd	FALSE
acccadbdaac	FALSE
acccbabcadc	FALSE
adbaddadcda	FALSE
adbbaabacbb	FALSE
baaaddbbcdc	FALSE
baaaddccddc	FALSE
bacdddbaacd	FALSE
bacddddbddd	FALSE
bbbcdaddcdb	FALSE
bbbdaaacbba	FALSE
bcababdddbc	FALSE
bcabacdbbab	FALSE
bcdaaacbddd	FALSE
bcdaaadabdc	FALSE
bdbdacccaba	FALSE
bdbdadcbddb	FALSE
bdddcbcbaca	FALSE
bdddcbcbdab	FALSE
cacbdbaccad	FALSE
cacbddcbddd	FALSE
cbadcdccdaa	FALSE
cbaddaabcad	FALSE
cbdbacbabbd	FALSE
cbdbaccabbb	FALSE
ccbdbdacccc	FALSE
ccbdbddcbdb	FALSE
cdaacdacaba	FALSE
cdaacdccdba	FALSE
cdcdbbbdadc	FALSE
cdcdbdcacdb	FALSE
daadddbdcbb	FALSE
daadddddcba	FALSE
dadcbbacdca	FALSE
dadcbbadacc	FALSE
dbcaadadadc	FALSE
dbcaadbdbca	FALSE
dcabaddccbc	FALSE
dcabbaccadd	FALSE
dccdbbcaaad	FALSE
dccdbbcbbba	FALSE
ddbcabbbbaa	FALSE
ddbcabccbbd	FALSE
aaaaaaaadaab	TRUE
aaaaaadcddca	TRUE
aaccccdaadcd	TRUE
aaccccdacccd	TRUE
aadddaadacdb	TRUE
aadddacddacb	TRUE
abcccaaccaaa	TRUE
abcccaccddcd	TRUE
acaaaaccaccc	TRUE
acaaaaccaddb	TRUE
accccaacaddd	TRUE
accccaacddab	TRUE
acddcdcdadab	TRUE
acdddaccccab	TRUE
adccaddadddb	TRUE
adcccaaaccdd	TRUE
caaaaaadcdaa	TRUE
caaaaacacaad	TRUE
cacaaddaadac	TRUE
cacaaddacaab	TRUE
cadacccdacab	TRUE
cadaccdccdaa	TRUE
ccaacaddccdb	TRUE
ccaaccaacacb	TRUE
cccaccdaaddc	TRUE
cccaccdadadc	TRUE
ccdadadaaccc	TRUE
ccdadadacada	TRUE
cdaadadccdda	TRUE
cdaadcdacadd	TRUE
cdcaddaccadc	TRUE
cdcaddacccab	TRUE
cddcaccaadac	TRUE
cddcaccaccac	TRUE
daaccadadccd	TRUE
daaccadadddd	TRUE
daccadddacca	TRUE
daccaddddadb	TRUE
dadccadddacc	TRUE
dadcccaacacc	TRUE
dcacaddaadad	TRUE
dcaccaaacada	TRUE
dccccdacccdc	TRUE
dccccdcdcdad	TRUE
dcddadccccda	TRUE
dcddadcdcadb	TRUE
ddadaddaacad	TRUE
ddadaddcdcaa	TRUE
ddcdddcccddc	TRUE
ddcdddccddcd	TRUE
aaaaaaaacbba	FALSE
aaaaaabaccbd	FALSE
aacccbacdbab	FALSE
aaccccdaaabb	FALSE
abbbabdcbccc	FALSE
abbbacdadbdd	FALSE
abdddbbabaca	FALSE
abdddcabcbbc	FALSE
accdadacbcbb	FALSE
accdbaababbc	FALSE
adbbbddccdcd	FALSE
adbbccabbadd	FALSE
baabbabacbcc	FALSE
baabbbccbddb	FALSE
badacbdcdbca	FALSE
badacccaddcd	FALSE
bbbcddcbbddd	FALSE
bbbdaabcccbb	FALSE
bcaadacdabab	FALSE
bcaadbcbbbbc	FALSE
bcccaaddbaba	FALSE
bcccabaccbab	FALSE
bdbadadacaca	FALSE
bdbadbacccad	FALSE
bdddcbabbaac	FALSE
bdddcbabddcc	FALSE
caccbcdbdaac	FALSE
caccbdacbadc	FALSE
cbbababcdabd	FALSE
cbbabbacccba	FALSE
cbdbbccadadb	FALSE
cbdbcaaadbdc	FALSE
ccbccaaaccdd	FALSE
ccbccbacbdca	FALSE
cdaadaadcbcc	FALSE
cdaadadadcbd	FALSE
cdccdbccdddc	FALSE
cdccdbdccbab	FALSE
dabbbdddadac	FALSE
dabbcbaadbdd	FALSE
daddbacabbba	FALSE
daddbccbabba	FALSE
dbcadcdddbca	FALSE
dbcaddababbb	FALSE
dcabcddbdcdc	FALSE
dcabdacbbdab	FALSE
dccdcbabdabc	FALSE
dccdcbbcdddb	FALSE
ddbbddbcdbaa	FALSE
ddbbddbdbbac	FALSE
aaaaaacacadda	TRUE
aaaaaacdcadca	TRUE
aaccaacccdaac	TRUE
aaccaadaddddd	TRUE
aaddaddccaddc	TRUE
aaddaddccdcda	TRUE
abccacaaccada	TRUE
abccacacdddcd	TRUE
abdcdcccadacd	TRUE
abdcdcdaaaccc	TRUE
acadcddccdcaa	TRUE
acadcddddcccc	TRUE
acdcaaaaccccd	TRUE
acdcaadcddddc	TRUE
adaddadaccacd	TRUE
adaddaddccdad	TRUE
addcdaadaccaa	TRUE
addcdadccdcab	TRUE
caadacccdcccd	TRUE
caadacdaaacdb	TRUE
cacddcdacdada	TRUE
cacddcdcddadc	TRUE
ccaaaadccddca	TRUE
ccaaaaddcdacc	TRUE
cccadccaaaccc	TRUE
cccadcccadacd	TRUE
ccdaddddacacb	TRUE
ccdadddddcccb	TRUE
cdaaddaccaacb	TRUE
cdaaddadcadcd	TRUE
cdcaddaddcddc	TRUE
cdcaddcaadaca	TRUE
cddccadaaccab	TRUE
cddccadaddacc	TRUE
daacadadcddad	TRUE
daacadaddadad	TRUE
dacadcaccdaaa	TRUE
dacadcaccdadb	TRUE
dadcacadaacdd	TRUE
dadcaccadaaac	TRUE
dcaccacaddadc	TRUE
dcaccaccaaaab	TRUE
dcccdcaacdcdc	TRUE
dcccdcaadcaaa	TRUE
dcddaccaacaad	TRUE
dcddaccadacad	TRUE
ddadcacaaaaac	TRUE
ddadcacaadddc	TRUE
ddcddadcadaac	TRUE
ddcddcaaaadac	TRUE
aaaaaaabdaccc	FALSE
aaaaaabcbabda	FALSE
aaccacddacdbd	FALSE
aaccadcdbcdba	FALSE
abbadadcdbcba	FALSE
abbadbaaadacd	FALSE
abdcbcabaaaca	FALSE
abdcbcdaaacda	FALSE
accabacaccbbd	FALSE
accabbbadccdc	FALSE
adadacddadbaa	FALSE
adadadabdacac	FALSE
addbdcbbbcdaa	FALSE
addbdccccadbb	FALSE
babdbdcbabcbb	FALSE
babdbdddccaba	FALSE
bbacacbaacbda	FALSE
bbacacbacbcdb	FALSE
bbdbadcbcdabc	FALSE
bbdbbabbadbad	FALSE
bcbddacabadbc	FALSE
bcbddddabcdaa	FALSE
bdaccbacacdab	FALSE
bdacccadcdcbb	FALSE
bdcdbdabdabda	FALSE
bdcdbdaccacdc	FALSE
cabbbdaabdbba	FALSE
cabbbdcbcacad	FALSE
cadcbbcaaaaac	FALSE
cadcbcacbbbad	FALSE
cbcbaaddbdcdd	FALSE
cbcbbabacddac	FALSE
ccbaddcbdcccd	FALSE
ccbadddbccabc	FALSE
ccdccdbcadbcd	FALSE
ccdccdbcdbdcc	FALSE
cdcacddadadbc	FALSE
cdcbaaabccbda	FALSE
daadbcabdddbb	FALSE
daadbcdcaabaa	FALSE
dadbddbbadccc	FALSE
dadcaaaaccbac	FALSE
dbbddbbbacaba	FALSE
dbbddbcdcacdc	FALSE
dcabdcbaabcdc	FALSE
dcabdcccdcccc	FALSE
dcdacbbaccdbc	FALSE
dcdacbbbbdadc	FALSE
ddbcdaccadabc	FALSE
ddbcdadbaaacc	FALSE
aaaaaaaccadacb	TRUE
aaaaaacdddaccc	TRUE
aaccccacccacad	TRUE
aaccccaccdaddb	TRUE
aaddcddcadcdad	TRUE
aadddaccddcadd	TRUE
abccdadccadddc	TRUE
abccdcadcadadd	TRUE
acaacaaaaccacb	TRUE
acaacaaadcccaa	TRUE
accccdcddaaaab	TRUE
accccddaadadcd	TRUE
acddddadddcdda	TRUE
acddddcaadadcd	TRUE
adcccacdcdaddb	TRUE
adcccadacdacad	TRUE
adddcdacdacdcd	TRUE
adddcdadcaadac	TRUE
caaddadaacccaa	TRUE
caaddadaacddcd	TRUE
cacddaddcddddb	TRUE
cacddcaacaaccc	TRUE
cadddcdaaddccc	TRUE
cadddcddcaacac	TRUE
cccaccaacacccd	TRUE
cccaccaaddaccd	TRUE
ccdacaddcdddad	TRUE
ccdaccaadaaacd	TRUE
cdaaccccddddab	TRUE
cdaacccdaacadc	TRUE
cdcaccdcaadcdc	TRUE
cdcaccdcdcacca	TRUE
cddccaadccdcaa	TRUE
cddccaaddadacb	TRUE
daacadaadddadc	TRUE
daacadcaddcaad	TRUE
daccccddccccda	TRUE
dacccdaaaaadac	TRUE
dadccadcdccdcc	TRUE
dadccaddacdcad	TRUE
dcacdacaddcada	TRUE
dcacdaccaacddb	TRUE
dcccdadccddcab	TRUE
dcccdaddacacdb	TRUE
dcddaaccaddadd	TRUE
dcddaaccddaada	TRUE
ddaddaaacdaccb	TRUE
ddaddacaaddaad	TRUE
ddcddadcacccad	TRUE
ddcddcaaaaacda	TRUE
aaaaaadbdacaaa	FALSE
aaaaabbabcccda	FALSE
aacccdbbcdbacc	FALSE
aaccdbbaacaabc	FALSE
abbcbbbadbbbac	FALSE
abbcbcbdbabdbc	FALSE
acabadaadcaabb	FALSE
acabadabdbcadb	FALSE
acccddabcadddc	FALSE
acccddbacddbbd	FALSE
adbbbccaadbbad	FALSE
adbbcabbabccbc	FALSE
adddccabddcdcc	FALSE
adddcdbcaddabd	FALSE
bacbbcdcccbcda	FALSE
bacbcbddcaabbd	FALSE
bbaddddabbbccb	FALSE
bbaddddadbdddb	FALSE
bbdcabbaccdccc	FALSE
bbdcacccdccdba	FALSE
bccacbbbdcdaad	FALSE
bccacbbcaaadcb	FALSE
bdacaaaddddbab	FALSE
bdacacbbdaccbb	FALSE
bddbcacccdbdaa	FALSE
bddbccadacddbb	FALSE
cabdddacdcdadd	FALSE
cacaaabbbbbadb	FALSE
cbabdcbabdbaba	FALSE
cbacaadcacbcca	FALSE
cbccddabccbbad	FALSE
cbccddccbabaaa	FALSE
ccbbaacdaddabc	FALSE
ccbbacabdabbcb	FALSE
ccdcbdbccaccbd	FALSE
ccdcbdbdbcdcad	FALSE
cdcacdbaccbabd	FALSE
cdcacdbcbabccb	FALSE
daacabbcbaabbd	FALSE
daacacdabcddda	FALSE
dacddbbcccaaca	FALSE
dacddcdccbbbcb	FALSE
dbbccabbaacbcc	FALSE
dbbccaccbccccb	FALSE
dbdddccaccdcbc	FALSE
dbdddddaddddcb	FALSE
dcccdadcdcdcbd	FALSE
dcccdbdccccddc	FALSE
ddbbadcbabcbbb	FALSE
ddbbadcbbdbbab	FALSE
aaaaaaaccadaccb	TRUE
aaaaaacddacccaa	TRUE
aaccadcaccdaadc	TRUE
aaccadcdadccaac	TRUE
aadddadcdccccaa	TRUE
aadddcaccaaacdb	TRUE
abccaddcaadaddd	TRUE
abccadddaddaddd	TRUE
acaaacdacaccddc	TRUE
acaaacdacdaadaa	TRUE
accccdaddcadcac	TRUE
accccdcaddddddd	TRUE
acdddcacdddcdaa	TRUE
acdddccadcddadd	TRUE
adccacaacdaadda	TRUE
adccacadacdcadd	TRUE
adddcddccddacac	TRUE
addddaaaadadcdb	TRUE
cacaadcaadadddc	TRUE
cacaaddaacddacb	TRUE
cadaacdddaadcaa	TRUE
cadaadcccaadaab	TRUE
ccaaccadaadaada	TRUE
ccaaccadddacaac	TRUE
cccadcaaddacadc	TRUE
cccadcacccdccad	TRUE
ccdaddadaccccca	TRUE
ccdaddcacddcccc	TRUE
cdacacaaddccacd	TRUE
cdacacaccacdcca	TRUE
cdcccddcadddadb	TRUE
cdcccddccacdccc	TRUE
cddccadddcdaaab	TRUE
cddcccacaccdcda	TRUE
daacacdaaacadaa	TRUE
daacacddacadcac	TRUE
dacccdadccadacd	TRUE
dacccdcaaadacca	TRUE
dadcddcccadcaad	TRUE
dadcddccccacaac	TRUE
dcadcaaaadccdad	TRUE
dcadcaaadadacdc	TRUE
dcdaaadddaddadb	TRUE
dcdaacaaccaccac	TRUE
ddaaaaddcaddcdd	TRUE
ddaaacacadaadcd	TRUE
ddcaaacaaccaadb	TRUE
ddcaaaccacdacdc	TRUE
dddaaccdaccadca	TRUE
dddaaccdccdcccd	TRUE
aaaaaadcaaacbcb	FALSE
aaaaadcdcdacbdd	FALSE
aaccbcdcbbddadb	FALSE
aaccbdbbccbaaac	FALSE
abbadbcddbaabca	FALSE
abbaddbdbdbadad	FALSE
acaaaccbbaaccbd	FALSE
acaaaddddadcbbc	FALSE
acccbabdbdbdbac	FALSE
acccbbbccdadcbd	FALSE
adadcbddabadcbb	FALSE
adadcddaadbcbaa	FALSE
addcbabacdcaabd	FALSE
addcbabcdaddbab	FALSE
bacabdcadccdacc	FALSE
bacabdcccaccaac	FALSE
bbacbdbdbdcabaa	FALSE
bbacbdcbcdadbcc	FALSE
bbdadbbdbaddccb	FALSE
bbdadcaaddbbbda	FALSE
bcbcbcadbccccac	FALSE
bcbcbcbcccdbadb	FALSE
bdabdcacccbcadd	FALSE
bdabdcbaaadaddc	FALSE
bdcdccaddabccca	FALSE
bdcddcbabcdaaac	FALSE
cabcabddaaccccd	FALSE
cabcabddadbdcda	FALSE
cadddcdcacdcabb	FALSE
cbaaaacdabdadaa	FALSE
cbcdabacbcbdbad	FALSE
cbcdabcabbbaada	FALSE
ccbadaabbabcbcd	FALSE
ccbadbbcabbaada	FALSE
ccdcddcdabaccad	FALSE
ccdcdddcbbacabd	FALSE
cdcababcbaaacbb	FALSE
cdcabbdbbcddacd	FALSE
daadabcbdadabad	FALSE
daadabddaacdbcd	FALSE
dadadabbbccacab	FALSE
dadadacbabddbbb	FALSE
dbbdbcddddaddcb	FALSE
dbbdbdccdbdbbcd	FALSE
dcabcbcbbddadcb	FALSE
dcabcdccaaabdbc	FALSE
dcdacbddbbacdad	FALSE
dcdacdddccddcbb	FALSE
ddbcdaacbbacbdb	FALSE
ddbcddabcaaabba	FALSE
aaaaaacadaadaccc	TRUE
aaaaaaccdccadaab	TRUE
aacccccadacccccb	TRUE
aaccccccacacacad	TRUE
abaaacadadccacdd	TRUE
abaaacadcaaddcca	TRUE
abcccaaadcccacda	TRUE
abcccaaccdcaacad	TRUE
abddcddcaacacacc	TRUE
abddcddcddadcacc	TRUE
accadccdccdccdcc	TRUE
accadccdcdaacadd	TRUE
acddccdccddddacc	TRUE
acddccddcdaaaddd	TRUE
adcacacdadcdddac	TRUE
adcacadccadaadad	TRUE
addccdadcaacaccc	TRUE
addccdcccdacddac	TRUE
caacdcdcddccdaab	TRUE
caacddaddcacdacb	TRUE
cacdcccadddaddab	TRUE
cacdccccacadacdb	TRUE
caddcdacaccaadac	TRUE
caddcdacadaddcad	TRUE
ccaddcdcdddaddcb	TRUE
ccaddcddaddaacdc	TRUE
ccdaccaddcccacdc	TRUE
ccdacccadaccdadd	TRUE
cdaadacccaacadcc	TRUE
cdaadacccdddcacd	TRUE
cdccaacdaaadcaac	TRUE
cdccaadaccdadccd	TRUE
cddccaaccaddddaa	TRUE
cddccaccccaacadd	TRUE
daaccdaccaacdccc	TRUE
daaccdcaadcdacda	TRUE
dacccdcacdccaaaa	TRUE
dacccdcdaaaaadcd	TRUE
daddaacaccadaacb	TRUE
daddaaccadaaacaa	TRUE
dcaddacadccdccad	TRUE
dcaddacdcaddccac	TRUE
dccddaaadcddaaad	TRUE
dccddaaddddadaac	TRUE
dcdddcccaccdcdaa	TRUE
dcdddcdaaccdddaa	TRUE
ddcaacaddcaacdcc	TRUE
ddcaaccdaccacddd	TRUE
dddaaacdcacacacb	TRUE
dddaaacddaccaaac	TRUE
aaaaabdadabcbbdb	FALSE
aaaaacbcdbdbaccd	FALSE
aaccdccbbadcadad	FALSE
aaccddabaccdcccc	FALSE
abaddccddddaacdb	FALSE
abadddcaaaabddab	FALSE
abdcbbaddcbbdcab	FALSE
abdcbcaadbbbdbbc	FALSE
accbdbbcbbabbdbd	FALSE
accbdbcadcbbabca	FALSE
adbaababbdaccccb	FALSE
adbaababdabcbcac	FALSE
addbacdbbcbccbbd	FALSE
addbadbabdddddac	FALSE
babdbbaaabbdbbcc	FALSE
babdbbcacadddabb	FALSE
bbacadaacbdadccd	FALSE
bbacadbcdccabbba	FALSE
bbdcabbcdacdcdba	FALSE
bbdcacadbaaacacb	FALSE
bcbdacaddbdaadcc	FALSE
bcbdadacacadacaa	FALSE
bdaadabcdbbbbbbd	FALSE
bdaadacaadbccbab	FALSE
bdccddbbcacabdad	FALSE
bdccddcaacdaccdc	FALSE
cabbcadccacddccb	FALSE
cabbcbdddcbbadcd	FALSE
cadcdbcbabbcbdcc	FALSE
caddaabcadaaccda	FALSE
cbcbbbdcdbdbcbad	FALSE
cbcbbdbdcddcdabd	FALSE
ccadcdcbabaacdca	FALSE
ccaddccbdccbcbbb	FALSE
ccdcbaaacabcacdd	FALSE
ccdcbabcbbccddba	FALSE
cdcacdacccacbdcb	FALSE
cdcacdddbcdbcccc	FALSE
daadbddaddaadddb	FALSE
daadcaaacacddcbd	FALSE
dadaadddcacdcabb	FALSE
dadabaabbbcccbbc	FALSE
dbbccdbddbcbddaa	FALSE
dbbcdacadcaccaac	FALSE
dcacabacbacaabdc	FALSE
dcacabacdccabadb	FALSE
dccdcbccdbbcbbdc	FALSE
dccdcbcdadbcabcc	FALSE
ddbbdbdaccbaaddc	FALSE
ddbbdbddaabdcadb	FALSE
aaaaaaaaacaadaccd	TRUE
aaaaaaaacdaaacaaa	TRUE
aacccdaaaacadaaaa	TRUE
aacccdacaadccddcd	TRUE
aaddcccccddccccdb	TRUE
aaddccccdcadacacb	TRUE
abcadadcadccdcddd	TRUE
abcadcacaccdaadda	TRUE
abddccdccdcadccca	TRUE
abddcdaacccdaaccd	TRUE
accadaadcdadcadcd	TRUE
accadadadacaacddb	TRUE
acddccdcddaadaadb	TRUE
acddcdccaaaacccac	TRUE
adccaccddacacadac	TRUE
adccadaaaacdccdaa	TRUE
adddddcdaaadaadcd	TRUE
adddddddddacaaddc	TRUE
cacaccaaadcaccdcd	TRUE
cacaccacaddcdccab	TRUE
cadacdaadadddaacb	TRUE
cadacdacccadddcdc	TRUE
ccaacdaaaadaadacc	TRUE
ccaacdaacaaaacaad	TRUE
cccadcacddddaddac	TRUE
cccadcadadadddddb	TRUE
ccdcaccddcdaccdcd	TRUE
ccdcacdcdadddaaca	TRUE
cdaadcdacccdcadcc	TRUE
cdaadcdccacacaacb	TRUE
cdcacddcdddddcaad	TRUE
cdcadaadddccacada	TRUE
cddcaddadcaacddda	TRUE
cddccaaacccdaaaab	TRUE
daaccaaaaddccddaa	TRUE
daaccaaaccadcdadb	TRUE
daccdadccacdcacad	TRUE
daccdadccdcaaddcc	TRUE
dadcdccaadcdcadab	TRUE
dadcdcccdaaadadca	TRUE
dcacdacacdcacaada	TRUE
dcacdacadcdccdacb	TRUE
dcccddcdcccacddca	TRUE
dccdaaaaccdccaaab	TRUE
dcdcddcadaaddaaca	TRUE
dcdcddcdaaddddcdd	TRUE
ddacdaccaccaaacca	TRUE
ddacdacdcadaadaab	TRUE
ddcdcadacaaacacab	TRUE
ddcdcadcdcdaddacb	TRUE
aaaaaabdacaddbaca	FALSE
aaaaaabdcadaaccab	FALSE
aaccdcacccdbbaaca	FALSE
aaccddbdbbbbacaab	FALSE
abbcccadbabaccbbb	FALSE
abbccdaadacbbabcd	FALSE
acabadbadddbaacdd	FALSE
acabbdbdbbdcccccd	FALSE
accdaacddaccdbbba	FALSE
accdabbaabddadbdd	FALSE
adbcabadadbbbacca	FALSE
adbcacbcbbddbdbab	FALSE
baaabdcacbcaacdbb	FALSE
baaacbacddcdbaaac	FALSE
baccbbbdcabbbadbd	FALSE
baccbccaaacaabaaa	FALSE
bbadcdaddbdbbdbbb	FALSE
bbadcddcccdbcddda	FALSE
bbdcacaaacbadcbbc	FALSE
bbdcacabbbddbcacd	FALSE
bccabdaabdbcddcad	FALSE
bccabdadbbadbcabc	FALSE
bdadabbaccaaaadda	FALSE
bdadabdadbcbabcad	FALSE
bddbcaaaacaccddac	FALSE
bddbcaaacbbbcdaaa	FALSE
cabdcbacacaacbada	FALSE
cabdcbbbbacaadbdb	FALSE
cbaadddccdaddcaba	FALSE
cbabaaccdadbdabcc	FALSE
cbcdddbdddabadcad	FALSE
cbcddddcadadaddbc	FALSE
ccbcbabdbaddabaaa	FALSE
ccbcbadacdaabdadb	FALSE
cdaacdcdcaadabadc	FALSE
cdaadbaabcdadcaba	FALSE
cdcbdaddcbcabadda	FALSE
cdcbdcdccacccdbac	FALSE
daaddddcddbcdaddc	FALSE
dabaabbaadbbbabab	FALSE
dadcbbddcadadadba	FALSE
dadccacccdacdcabd	FALSE
dbcacbabdcabaaaac	FALSE
dbcacbbdccdadacdb	FALSE
dcacaddcaaaaadcbd	FALSE
dcacbabcdabcbdabb	FALSE
dcdbaaadddaddcdbb	FALSE
dcdbaacaddaddabdc	FALSE
ddbbdcacaadbbccac	FALSE
ddbbdcbbacdcbbcdb	FALSE
aaaaaacccadaaaddca	TRUE
aaaaaacdaddddcadad	TRUE
aaccaaaccaadadaccc	TRUE
aaccaadddaacadadad	TRUE
aadcddddccddaaacda	TRUE
aaddaaacadddadcdcb	TRUE
abcaacdadcaadcaaca	TRUE
abcaacddaaacaacaad	TRUE
abdadddacaddcaddad	TRUE
abdadddacccaddadcc	TRUE
acadacccacdacaaddb	TRUE
acadaccccaadcdaaab	TRUE
acdacccacaaddadadd	TRUE
acdacccacacacddccc	TRUE
adadcacacacdddacca	TRUE
adadcaccaccaccdada	TRUE
addcaaaaddccdaaaab	TRUE
addcaaacaacaacddcc	TRUE
caacdaccdcddcdddaa	TRUE
caacdacddaadadadcc	TRUE
cacdadcdccdcdacadc	TRUE
cacdadcddacccaacdc	TRUE
caddcddcddddaadddd	TRUE
caddcdddaacdcaccca	TRUE
cccaaccdcddcaadcad	TRUE
cccaacdacacdaadadd	TRUE
ccdacadcaccdcaadac	TRUE
ccdacaddcdcdadcdcd	TRUE
cdaacdccccddaaaddb	TRUE
cdaacddaaacaccdadb	TRUE
cdcadacdaccccaccca	TRUE
cdcadacddcdadddcaa	TRUE
cddacdddadcadaaddc	TRUE
cddacddddcccdaaccc	TRUE
daaadddcccdaccddcd	TRUE
daacaaaccdcacaaddb	TRUE
daccacdddaaccadacd	TRUE
daccacdddacdcdddaa	TRUE
dadcccaadcadcadacb	TRUE
dadcccaaddcdcddaca	TRUE
dcaccaddaaccddacdb	TRUE
dcaccadddaccaddccb	TRUE
dcccccadcacacaaaca	TRUE
dccccccaacaaccccac	TRUE
dcdccdcdacaccdacdd	TRUE
dcdccddcdcacaacacb	TRUE
ddacddddccadcaacaa	TRUE
ddacddddddaaaddaaa	TRUE
ddcdcdacccdddccdcd	TRUE
ddcdcdaccdacaaccab	TRUE
aaaaabadccbccddaab	FALSE
aaaaabcdaaaabbdcca	FALSE
aaccddacacadadddbb	FALSE
aaccddbabaadcbbcdb	FALSE
abbbdbddcaccdbbcbb	FALSE
abbbddaadadccaaabb	FALSE
acaaaadbdadcdacccd	FALSE
acaaababcbdaabcccb	FALSE
acccadddacdaccccbd	FALSE
acccbababbadabdbdc	FALSE
adbadadccaaacdbada	FALSE
adbadbcdbcdbccaabd	FALSE
adddbaadabaddabcaa	FALSE
adddbabcacbbbbbcad	FALSE
bacbddcadabacdccbb	FALSE
baccaadadabddcacba	FALSE
bbbacdccbdabbadbbd	FALSE
bbbacddcdacabbabbc	FALSE
bbddbccbcbbacdbddc	FALSE
bbddbdcabacdaddbcd	FALSE
bccadaacaaaccbddba	FALSE
bccadacaabbcaacdcc	FALSE
bdabbdcacaddaabccd	FALSE
bdabbdcacbabddccdd	FALSE
bdcccddcabadaabbbb	FALSE
bdccdaabaabbdcddbd	FALSE
cabcacbddbbbdcbccd	FALSE
cabcadbcadcccbdccb	FALSE
cbaaabddcbaddaccbc	FALSE
cbaaacacdcdbdcacab	FALSE
cbcbabdcddaddbadcb	FALSE
cbcbacacccbacaccca	FALSE
ccadbdddaccdddbbdc	FALSE
ccadcbbaaabccbdbcc	FALSE
ccdbaccaacbddadaab	FALSE
ccdbadaadadddadbdc	FALSE
cdcabccaabbcaadaaa	FALSE
cdcabdbccdaaabbbcb	FALSE
daaccbcacadcddbaaa	FALSE
daacccabacddbbacaa	FALSE
dadacdcbdcabbadbcb	FALSE
dadadbbaccbbacdbac	FALSE
dbbcadabaacbbbaccb	FALSE
dbbcadccbacaddbadd	FALSE
dcaabaccbbacdabddb	FALSE
dcaabbcdccdacabcaa	FALSE
dccbcdbccdcdbcbadb	FALSE
dccbcdbcdbbaaadadb	FALSE
ddbadcdacdbabacabd	FALSE
ddbaddaacbbaabacbb	FALSE
aaaaaaaccccddaaadaa	TRUE
aaaaaaadcadcaaddcac	TRUE
aaccccaaadccdccaacb	TRUE
aaccccacdacdaadddcb	TRUE
abaacaacdcccaaddcad	TRUE
abaacacdddcacddadcd	TRUE
abcdaacaaccccaaaddd	TRUE
abcdaacccadccdddccd	TRUE
acaaadcacaadaddaada	TRUE
acaaadddcdccdddaadc	TRUE
acccdacdccdddaccddb	TRUE
acccdacddaaacaaadab	TRUE
acddddcadaaddccdacc	TRUE
acddddccdadaadaaccc	TRUE
adccaacadccccdddacb	TRUE
adccaaccaccdcdacccc	TRUE
adddcdcacadcadcaadc	TRUE
adddcdcadaaacdccdcd	TRUE
cacaaccaaccdddcaccd	TRUE
cacaacccdcddcddadcc	TRUE
cadaaaaaddcccddddda	TRUE
cadaaaadaccadadccaa	TRUE
ccaaccaaccaacaacaaa	TRUE
ccaaccaacdaccccdcdb	TRUE
cccacaadadcddcdadca	TRUE
cccacaadcadcdcadacd	TRUE
ccdadcacacddaaddcab	TRUE
ccdadcadddcadaaaaab	TRUE
cdacacdcccdcdaddadb	TRUE
cdacadaaaadcdacdccd	TRUE
cdccadcdddddadaccad	TRUE
cdccaddacaccaccdcca	TRUE
cddcacdaccaacccccdd	TRUE
cddcacdaddcccddddca	TRUE
daacccacaddaacaaaaa	TRUE
daacccadcaddcadaada	TRUE
dacccdddacdddddaddd	TRUE
dacccdddcaaddcdaaab	TRUE
dadcddadcacccdcccca	TRUE
dadcddadddccadaacdc	TRUE
dcadaaccdcaddadacac	TRUE
dcadaacdcadacddaaad	TRUE
dccdccadccaccdaaacc	TRUE
dccdccaddaaaacdcddd	TRUE
dcddcdddacccaadccda	TRUE
dcddcdddadccddddacc	TRUE
ddaddadccdcdaddaddc	TRUE
ddaddadcdcadadacaab	TRUE
ddcdddddacdacccdccb	TRUE
ddcdddddcacaccdadca	TRUE
aaaaadbabbdbaaaadaa	FALSE
aaaaadcccaddbacaaad	FALSE
aacbdabbccabdbddada	FALSE
aacbdbcaadaaccdcdbc	FALSE
abbaabccccaadaababd	FALSE
abbaabdcbabaabdddad	FALSE
abddbcccadcbbbdadbd	FALSE
abddbcdadaabbdcbabb	FALSE
accbdbcccacdcbabcac	FALSE
accbdcadccddcbadacb	FALSE
adbabbcaddcbcacdcac	FALSE
adbabbdccaadaaadbbd	FALSE
addcddcdcbccacbbbcd	FALSE
addcdddadbdddacacdd	FALSE
bacbbddabdaaaddaaba	FALSE
bacbcbbcddacaacaddc	FALSE
bbadabdcaaddacdbbdb	FALSE
bbadbccabbdbaccddcd	FALSE
bbdadccacdaaacccbda	FALSE
bbdadcdaaacddbdcada	FALSE
bccaaccadbcddabdcaa	FALSE
bccaacdbacccbaccbaa	FALSE
bdabcdacdadcacddbcd	FALSE
bdabdbcbbbadcdcccca	FALSE
bddbabaddaddbbcdabb	FALSE
bddbadaccddbbcaabbc	FALSE
cabdbabcabbccbaadda	FALSE
cabdbcbcdbcabcbbbbb	FALSE
cbabdcabccbbacbcaba	FALSE
cbabdddcdacabddadad	FALSE
cbdadbcddddbbccaaac	FALSE
cbdadcdaccdbdbbabdd	FALSE
ccbddabadbbcdcddbdc	FALSE
ccbddbbbdccbccadcca	FALSE
cdabcaadbddcabcdaab	FALSE
cdabcadadcbccdccbdd	FALSE
cdcddcccaccbcabcdbb	FALSE
cddaacbcdddddcdcbca	FALSE
dabcabcbabdbbddbbab	FALSE
dabcacbabacbabbdcbd	FALSE
daddccbababbccbdcab	FALSE
daddccbcbddcabadbbc	FALSE
dbcabdcdddbdcaccdcb	FALSE
dbcacaacacbacdbdcab	FALSE
dcadadacddabddacbcc	FALSE
dcadbaccaccadcaccdd	FALSE
dcdabbcddcbccaddccd	FALSE
dcdacacbabdcacdcacb	FALSE
ddbbccdcabbdcbcabac	FALSE
ddbbcdacdadaadacdbd	FALSE
