aaaaabccdd	TRUE
aaaaaddacc	TRUE
aacbacabcd	TRUE
aacbaccbdc	TRUE
abadcaaaca	TRUE
abadcaabbd	TRUE
abdcbdbbab	TRUE
abdcbdddbc	TRUE
acbdacddcb	TRUE
acbdadacbc	TRUE
adaacbccbb	TRUE
adaacbdaac	TRUE
adcbdccdac	TRUE
adcbddcbdd	TRUE
baacdbabcd	TRUE
baacdbcacc	TRUE
badacddcca	TRUE
badadaacbb	TRUE
bcbacabdbc	TRUE
bcbacabdbc	TRUE
bcdaccacda	TRUE
bcdaccbbac	TRUE
bdaddacccb	TRUE
bdaddadddc	TRUE
bddadacaad	TRUE
bddadaddcd	TRUE
cabacabcdc	TRUE
cabacbaddc	TRUE
cadcdddcad	TRUE
caddacbcac	TRUE
cbcbdcbbab	TRUE
cbcbdcbcca	TRUE
ccacdbacbd	TRUE
ccacdbdcbc	TRUE
ccdbdcccdd	TRUE
ccdbdcdaab	TRUE
cdcbacddcb	TRUE
cdcbaddcdb	TRUE
daaddacbda	TRUE
daaddbaccd	TRUE
dadbaacbbd	TRUE
dadbaadaaa	TRUE
dbcccbdbbc	TRUE
dbcccbdccc	TRUE
dcacbacdac	TRUE
dcacbadada	TRUE
dcdaaabacd	TRUE
dcdaacbcba	TRUE
ddbcdadbba	TRUE
ddbcdaddaa	TRUE
aaaaabbcdd	FALSE
aaaaaddabb	FALSE
aacbababcd	FALSE
aacbabcbdc	FALSE
abadbaaaca	FALSE
abadbaabbd	FALSE
abdbbdbbab	FALSE
abdbbdddbc	FALSE
acbdabddcb	FALSE
acbdadabbc	FALSE
adaacbbcbb	FALSE
adaacbdaab	FALSE
adcbdbcdac	FALSE
adcbddbbdd	FALSE
baabdbabcd	FALSE
baabdbcacc	FALSE
badabddcca	FALSE
badadaabbb	FALSE
bbbacabdbc	FALSE
bbbacabdbc	FALSE
bbdaccacda	FALSE
bbdaccbbac	FALSE
bdaddabccb	FALSE
bdaddadddb	FALSE
bddadabaad	FALSE
bddadaddbd	FALSE
cabababcdc	FALSE
cababbaddc	FALSE
cadcdddcbb	FALSE
caddacbbac	FALSE
cbbbdcbbab	FALSE
cbbbdcbcca	FALSE
ccacdbabbd	FALSE
ccacdbdbbc	FALSE
ccdbdbccdd	FALSE
ccdbdbdaab	FALSE
cdcbabddcb	FALSE
cdcbaddbdb	FALSE
daaddacbdb	FALSE
daaddbabcd	FALSE
dadbaabbbd	FALSE
dadbaadaab	FALSE
dbbccbdbbc	FALSE
dbbccbdccc	FALSE
dcacbabdac	FALSE
dcacbadadb	FALSE
dcdaaababd	FALSE
dcdaacbbba	FALSE
ddbbdadbba	FALSE
ddbbdaddaa	FALSE
aaaaabccddc	TRUE
aaaaadaccca	TRUE
aacbcbcaada	TRUE
aacbccdccaa	TRUE
abadaacccda	TRUE
abadaaccdcd	TRUE
abdcdabdcdb	TRUE
abdcdacbaba	TRUE
acbdadaaada	TRUE
acbdadacacb	TRUE
adabaaaaadd	TRUE
adabaaaddaa	TRUE
adccadbccad	TRUE
adccadbdcac	TRUE
baaccddabbd	TRUE
baacdacacba	TRUE
badadaacbcd	TRUE
badadaadaca	TRUE
bcaddcdaabc	TRUE
bcaddcdccab	TRUE
bccdcabbbda	TRUE
bccdccadcda	TRUE
bdadaccdadb	TRUE
bdadacddacb	TRUE
bddcaaadadc	TRUE
bddcaabbabb	TRUE
cabccaacccb	TRUE
cabccadacbd	TRUE
cbaaadcccca	TRUE
cbaaaddcadd	TRUE
cbcddccbdca	TRUE
cbdaaaadcba	TRUE
ccbcabaacca	TRUE
ccbcabbcaba	TRUE
ccddbcbcdda	TRUE
ccddbccacaa	TRUE
cdcbaccacab	TRUE
cdcbacdbdba	TRUE
daadccbdccd	TRUE
daadcccbdca	TRUE
dadbcbbacab	TRUE
dadbcbdbabc	TRUE
dbccbccbcda	TRUE
dbccbdbcadd	TRUE
dcabddadaaa	TRUE
dcabddcbddc	TRUE
dccdbacbdbb	TRUE
dccdbaccdcc	TRUE
ddbaddcdabd	TRUE
ddbaddddcbc	TRUE
aaaaabbcddc	FALSE
aaaaadaccbb	FALSE
aacbbbcaada	FALSE
aacbbcdccaa	FALSE
abadaabccda	FALSE
abadaabcdcd	FALSE
abdbdabdcdb	FALSE
abdbdacbaba	FALSE
acbdadaaadb	FALSE
acbdadabacb	FALSE
adabaaaaadb	FALSE
adabaaaddab	FALSE
adccadbbcad	FALSE
adccadbdbac	FALSE
baabcddabbd	FALSE
baabdacacba	FALSE
badadaabbcd	FALSE
badadaadaba	FALSE
bbaddcdaabc	FALSE
bbaddcdccab	FALSE
bbcdcabbbda	FALSE
bbcdccadcda	FALSE
bdadabcdadb	FALSE
bdadabddacb	FALSE
bddbaaadadc	FALSE
bddbaabbabb	FALSE
cabbcaacccb	FALSE
cabbcadacbd	FALSE
cbaaadbccca	FALSE
cbaaaddbadd	FALSE
cbbddccbdca	FALSE
cbdaaaadbba	FALSE
ccbbabaacca	FALSE
ccbbabbcaba	FALSE
ccddbbbcdda	FALSE
ccddbbcacaa	FALSE
cdcbabcacab	FALSE
cdcbabdbdba	FALSE
daadccbdbcd	FALSE
daadcccbdba	FALSE
dadbbbbacab	FALSE
dadbbbdbabc	FALSE
dbbcbccbcda	FALSE
dbbcbdbcadd	FALSE
dcabddadaab	FALSE
dcabddbbddc	FALSE
dccdbabbdbb	FALSE
dccdbabcdcc	FALSE
ddbaddbdabd	FALSE
ddbaddddbbc	FALSE
aaaaacabadda	TRUE
aaaaacbadcca	TRUE
aaccacdaabca	TRUE
aaccadadadbd	TRUE
abadcacdcaab	TRUE
abadcadcbbbb	TRUE
abdccdcdbbcc	TRUE
abdcdbaddbab	TRUE
accabadaaacc	TRUE
accabadcbcdb	TRUE
adadcbcdadbb	TRUE
adadcbcdbddb	TRUE
addbacdcbbbd	TRUE
addbadacabbd	TRUE
bacabcaaccac	TRUE
bacabcacbcab	TRUE
badcbbacdcaa	TRUE
badcbbcadcbb	TRUE
bcbbbcbacccc	TRUE
bcbbbccacddc	TRUE
bcdadaccccdd	TRUE
bcdadadcbcdb	TRUE
bdadcbdbbcdb	TRUE
bdadcccadadb	TRUE
bddcaacaaadc	TRUE
bddcaadcaccc	TRUE
cabaddcadcbb	TRUE
cabcabbdccbb	TRUE
cadddbdddcab	TRUE
cadddccadbdd	TRUE
cbdaacdbabaa	TRUE
cbdaadcbadad	TRUE
ccbcbdadcdad	TRUE
ccbcbdbaccca	TRUE
ccdcdabddcba	TRUE
ccdcdbcbbaaa	TRUE
cdcbcbbdcbaa	TRUE
cdcbcccbbbcc	TRUE
daadbcdbadcd	TRUE
daadcbdadada	TRUE
dadbadddacbc	TRUE
dadbcabcaddb	TRUE
dbcbdbdbbdda	TRUE
dbcbdcabcdca	TRUE
dcabdacabddd	TRUE
dcabdaccdbac	TRUE
dccdbdcdadac	TRUE
dccdcaccacbc	TRUE
ddbcabbcaacc	TRUE
ddbcabbcddbb	TRUE
aaaaacabaddb	FALSE
aaaaacbadbca	FALSE
aaccacdaabba	FALSE
aaccadadadbb	FALSE
abadbacdcaab	FALSE
abadbadcbbbb	FALSE
abdbcdcdbbcc	FALSE
abdbdbaddbab	FALSE
accabadaaabc	FALSE
accabadbbcdb	FALSE
adadcbbdadbb	FALSE
adadcbbdbddb	FALSE
addbabdcbbbd	FALSE
addbadababbd	FALSE
bababcaaccac	FALSE
bababcacbcab	FALSE
badbbbacdcaa	FALSE
badbbbcadcbb	FALSE
bbbbbcbacccc	FALSE
bbbbbccacddc	FALSE
bbdadaccccdd	FALSE
bbdadadcbcdb	FALSE
bdadbbdbbcdb	FALSE
bdadbccadadb	FALSE
bddbaacaaadc	FALSE
bddbaadcaccc	FALSE
cabaddbadcbb	FALSE
cabbabbdccbb	FALSE
cadddbdddbab	FALSE
cadddccadbdb	FALSE
cbdaabdbabaa	FALSE
cbdaadbbadad	FALSE
ccbbbdadcdad	FALSE
ccbbbdbaccca	FALSE
ccdcdabddbba	FALSE
ccdcdbbbbaaa	FALSE
cdcbbbbdcbaa	FALSE
cdcbbccbbbcc	FALSE
daadbbdbadcd	FALSE
daadcbdadadb	FALSE
dadbadddabbc	FALSE
dadbbabcaddb	FALSE
dbbbdbdbbdda	FALSE
dbbbdcabcdca	FALSE
dcabdababddd	FALSE
dcabdabcdbac	FALSE
dccdbdbdadac	FALSE
dccdcaccacbb	FALSE
ddbbabbcaacc	FALSE
ddbbabbcddbb	FALSE
aaaaacabaddad	TRUE
aaaaacbdccaab	TRUE
aaccbcacbddca	TRUE
aaccbdadddcdc	TRUE
abadaaddcdcab	TRUE
abadacbbccbbd	TRUE
abdccbdbabcbc	TRUE
abdcccadacadd	TRUE
accacbcbcbbaa	TRUE
accacbccdcada	TRUE
adadbaaacaaac	TRUE
adadbaacabcad	TRUE
addbadcdbdabb	TRUE
addbcadbcbcca	TRUE
bacabbdbddcca	TRUE
bacabcdadcaaa	TRUE
badccbbadbcaa	TRUE
badccbbbcdaac	TRUE
bcbbddccabdcb	TRUE
bcbcaabcdccca	TRUE
bcdbcbcbddbbb	TRUE
bcdbcbdacdbbb	TRUE
bdadccccdadca	TRUE
bdadccdaacbac	TRUE
bddcaaadaacad	TRUE
bddcabaaabcbd	TRUE
cabcbbbbcdcda	TRUE
cabcbcacbcbcd	TRUE
cbaaaacaaadbb	TRUE
cbaaaacbbadcb	TRUE
cbdadaccbcadd	TRUE
cbdadaccbdaad	TRUE
ccbcaadddcbac	TRUE
ccbcabaaddaaa	TRUE
ccddbddacdcaa	TRUE
ccddbdddcacda	TRUE
cdcbacadbbcca	TRUE
cdcbaccdbdacd	TRUE
dabacbbbbabca	TRUE
dabacbddddbbd	TRUE
dadcaadbcdcdc	TRUE
dadcabaaaacbd	TRUE
dbcbdaaaccadd	TRUE
dbcbdabbadbcd	TRUE
dcabcdbacdcbc	TRUE
dcabddacabcbd	TRUE
dccddddabcdbd	TRUE
dcdaaaadddcbd	TRUE
ddbdaaacbabcc	TRUE
ddbdaaccddcca	TRUE
aaaaaacabbdbd	FALSE
aaaaababaabac	FALSE
aacbbdcdddbdb	FALSE
aacbdaddaaaab	FALSE
ababddbdddacd	FALSE
ababddcbacbbc	FALSE
abdbdabcccabd	FALSE
abdbdbbacdabb	FALSE
acbdddbbbdcba	FALSE
accaabbdcbcba	FALSE
adacaadcaabdb	FALSE
adacabbcbbdda	FALSE
addaabbaababd	FALSE
addaabbacdbcb	FALSE
baaddbacbbbca	FALSE
baaddbcabaccd	FALSE
badaddddbcbcc	FALSE
badbaacddacaa	FALSE
bbbabbcbbbabc	FALSE
bbbabbccdacbc	FALSE
bbcdbccccaddb	FALSE
bbcdbddbbdccc	FALSE
bdadaabbadaca	FALSE
bdadaabcbccca	FALSE
bddabcdcbdaaa	FALSE
bddabcddcbddd	FALSE
cabaaaadaaabd	FALSE
cabaaabaccdda	FALSE
cadcbaabdddcd	FALSE
cadcbaaddbabb	FALSE
cbbdaabbbbada	FALSE
cbbdaabdbaacc	FALSE
ccbadbacaddcc	FALSE
ccbadbaddcaac	FALSE
ccdcbaadabbaa	FALSE
ccdcbadbcbcbc	FALSE
cdcaddddbbdba	FALSE
cdcbaaaaadabd	FALSE
daadbbbabbabc	FALSE
daadbdbbddcdb	FALSE
dadcbbaadddbb	FALSE
dadcbbababdcd	FALSE
dbbcbabbcbacb	FALSE
dbbcbadbcacbb	FALSE
dcaccbbdacccb	FALSE
dcacccaadacbb	FALSE
dcdadadcdacbb	FALSE
dcdadcbdadaab	FALSE
ddbdadbaadbdd	FALSE
ddbdbaaaabcdd	FALSE
aaaaaacabcdbdb	TRUE
aaaaabcaacacac	TRUE
aacbdcadcaaaac	TRUE
aacbdcccdcddac	TRUE
abacdddbdbdabd	TRUE
abadaacccdbbcb	TRUE
abdcdbcdbcbadd	TRUE
abdcdccbcacabc	TRUE
accaadadadbacb	TRUE
accaadbacddbbc	TRUE
adabcccabadcbc	TRUE
adabcdbaadbddb	TRUE
adcdccccbaaadc	TRUE
adcddaddccdabc	TRUE
baadcbdcabcdac	TRUE
baadcbdcacadbb	TRUE
badadadacacdab	TRUE
badadadcbdcddc	TRUE
bcaddcbddacaba	TRUE
bcadddacaaabab	TRUE
bccdcabbccabbb	TRUE
bccdcadcbdbbba	TRUE
bdadaacbcccacd	TRUE
bdadaacddadbbb	TRUE
bddacadcadabcd	TRUE
bddacadddadddc	TRUE
cabaadadaddacc	TRUE
cabaadcacbbacb	TRUE
caddbcacdcabac	TRUE
caddbcdaaddacc	TRUE
cbcdbbbcdabbbb	TRUE
cbcdbdcdaccddb	TRUE
ccaddccdcddcab	TRUE
ccadddbcadbaad	TRUE
ccdbcacddcdbcc	TRUE
ccdbcdddbbdbcc	TRUE
cdcaccdbadcabb	TRUE
cdcacdbddaddda	TRUE
daadbdcccdaadb	TRUE
daadcadcbadcaa	TRUE
dadbdadcbadbab	TRUE
dadbdadccbbccb	TRUE
dbcccbabdcdcab	TRUE
dbcccbcdaacbcc	TRUE
dcaccbaacadbaa	TRUE
dcaccbaaddcbba	TRUE
dcdbcaabcaadda	TRUE
dcdbcadacacadb	TRUE
ddbcbadbbbabad	TRUE
ddbcbbaaaaabac	TRUE
aaaaaaacbdbcba	FALSE
aaaaacaccbaddb	FALSE
aaccbaaddbabcc	FALSE
aaccbabcdabcab	FALSE
abadbbcaccdbaa	FALSE
abadbbcbacbacb	FALSE
abddbbddddacca	FALSE
abddbcadaacbcb	FALSE
accbbdacbdcdad	FALSE
accbbdadabdbdc	FALSE
adbaaadabaadbb	FALSE
adbaaadaddaaab	FALSE
addcdabbdacdac	FALSE
addcdabdaddaba	FALSE
babbabbbcdcbda	FALSE
babbabcadcdaac	FALSE
badbcccaaacdbd	FALSE
badbcccbdcabca	FALSE
bbbbbacdccdbda	FALSE
bbbbbbbcbddcad	FALSE
bbdadbbbcdbaad	FALSE
bbdadbbdcaccdc	FALSE
bdadbcabaddcdb	FALSE
bdadbccdacaaad	FALSE
bddadabdadbbcc	FALSE
bddadadaabdddc	FALSE
caaddbdddbacba	FALSE
caaddcabadbdad	FALSE
caddaaabddabbc	FALSE
caddaccdcbdbba	FALSE
cbbcbcbcdbcdbd	FALSE
cbbcbdccdacadc	FALSE
ccadccacdadabb	FALSE
ccadcdacdccabb	FALSE
ccdbbbadbcbbbc	FALSE
ccdbbbccdabbda	FALSE
cdbdaddbaacaab	FALSE
cdbdadddbbaada	FALSE
daaccadddccbbd	FALSE
daaccbabdcdccc	FALSE
dadadcdcababca	FALSE
dadbaaaaaaadab	FALSE
dbbbacaabadadb	FALSE
dbbbacbaccaadd	FALSE
dcabadabddaaaa	FALSE
dcabbcbbcdaccb	FALSE
dccdaddcbdbaac	FALSE
dccdbadaadaaab	FALSE
ddbbabdbcacadc	FALSE
ddbbacabcadcbd	FALSE
aaaaaaacbdccbad	TRUE
aaaaacccbaddddd	TRUE
aaccbadcbacbcdb	TRUE
aaccbadcbbbdadd	TRUE
abaddcbbdcdabdd	TRUE
abaddccbddaaddc	TRUE
abddcbbbcdacdac	TRUE
abddcbcbddddbbc	TRUE
accbdaccbbbabab	TRUE
accbdcaabccaacc	TRUE
adbaddacdadadcd	TRUE
adbcaabcdbdbcad	TRUE
addcdadcabadcac	TRUE
addcdbacaadacad	TRUE
bacbbcbccbddaad	TRUE
bacbbccabcadbdd	TRUE
baddccaddccaddb	TRUE
baddccbdaaadada	TRUE
bcbdaabccdaabbc	TRUE
bcbdaabdccaacad	TRUE
bcdcaddcbdcccdd	TRUE
bcdcbabcbcbcacd	TRUE
bdadcadbdddaadd	TRUE
bdadcbccbdddbda	TRUE
bddadcabbcbaacb	TRUE
bddadcabccbdbab	TRUE
cabaaddcbddcabb	TRUE
cabacacdaacbadb	TRUE
caddbacccabddda	TRUE
caddbaccdbdbadb	TRUE
cbcbdbdadaacddb	TRUE
cbcbdcabbbdcdcb	TRUE
ccadacadaabdccb	TRUE
ccadacccddcadaa	TRUE
ccdaccbaacaccab	TRUE
ccdaccdbcddbbbc	TRUE
cdcabacdcdaabba	TRUE
cdcabccbbddcdac	TRUE
daacacaddacacca	TRUE
daacacdcbdcbaab	TRUE
dadabdaddcddbbc	TRUE
dadabdcbbcdaccd	TRUE
dbadddcdaabdbaa	TRUE
dbaddddaccccadc	TRUE
dcaaaadcbcbaddc	TRUE
dcaaabcbabcddca	TRUE
dccbdcaaadcadcb	TRUE
dccbdcaadbabcbd	TRUE
ddbacabcbaacdbb	TRUE
ddbacaddbbcbadb	TRUE
aaaaaababbddaca	FALSE
aaaaaabddddabad	FALSE
aaccacdbbadccdd	FALSE
aaccbadbcacbcab	FALSE
abaddbccdbbacdd	FALSE
abaddbcddbdabda	FALSE
abddaabcdaadcab	FALSE
abddaabdbadbdaa	FALSE
accbabaccbcacac	FALSE
accbabaddbddcda	FALSE
adacbaddddabddd	FALSE
adacbdadbbdcaaa	FALSE
adcdcacbdaaaadb	FALSE
adcdcbbbbbdcdaa	FALSE
baadbbbabbcbcac	FALSE
baadbbcddbcacdc	FALSE
badaddbcdddcbad	FALSE
badbaabdbaccdda	FALSE
bbbacadcbbabdcb	FALSE
bbbacbbbbdbbbcb	FALSE
bbdaaabaadbabcc	FALSE
bbdaaacbdcdddda	FALSE
bdadadbcaacaccd	FALSE
bdadadbddaabbcc	FALSE
bddadbdabcaabdd	FALSE
bddadbdaccacabd	FALSE
cabbabcbbbbbdcb	FALSE
cabbabdbcbcdbbd	FALSE
caddbabadcbbdac	FALSE
caddbbdabccdbda	FALSE
cbbdbdcbaacbbab	FALSE
cbbdcbdadcbdccb	FALSE
ccbaaaabdccbddb	FALSE
ccbaabcbcccbcac	FALSE
ccdcbadddbbaabd	FALSE
ccdcbbbbbcdacbd	FALSE
cdbdddaadbbdbdd	FALSE
cdbdddababbabac	FALSE
daacdbdaadaddbb	FALSE
daacdcbddabaacb	FALSE
dadbbcdccdabddc	FALSE
dadbdabbdabcdbb	FALSE
dbbbbbbccabdddc	FALSE
dbbbbbcbbdcadac	FALSE
dcabbddbdcacbaa	FALSE
dcabbddcdcccadb	FALSE
dcdaabddddddbca	FALSE
dcdaacccabddbdc	FALSE
ddbbbddcbbdcdda	FALSE
ddbbcaabbcbbcdc	FALSE
aaaaaabacbddacad	TRUE
aaaaaabdddacadcc	TRUE
aaccbcdacdacbdcd	TRUE
aacccabccaabbbda	TRUE
abaddaacdcbacdcc	TRUE
abaddaadaaadaadc	TRUE
abddacaacdbbdddd	TRUE
abddacbbadacaabc	TRUE
accaaddaacdcabdd	TRUE
accabacbaacdcaad	TRUE
adacadbacabccbcc	TRUE
adacbcadcbdabbdc	TRUE
adcdcddcddcacbca	TRUE
adcddaabcaaabaaa	TRUE
baaddcaddbdabadb	TRUE
baaddcbbdabdbaab	TRUE
badcaccdaaadddab	TRUE
badcacdaddaabadc	TRUE
bcbabccdcbcabdcb	TRUE
bcbabdcadacdadcd	TRUE
bcdadccbabadcbba	TRUE
bcdadcdabdcabacc	TRUE
bdadcacccadbaccd	TRUE
bdadcadaaacadcbb	TRUE
bddacdaabadcccad	TRUE
bddacdaabcdaacdc	TRUE
cabacacaadbbdbdb	TRUE
cabacacbbaabcbca	TRUE
cadcbaaccdbbcbab	TRUE
cadcbacbcbacbcaa	TRUE
cbccadccdbbadaca	TRUE
cbccaddcdbaaaabd	TRUE
ccabacbdddcddadc	TRUE
ccabadcaddcddddb	TRUE
ccdbaddaadaaccbd	TRUE
ccdbaddaadaaddcc	TRUE
cdcabdcbdaabacca	TRUE
cdcabddaacddacba	TRUE
daadcdddacaabacb	TRUE
daaddaadbddaaacd	TRUE
daddbdcccacabdba	TRUE
daddbddcbdbdabdb	TRUE
dbcdcadaadbcaccd	TRUE
dbcdcdaddacacdac	TRUE
dcadddbdaaacdaca	TRUE
dcaddddbcaabbdcc	TRUE
dcdbdcbabbbdcadc	TRUE
dcdbdcbabcacbdbd	TRUE
ddbdadcdddcbcccc	TRUE
ddbdaddcbaadcdba	TRUE
aaaaaaccdbdbaacc	FALSE
aaaaabddabcdacac	FALSE
aaccdbbbdcabbcca	FALSE
aaccdbdddbbdabbb	FALSE
abaddbaabaccbdad	FALSE
abaddbaabccdbdcb	FALSE
abdbddbdcbbbbdac	FALSE
abdbddcbbcccacba	FALSE
accabdadddadbbbd	FALSE
accabddaaaaadbab	FALSE
adaddaccccbdbdad	FALSE
adaddbaaaddbbaad	FALSE
addcbaadbdcdabcc	FALSE
addcbdaaaabcbada	FALSE
babbabbaacccdadb	FALSE
babbabddacaccaba	FALSE
badbddcbdbcdbdbd	FALSE
baddaaaadbcacadc	FALSE
bbbbadaddbacdbab	FALSE
bbbbaddcadcdacbc	FALSE
bbdbbbbdbbbcabcc	FALSE
bbdbbbbdbcddbcca	FALSE
bdaddbccbabcbbcd	FALSE
bdadddabcacaacbc	FALSE
bddaddbaccccadba	FALSE
bddaddbbabcccbbd	FALSE
cabbabcaddbcdccd	FALSE
cabbacbabaccdacd	FALSE
cbaabadbcbbdabaa	FALSE
cbaabadddcbbaaba	FALSE
cbdabcdcbdcbcbba	FALSE
cbdabdadbcbbdaba	FALSE
ccbbadabaccbacca	FALSE
ccbbadadbbadadbd	FALSE
ccdcdcdaaabbbdbb	FALSE
ccdcdddadaadbaba	FALSE
cdcadacbbccccdba	FALSE
cdcadaddabbddacc	FALSE
daaccdbddddddbcb	FALSE
daaccdcacdadacbb	FALSE
dadbbcddacddddbd	FALSE
dadbbdadcdddacaa	FALSE
dbbbbdbcadabdabd	FALSE
dbbbbdbccccadaba	FALSE
dcabdaaddddadbbc	FALSE
dcabdabcaadbabca	FALSE
dccdacbdabbaccba	FALSE
dccdaccaaaabddba	FALSE
ddbbbadccccbbdcc	FALSE
ddbbbbdcbccbdaba	FALSE
aaaaaaacbccccabdb	TRUE
aaaaaabacabbdbddb	TRUE
aaccbdcbdaadadadd	TRUE
aacccacdaddcaabdd	TRUE
abadccaddbdbaddab	TRUE
abadccdbddcddbbcd	TRUE
acabacbbbabdccabd	TRUE
acabacccbadcbdadc	TRUE
acccbacccdaddacab	TRUE
acccbacddaaccccdc	TRUE
adbcabdadbdddbacb	TRUE
adbcabdbabbcaaadc	TRUE
baaaaaaddcbdccdba	TRUE
baaaaaccddaadbacd	TRUE
bacbaccbdcddcbaaa	TRUE
bacbadbbbdabcddac	TRUE
badcddbdcbcadbdbd	TRUE
badcddcbbaadbdbcd	TRUE
bcbbbdcabcdaacdcc	TRUE
bcbbbdcbabdbddbbc	TRUE
bcdbadaaddcabacaa	TRUE
bcdbadcccdadaddcd	TRUE
bdaddccddbdbbccdc	TRUE
bdaddcdaaabadbbda	TRUE
bddcacbcbbaaaacba	TRUE
bddcaccacbaaabcbb	TRUE
cabccdadbbacadccc	TRUE
cabccdadbbcbaabdb	TRUE
caddddbccbaacccba	TRUE
caddddbdcdaaabacd	TRUE
cbcdadabaccdabbcd	TRUE
cbcdadbdbcddacacb	TRUE
ccaddbdccaacdacda	TRUE
ccaddbdddcdbbacdb	TRUE
ccdbdcadcdcddbdcd	TRUE
ccdbdcbababaaacbc	TRUE
cdcacbdcdadcbcccb	TRUE
cdcacccabaacbabac	TRUE
daacdbcddcbdcbdcc	TRUE
daacdbcddcdbdacac	TRUE
dadcadbdaacccaacc	TRUE
dadcaddddcbdadcad	TRUE
dbcccadcadcbbdbba	TRUE
dbcccbccdbbdadacc	TRUE
dcacdbacccccadaca	TRUE
dcacdbacddaccbbdc	TRUE
dcdacbaaddcbdadca	TRUE
dcdaccaabdacaaadd	TRUE
ddbcccabacbddaddc	TRUE
ddbcccccaabadbdab	TRUE
aaaaaaacbbcccabdb	FALSE
aaaaaabababbdbddb	FALSE
aaccbdbbdaadadadd	FALSE
aacccacdaddcaabdb	FALSE
abadbcaddbdbaddab	FALSE
abadbcdbddcddbbcd	FALSE
acababbbbabdccabd	FALSE
acababccbadcbdadc	FALSE
acccbabccdaddacab	FALSE
acccbabddaaccccdc	FALSE
adbbabdadbdddbacb	FALSE
adbbabdbabbcaaadc	FALSE
baaaaaaddbbdccdba	FALSE
baaaaabcddaadbacd	FALSE
babbaccbdcddcbaaa	FALSE
babbadbbbdabcddac	FALSE
badbddbdcbcadbdbd	FALSE
badbddcbbaadbdbcd	FALSE
bbbbbdcabcdaacdcc	FALSE
bbbbbdcbabdbddbbc	FALSE
bbdbadaaddcabacaa	FALSE
bbdbadcccdadaddcd	FALSE
bdaddbcddbdbbccdc	FALSE
bdaddbdaaabadbbda	FALSE
bddbacbcbbaaaacba	FALSE
bddbaccacbaaabcbb	FALSE
cabbcdadbbacadccc	FALSE
cabbcdadbbcbaabdb	FALSE
caddddbbcbaacccba	FALSE
caddddbdbdaaabacd	FALSE
cbbdadabaccdabbcd	FALSE
cbbdadbdbcddacacb	FALSE
ccaddbdbcaacdacda	FALSE
ccaddbdddbdbbacdb	FALSE
ccdbdbadcdcddbdcd	FALSE
ccdbdbbababaaacbc	FALSE
cdcacbdbdadcbcccb	FALSE
cdcacccabaabbabac	FALSE
daacdbbddcbdcbdcc	FALSE
daacdbbddcdbdacac	FALSE
dadcadbdaabccaacc	FALSE
dadcaddddcbdadbad	FALSE
dbbccadcadcbbdbba	FALSE
dbbccbccdbbdadacc	FALSE
dcacdbabccccadaca	FALSE
dcacdbabddaccbbdc	FALSE
dcdacbaaddbbdadca	FALSE
dcdaccaabdabaaadd	FALSE
ddbbccabacbddaddc	FALSE
ddbbccccaabadbdab	FALSE
aaaaaabcaacadcdccd	TRUE
aaaaaadbcdaacadcdc	TRUE
aaccadabdddcbdbdda	TRUE
aaccbacabbcbcbdbcb	TRUE
abadaccbbcccabbdcb	TRUE
abadaccdbdbcdbccdd	TRUE
abdcddbcccdcdbbaac	TRUE
abdcddddbcaaaadddc	TRUE
accbcbdaaccacaabcc	TRUE
accbccbbcdadbddcdc	TRUE
adadbadacbccbacbcb	TRUE
adadbcacacbdddcdcd	TRUE
addbcdaaccacbcdcaa	TRUE
addbcdaddcaabbaccc	TRUE
bacaaadabaaaacaaac	TRUE
bacaaadbabacdacbcc	TRUE
badcdbdbdbbcbaddbb	TRUE
badcdbdcbbdddddbcd	TRUE
bcbadbbccaccbcbdda	TRUE
bcbadbdcaaacdbaacc	TRUE
bcdabddcbbaaabadba	TRUE
bcdacabdbddbccdaca	TRUE
bdadaddaadacdcbcad	TRUE
bdadaddacbbdabadcb	TRUE
bddaccddaaaabcdcbb	TRUE
bddacdcaacbcbdcddc	TRUE
cabaaccccbabbdbcab	TRUE
cabaaccdabaaadbaba	TRUE
caddabdaaccacbaccb	TRUE
caddabdcbcdadbdcda	TRUE
cbcdcaaabbcacacccc	TRUE
cbcdcaadcdaaabacad	TRUE
ccbadcacdabbadcdcb	TRUE
ccbadccbaababadccb	TRUE
ccddacdabdacaaabdb	TRUE
ccddadbadcadccccaa	TRUE
cdccabccccabcccacb	TRUE
cdccacbdddccacdabd	TRUE
dabacdaaddccddaabd	TRUE
dabacdddbbdbdbadbb	TRUE
dadccadbddaccdbadb	TRUE
dadccbcbbbbdddadaa	TRUE
dbccbddcbabcdabada	TRUE
dbcccaaabdaaaddbbc	TRUE
dcacdcccdbcdbaaccd	TRUE
dcacddabcaadabddaa	TRUE
dcdbaddadcdcadbadc	TRUE
dcdbcaabaadcdcadcd	TRUE
ddbcdadddabaadcbdd	TRUE
ddbcdbbccaacbadaca	TRUE
aaaaabdbccaabcdcdd	FALSE
aaaaacadabdbbabccc	FALSE
aacdbddbcaadcacccb	FALSE
aacdccbdabbcadcadd	FALSE
abadddbbdbaccdbccc	FALSE
abaddddabcbdbcbcac	FALSE
abdbcddcbdccaadbbb	FALSE
abdbcdddccdcbccdcb	FALSE
accaabdabbaadbdccd	FALSE
accaabdadaabaadddd	FALSE
adadadadaddacbddab	FALSE
adadadbdbbaacacacb	FALSE
addcabbcccbdbcbdbd	FALSE
addcabdbaabcbdcdcc	FALSE
bababdaaacdacccccc	FALSE
bababdcbaacbcaccac	FALSE
badbbccdbdababbada	FALSE
badbbdaddaaddadcad	FALSE
bbbadbadaadddbadda	FALSE
bbbadcabacbaabbcaa	FALSE
bbdaccadddadcaaaad	FALSE
bbdacdbbdddabdacba	FALSE
bdadaddaaabbbadbdb	FALSE
bdadaddbbaaababbbc	FALSE
bddabaadcadbccbdcb	FALSE
bddabbcacaabddabaa	FALSE
caaddcccacccdbdddb	FALSE
caadddaabaadddbcac	FALSE
cadbddabadcbabbbca	FALSE
cadcaadacabbadcadc	FALSE
cbbbcdbdbddbcbbadd	FALSE
cbbbcdcadcbddcbbca	FALSE
ccabbbcbbcbacdbdba	FALSE
ccabbbddaddbcadccb	FALSE
cccdcdcadcbbcbacab	FALSE
cccddbdaddaabcaaaa	FALSE
cdbdbdbacbaaabdbaa	FALSE
cdbdbdcabbdaaccdad	FALSE
daabdbabbbbdbddabb	FALSE
daabdddbbdcbdbcbad	FALSE
dadababadccbccaabd	FALSE
dadababcadabbdadca	FALSE
dbbadabbaadbcadbdd	FALSE
dbbadbbaccaddbcaac	FALSE
dcaadababacdcccbaa	FALSE
dcaadbbcdbaddabcad	FALSE
dcccdbdbbadcdadbba	FALSE
dcccdcabdaababdbab	FALSE
ddbadbdaabccbbcaad	FALSE
ddbadbdcdadadadadc	FALSE
aaaaabdcccaabcdcddb	TRUE
aaaaacdabdcbabccccd	TRUE
aacddbdacaaaddadaac	TRUE
aacddbdacaccdadbdba	TRUE
abadcddcbddabbaaaca	TRUE
abaddaacbccbbaadddc	TRUE
abdccdbdcaabdccacbc	TRUE
abdcdadaccdbddccadc	TRUE
accadcddadccabacadd	TRUE
accadcddbdaadddcbbc	TRUE
adadbdadaccacdcacac	TRUE
adadbdcadbcdbbdccdc	TRUE
addcaddabccabbbbddc	TRUE
addcbaaccddaabdbdac	TRUE
bacaacbbbadabcbcdaa	TRUE
bacaacdabccadddbcdd	TRUE
badcdadbccbcbbdcacd	TRUE
badcdbabccacccbbabc	TRUE
bcbbbdcadcabcbbcddb	TRUE
bcbbbddcdbbdabacccc	TRUE
bcdaccbacdcabcacdac	TRUE
bcdaccdbccdacacdcba	TRUE
bdadaaacbcccccbcaba	TRUE
bdadaacabacbdaacdba	TRUE
bddadcbdcaadaddcacd	TRUE
bddadccbddadcdbbaca	TRUE
cabaaacabcccccdaaac	TRUE
cabaaadacacdacaabdd	TRUE
cadcabdaadcabcadddc	TRUE
cadcabdaddadaddcdca	TRUE
cbccddcdcadcdbadabc	TRUE
cbccdddcdcaddcbdbca	TRUE
ccadccccbcbdbbcabaa	TRUE
ccaddaddcbcccccdaaa	TRUE
ccdbaddaddccdbacbaa	TRUE
ccdbcbcbdabbdaaccda	TRUE
cdbddadccbbbabbdabc	TRUE
cdbddcbcacdcdadacad	TRUE
daabdadccbbabacdbbd	TRUE
daabdcbaabdddabbacc	TRUE
dadaddaaacdbcccddcc	TRUE
dadbaacaabdcaabadbd	TRUE
dbcbbaccddcddaacdbc	TRUE
dbcbbbbbadcbcabbbab	TRUE
dcabcaadacaddcbaddb	TRUE
dcabcadbbabdbcdcbda	TRUE
dccdacddadcbadcaccc	TRUE
dccdbcccabcdcbcdbbc	TRUE
ddbcbcabaccaccbcbca	TRUE
ddbcbcacbabaccdabcd	TRUE
aaaaababdcbddaadbca	FALSE
aaaaadadbdbcdbbcbcc	FALSE
aacbbcbcaccabaababd	FALSE
aacbbcccbbdbbaccdbd	FALSE
abadbbdbcacdacdcbbc	FALSE
abadbbdbdcdcbdcbcca	FALSE
abddaddaaadbccabbda	FALSE
abddaddbbbdbbaddbaa	FALSE
accbbdbddcbcbabbcbc	FALSE
accbdaaadbbcddaabad	FALSE
adaddbbaabbcadaabca	FALSE
adaddccdaadadababcd	FALSE
addbdddabacdabcdbca	FALSE
addbddddadbbcddbbca	FALSE
babaaabcbdaadaadbad	FALSE
babaaacabacdbaaabdb	FALSE
badbccacaaaabdbdbdb	FALSE
badbccbbadbdacbaabb	FALSE
bbbbcaabacbacccccbb	FALSE
bbbbcabbadabbbdabac	FALSE
bbdbbcdaacaabcdacad	FALSE
bbdbcabacccbcbbcddc	FALSE
bdadbaabdacdaacbcac	FALSE
bdadbaacbbbdbcbdbda	FALSE
bddbacacbcdcbbdbaad	FALSE
bddbacdcdbcccddbddd	FALSE
cabbbdcdcbcdbbcabbb	FALSE
cabbcbadbdbcbbcacaa	FALSE
cbaaabccdbddabdccaa	FALSE
cbaaabdcbcdbdbbbdda	FALSE
cbbddddabdadcdabcad	FALSE
cbdaaaaaddbcaaabcaa	FALSE
ccbaaddddbcabbcdbda	FALSE
ccbaadddddbdacbaaca	FALSE
ccddccbbccdcacadabc	FALSE
ccdddbabbcabacccdac	FALSE
cdccbdabbbcaaaadaca	FALSE
cdccbdadaaddbabbbac	FALSE
dabaadbccbbdbdbcbbd	FALSE
dabaaddbabdcbccdabb	FALSE
dadcdbaddabccadbdaa	FALSE
dadcdbdbdbbadabbacb	FALSE
dbbcbbbccbacbadabca	FALSE
dbbcbbcccadcbabbcdd	FALSE
dcadabddbbacdbcddcd	FALSE
dcadaccaccabdbdbcbd	FALSE
dcdbaaadabbadaddada	FALSE
dcdbaadaabddcaaddca	FALSE
ddbbbbdcccbcbaddabc	FALSE
ddbbbcbaabaacddbdca	FALSE
