aaaaaaccab	TRUE
aaaaabcddb	TRUE
aacbccbbbb	TRUE
aacbcdaaab	TRUE
abbaabbaab	TRUE
abbaaccbbb	TRUE
abdbdbbabb	TRUE
abdbdbbddb	TRUE
accbcacdcb	TRUE
accbcbaddb	TRUE
adbaacbadb	TRUE
adbaacccab	TRUE
addccdbadb	TRUE
addccdddab	TRUE
baccdddbad	TRUE
bacdaabcad	TRUE
bbbbdabbdc	TRUE
bbbbdacbcc	TRUE
bbdccadadc	TRUE
bbdccbddbd	TRUE
bcbddbaddc	TRUE
bcbddbbbcd	TRUE
bdacbdacbc	TRUE
bdacbdbccd	TRUE
bdcdbdbdbd	TRUE
bdcdcaabca	TRUE
cabbcbadda	TRUE
cabbcbbdbd	TRUE
caddadbcac	TRUE
caddbbacba	TRUE
cbcacddbbd	TRUE
cbcadcbbbc	TRUE
ccadccadca	TRUE
ccadcccabc	TRUE
ccdbabdbac	TRUE
ccdbaccdaa	TRUE
cdbcccbdbc	TRUE
cdbcccdbba	TRUE
daaadbdccc	TRUE
daaaddbdda	TRUE
dacdbadada	TRUE
dacdbcbddd	TRUE
dbbcbbaaba	TRUE
dbbcbbcddc	TRUE
dcaacdabcc	TRUE
dcaacddacd	TRUE
dccdbacbda	TRUE
dccdbbaaaa	TRUE
ddbbadcaaa	TRUE
ddbbbbcbca	TRUE
aaaaaaccad	FALSE
aaaaabcdda	FALSE
aacbccbbba	FALSE
aacbcdaaac	FALSE
abbaabbaac	FALSE
abbaaccbbd	FALSE
abdbdbbabc	FALSE
abdbdbbddc	FALSE
accbcacdcc	FALSE
accbcbadda	FALSE
adbaacbadd	FALSE
adbaacccad	FALSE
addccdbadc	FALSE
addccdddad	FALSE
baccdddbab	FALSE
bacdaabcab	FALSE
bbbbdabbdb	FALSE
bbbbdacbcb	FALSE
bbdccadadb	FALSE
bbdccbddbb	FALSE
bcbddbaddb	FALSE
bcbddbbbcb	FALSE
bdacbdacbb	FALSE
bdacbdbccb	FALSE
bdcdbdbdbb	FALSE
bdcdcaabcb	FALSE
cabbcbaddb	FALSE
cabbcbbdbb	FALSE
caddadbcab	FALSE
caddbbacbb	FALSE
cbcacddbbb	FALSE
cbcadcbbbb	FALSE
ccadccadcb	FALSE
ccadcccabb	FALSE
ccdbabdbab	FALSE
ccdbaccdab	FALSE
cdbcccbdbb	FALSE
cdbcccdbbb	FALSE
daaadbdccb	FALSE
daaaddbddb	FALSE
dacdbadadb	FALSE
dacdbcbddb	FALSE
dbbcbbaabb	FALSE
dbbcbbcddb	FALSE
dcaacdabcb	FALSE
dcaacddacb	FALSE
dccdbacbdb	FALSE
dccdbbaaab	FALSE
ddbbadcaab	FALSE
ddbbbbcbcb	FALSE
aaaaaaccadb	TRUE
aaaaabddbab	TRUE
aacbdbbbccb	TRUE
aacbddbbccb	TRUE
abbababbdcb	TRUE
abbabbbcaab	TRUE
abdcadbacab	TRUE
abdcadbcddb	TRUE
accadaaaacb	TRUE
accadaadadb	TRUE
adbaadbadbb	TRUE
adbaadbbbbb	TRUE
addcbdbbacb	TRUE
addcbdcabab	TRUE
babdccbcaac	TRUE
babdcdadaaa	TRUE
bbacbdbdacc	TRUE
bbaccaacaba	TRUE
bbdbcadbddd	TRUE
bbdbcbadcbd	TRUE
bcbdcadcddc	TRUE
bcbdcbdcbdd	TRUE
bdacaabdcac	TRUE
bdacadcabbd	TRUE
bddaaacbadd	TRUE
bddaaadabba	TRUE
cabbbdbbcda	TRUE
cabbcacccac	TRUE
cbaabdbabda	TRUE
cbaabdbbdba	TRUE
cbcbddbdbcc	TRUE
cbccacbabdd	TRUE
ccadabbcacc	TRUE
ccadabdaccc	TRUE
cccddcabbaa	TRUE
cccddcabbda	TRUE
cdbbdbdacdc	TRUE
cdbcaaaacda	TRUE
daabacbbadd	TRUE
daabaccbdcd	TRUE
dacdaabddcd	TRUE
dacdadacdbd	TRUE
dbbcaddaaad	TRUE
dbbcbacbabd	TRUE
dcabaabdaad	TRUE
dcababdacbd	TRUE
dccdbabaabc	TRUE
dccdbacbadd	TRUE
ddbcadcbacd	TRUE
ddbcbaadbda	TRUE
aaaaaaccadc	FALSE
aaaaabddbad	FALSE
aacbdbbbccd	FALSE
aacbddbbccd	FALSE
abbababbdcd	FALSE
abbabbbcaaa	FALSE
abdcadbacaa	FALSE
abdcadbcdda	FALSE
accadaaaacd	FALSE
accadaadadd	FALSE
adbaadbadbc	FALSE
adbaadbbbbc	FALSE
addcbdbbaca	FALSE
addcbdcabad	FALSE
babdccbcaab	FALSE
babdcdadaab	FALSE
bbacbdbdacb	FALSE
bbaccaacabb	FALSE
bbdbcadbddb	FALSE
bbdbcbadcbb	FALSE
bcbdcadcddb	FALSE
bcbdcbdcbdb	FALSE
bdacaabdcab	FALSE
bdacadcabbb	FALSE
bddaaacbadb	FALSE
bddaaadabbb	FALSE
cabbbdbbcdb	FALSE
cabbcacccab	FALSE
cbaabdbabdb	FALSE
cbaabdbbdbb	FALSE
cbcbddbdbcb	FALSE
cbccacbabdb	FALSE
ccadabbcacb	FALSE
ccadabdaccb	FALSE
cccddcabbab	FALSE
cccddcabbdb	FALSE
cdbbdbdacdb	FALSE
cdbcaaaacdb	FALSE
daabacbbadb	FALSE
daabaccbdcb	FALSE
dacdaabddcb	FALSE
dacdadacdbb	FALSE
dbbcaddaaab	FALSE
dbbcbacbabb	FALSE
dcabaabdaab	FALSE
dcababdacbb	FALSE
dccdbabaabb	FALSE
dccdbacbadb	FALSE
ddbcadcbacb	FALSE
ddbcbaadbdb	FALSE
aaaaacbdddbb	TRUE
aaaaadbcdcdb	TRUE
aacdaccaaaab	TRUE
aacdadacbaab	TRUE
abbcaaadbcdb	TRUE
abbcaaccaadb	TRUE
abdddaabbdcb	TRUE
abdddabbdcab	TRUE
accbdadcbbbb	TRUE
accbdccbdbbb	TRUE
adbacbcbdddb	TRUE
adbacbdccddb	TRUE
baaacacdaaaa	TRUE
baaacdbdaaaa	TRUE
baccbdccdcad	TRUE
bacccbabdacd	TRUE
bbbacdddadcd	TRUE
bbbadbccbacc	TRUE
bbddaccadbdd	TRUE
bbddadccdbaa	TRUE
bccbbbdbcadd	TRUE
bccbbccdbadd	TRUE
bdadcdbbabaa	TRUE
bdadcdbbdbdc	TRUE
bddbbbdbbcad	TRUE
bddbbcadbaac	TRUE
cabdbdbabbbd	TRUE
cabdbdbacdac	TRUE
cbaadccdacba	TRUE
cbaaddaddcbc	TRUE
cbdabbbbcada	TRUE
cbdabbbddccc	TRUE
ccbdadabcdda	TRUE
ccbdadbabbca	TRUE
cdabcadccdba	TRUE
cdabcbcbcdad	TRUE
cdcddbddcbbc	TRUE
cdcddbdddaaa	TRUE
dabcabcbcbcc	TRUE
dabcabdbaaba	TRUE
daddccacacac	TRUE
daddccbdcddc	TRUE
dbccaaccbaaa	TRUE
dbccacccbabc	TRUE
dcadbdddbadc	TRUE
dcadcabccdda	TRUE
dcdadacdcdca	TRUE
dcdadbccacac	TRUE
ddbccdadddba	TRUE
ddbccdbaacbc	TRUE
aaaaacbdddba	FALSE
aaaaadbcdcda	FALSE
aacdaccaaaac	FALSE
aacdadacbaad	FALSE
abbcaaadbcda	FALSE
abbcaaccaada	FALSE
abdddaabbdcd	FALSE
abdddabbdcad	FALSE
accbdadcbbba	FALSE
accbdccbdbbc	FALSE
adbacbcbdddd	FALSE
adbacbdccdda	FALSE
baaacacdaaab	FALSE
baaacdbdaaab	FALSE
baccbdccdcab	FALSE
bacccbabdacb	FALSE
bbbacdddadcb	FALSE
bbbadbccbacb	FALSE
bbddaccadbdb	FALSE
bbddadccdbab	FALSE
bccbbbdbcadb	FALSE
bccbbccdbadb	FALSE
bdadcdbbabab	FALSE
bdadcdbbdbdb	FALSE
bddbbbdbbcab	FALSE
bddbbcadbaab	FALSE
cabdbdbabbbb	FALSE
cabdbdbacdab	FALSE
cbaadccdacbb	FALSE
cbaaddaddcbb	FALSE
cbdabbbbcadb	FALSE
cbdabbbddccb	FALSE
ccbdadabcddb	FALSE
ccbdadbabbcb	FALSE
cdabcadccdbb	FALSE
cdabcbcbcdab	FALSE
cdcddbddcbbb	FALSE
cdcddbdddaab	FALSE
dabcabcbcbcb	FALSE
dabcabdbaabb	FALSE
daddccacacab	FALSE
daddccbdcddb	FALSE
dbccaaccbaab	FALSE
dbccacccbabb	FALSE
dcadbdddbadb	FALSE
dcadcabccddb	FALSE
dcdadacdcdcb	FALSE
dcdadbccacab	FALSE
ddbccdadddbb	FALSE
ddbccdbaacbb	FALSE
aaaaacbdddbbb	TRUE
aaaaadaddcdab	TRUE
aacdbbdbbabbb	TRUE
aacdbcdacbadb	TRUE
abbccccaaccab	TRUE
abbcccdccabbb	TRUE
abddcddddabbb	TRUE
abdddacbdcccb	TRUE
acccaacdccddb	TRUE
acccaadccbdab	TRUE
adbbbabcbccab	TRUE
adbbbbbbabcbb	TRUE
baaacdbccbcba	TRUE
baaacdcdbaada	TRUE
bacbdbbdbadba	TRUE
bacbdcaccdaba	TRUE
bbbaadabcaaad	TRUE
bbbababadbaac	TRUE
bbddcbcaaddba	TRUE
bbddcbdacabdd	TRUE
bccbdbdcdcdbc	TRUE
bccbdcbbcaddd	TRUE
bdbaacbbdbccd	TRUE
bdbaacdacdcbc	TRUE
bddcbdddbbacd	TRUE
bddccabbcadba	TRUE
cacabacddccda	TRUE
cacabadbaaadd	TRUE
cbabdbdcdcbca	TRUE
cbabdcdbbddcd	TRUE
cbdbbccbdabca	TRUE
cbdbcabbcccbc	TRUE
ccbddbadabaad	TRUE
ccbddcabaacca	TRUE
cdabccbccbada	TRUE
cdabcccbaadda	TRUE
cdcdcbbcdabdd	TRUE
cdcdcbbcdbabd	TRUE
dabcbcaaddada	TRUE
dabcbccadcaba	TRUE
dadddadddcbcd	TRUE
dadddbdabadbc	TRUE
dbcbadddcbada	TRUE
dbcbbabdcbbca	TRUE
dcacdcdcaccbd	TRUE
dcadaaaaddbaa	TRUE
dcdaccabcdaaa	TRUE
dcdacdacdcacd	TRUE
ddbcabacbdada	TRUE
ddbcabcddadbc	TRUE
aaaaaadabcbdd	FALSE
aaaaabbcabacc	FALSE
aacdcaacdaccc	FALSE
aacdcccbdcbdd	FALSE
abbdaadbbaddd	FALSE
abbdabbccbbbd	FALSE
acababadcbcad	FALSE
acababcacdcac	FALSE
accdcdddbdbdc	FALSE
accddaaacbaca	FALSE
adbcbbcdaccaa	FALSE
adbcbdcccaaaa	FALSE
adddbbaddbdad	FALSE
adddbbbcacabd	FALSE
bacbbbbbcacbb	FALSE
bacbbbcabbcdb	FALSE
bbadccdbbdddb	FALSE
bbaddabdbdabb	FALSE
bbdcacbadbbbb	FALSE
bbdcacdaddadb	FALSE
bccabbbadcbab	FALSE
bccabbbbabdcb	FALSE
bdacaccdaacab	FALSE
bdacaddbacaab	FALSE
bddbdbcbaabab	FALSE
bddbdcaacbcdb	FALSE
cacadbacccbdb	FALSE
cacadbcdbbaab	FALSE
cbabbddbcbbcb	FALSE
cbabcacdcadbb	FALSE
cbccdcdabaabb	FALSE
cbccddbbadadb	FALSE
ccbcaaccbaadb	FALSE
ccbcaccaabbab	FALSE
ccdddaaccdbab	FALSE
ccdddbccddcdb	FALSE
cdcaddbbccaab	FALSE
cdcaddcadaacb	FALSE
daadbaccadaab	FALSE
daadbdcadcbdb	FALSE
dadbbabaacbbb	FALSE
dadbbabaacdcb	FALSE
dbbddbdcdcbcb	FALSE
dbbddccccaabb	FALSE
dcabbbdbbaccb	FALSE
dcabbcabddacb	FALSE
dcccbdbbddabb	FALSE
dccccbbbcdcab	FALSE
ddbbadbaddbab	FALSE
ddbbaddddabbb	FALSE
aaaaaadabcbddb	TRUE
aaaaabcabacccb	TRUE
aacddabadacdcb	TRUE
aacddaddcdccdb	TRUE
abbcadaccbbabb	TRUE
abbcadbcbcdddb	TRUE
acaaddaddacdcb	TRUE
acabaaaacaaabb	TRUE
accdaabadaaccb	TRUE
accdaaddbbdaab	TRUE
adbbdacaaaacdb	TRUE
adbbdbbdbdcacb	TRUE
adddbcdbcabadb	TRUE
adddbcdddbbddb	TRUE
bacadabcabbcdc	TRUE
bacbaaadacbabc	TRUE
bbbacacaccabcd	TRUE
bbbacaccabcdaa	TRUE
bbdcbbabaaacda	TRUE
bbdcbcaddcadaa	TRUE
bccaabdcbdcaaa	TRUE
bccaadcbccdbca	TRUE
bdacdbdcbbaada	TRUE
bdacdccbbacbda	TRUE
bddcabcacdaccd	TRUE
bddcacdbcabbbc	TRUE
cacacaabddbadd	TRUE
cacacaacaaccac	TRUE
cbacdcbcdddadc	TRUE
cbacdddadcbbad	TRUE
cbdadcadabacdc	TRUE
cbdaddcbcaabca	TRUE
ccbcadcccbdaba	TRUE
ccbcbaabbdcbbc	TRUE
cdaacdbbbcdbca	TRUE
cdaadabdccaabd	TRUE
cdcbdcdbccacca	TRUE
cdcbddcdadaada	TRUE
daadadbbadcaac	TRUE
daadadbddcbaaa	TRUE
dadbbbdbbbbdcc	TRUE
dadbbcacbacddc	TRUE
dbbcaccdddbbcc	TRUE
dbbcacdbbcacca	TRUE
dcaacabddbcdac	TRUE
dcaacbcabddccd	TRUE
dccccaddabcdcc	TRUE
dcccccaacddcdc	TRUE
ddbbbdbcdcdccc	TRUE
ddbbbdbdaaaccd	TRUE
aaaaaaacbbaaba	FALSE
aaaaaabadabbdd	FALSE
aaccabccddddac	FALSE
aaccadaabcbabc	FALSE
abbacccbbbcaad	FALSE
abbaccdbdbaccc	FALSE
abdccdadcbcbad	FALSE
abdccdbcabccdc	FALSE
acccccbbaabcad	FALSE
acccdabdcbabda	FALSE
adbbdcaaadacda	FALSE
adbbdcbdacdcaa	FALSE
baaaadaadaadcb	FALSE
baaabbbccbdacb	FALSE
bacbddabcaaabb	FALSE
bacbddbccdbabb	FALSE
bbadddacbddbab	FALSE
bbadddbbcbabdb	FALSE
bbdbdbabcbcbab	FALSE
bbdbdbabccbddb	FALSE
bcbcbdcacdddab	FALSE
bcbcbddbacabdb	FALSE
bdaacbdaaabccb	FALSE
bdaacbddacdabb	FALSE
bddaadcaacdddb	FALSE
bddabaabdababb	FALSE
cabbcbacbcaadb	FALSE
cabbcbbcdccbcb	FALSE
cadcbdcaaaddab	FALSE
cadcbdcbdcdbab	FALSE
cbcadcbcbaaddb	FALSE
cbcadccccbcdbb	FALSE
ccabbdbcdcbcab	FALSE
ccabcacaacbbbb	FALSE
ccdaacdcbcbbab	FALSE
ccdaadbbcdcdbb	FALSE
cdbbbdaacabddb	FALSE
cdbbbdadddcdab	FALSE
daaabaddbcbdbb	FALSE
daaabbabdbadbb	FALSE
dacdbbbcbcbccb	FALSE
dacdbbdcaacacb	FALSE
dbbcbcdcaabacb	FALSE
dbbcbdcabcbabb	FALSE
dcaaccbabbdcab	FALSE
dcaaccccbccbcb	FALSE
dccdbcadddabbb	FALSE
dccdbcbadccbcb	FALSE
ddbbbdadbdbabb	FALSE
ddbbcadbabaacb	FALSE
aaaaaaacbbaabab	TRUE
aaaaaabdabbdddb	TRUE
aaccacaabcbbabb	TRUE
aaccacddbacccbb	TRUE
abbaabcccdadcbb	TRUE
abbaabdbcacdacb	TRUE
abdcadcbdabbddb	TRUE
abdcadddaacbadb	TRUE
accbdcccabcdbcb	TRUE
accbddccdacadbb	TRUE
adbbacbabbdbbab	TRUE
adbbadaabdcbcab	TRUE
baaaacddbbcabba	TRUE
baaabcbccadaacc	TRUE
bacccdcacddacdc	TRUE
baccdaaaadcbccd	TRUE
bbbaaadacddbcdd	TRUE
bbbaabbbbaadcad	TRUE
bbdbdadcacadadd	TRUE
bbdbdadcbccdccc	TRUE
bcbdbcbbcddabdd	TRUE
bcbdbccbaaadbca	TRUE
bdaccbadcbdabdd	TRUE
bdacdccbdadaada	TRUE
bddadbacabbbccc	TRUE
bddadbbacdbcada	TRUE
cabbbdbcbcacadd	TRUE
cabbbddbdadddda	TRUE
caddbbdcdbdacaa	TRUE
caddbcaacacccac	TRUE
cbcaabcaaadacac	TRUE
cbcaacbbddcabcd	TRUE
ccabaddaadcdbaa	TRUE
ccabaddbdbcbacd	TRUE
cccccddcaacaaaa	TRUE
ccccdaadcbbdcbd	TRUE
cdbbbcbbaadcdad	TRUE
cdbbbdabbaccddc	TRUE
daaabcbbbdabdbd	TRUE
daaabdabacadbad	TRUE
daccdccbdcbdcdd	TRUE
daccddccdcbddba	TRUE
dbbbddddbbacbad	TRUE
dbbcaabcbdbcdad	TRUE
dcaadcbbcbbdddc	TRUE
dcaaddcbbbdbbda	TRUE
dccdbcadadcbadd	TRUE
dccdbdbcadadccc	TRUE
ddbbbcdacbaacaa	TRUE
ddbbbdbbbdabbdd	TRUE
aaaaaadbccdacba	FALSE
aaaaaccacbbcbba	FALSE
aaccaabaabcadcc	FALSE
aaccaabcdcbcadc	FALSE
abaddccdaccadaa	FALSE
abaddcdbbaacbaa	FALSE
abdcdcbdbccccac	FALSE
abdcdcdcabaacdd	FALSE
accbccadacdccdc	FALSE
accbcdcadbdaada	FALSE
adbbadaacacbdcc	FALSE
adbbbaaddadcdcc	FALSE
baaaabadabbdabb	FALSE
baaaabadbddcbcb	FALSE
bacbdcacacbbdbb	FALSE
baccabbbcbcdabb	FALSE
bbadcdabcbcddbb	FALSE
bbadcdbbbdbcaab	FALSE
bbdcabcaddbacdb	FALSE
bbdcacbddabdacb	FALSE
bccacbcbabbdadb	FALSE
bccacbccdbbccbb	FALSE
bdacdbaaddcdcab	FALSE
bdacdbbdccddbab	FALSE
bddacaacdcddabb	FALSE
bddacabdacaaaab	FALSE
cabdbdadddbdadb	FALSE
cabdbdcbdddbdbb	FALSE
cbabaabdaddcbdb	FALSE
cbabaacaacdcbab	FALSE
cbcddcbaaadbbab	FALSE
cbcdddaaddbcbab	FALSE
ccbbbabbbbdcadb	FALSE
ccbbbadbcddbdbb	FALSE
ccddabcdacacbcb	FALSE
ccddabdaaaddbcb	FALSE
cdcaddddccbacbb	FALSE
cdcbaaacacdaccb	FALSE
daacbbaddbbbaab	FALSE
daacbdcbaaadadb	FALSE
dadbbbabdddbbdb	FALSE
dadbbbbbdbcdadb	FALSE
dbcabaadbddbacb	FALSE
dbcabcdcbccbcdb	FALSE
dcacbacdbdbccab	FALSE
dcacbadacbbadab	FALSE
dcccdcdcdbdcbdb	FALSE
dcccddcabaddaab	FALSE
ddbcabcaacacddb	FALSE
ddbcadaddccdbab	FALSE
aaaaaadbccdacbab	TRUE
aaaaacacbbcbbabb	TRUE
aaccaccbaabddcdb	TRUE
aaccadbcbdbbadbb	TRUE
abaddccdbbbcdcdb	TRUE
abaddcdcbbbddbcb	TRUE
abdcdabadcdbcdcb	TRUE
abdcdbacbcbcadbb	TRUE
accbdcabccacaacb	TRUE
accbdcbddabdcbbb	TRUE
adbabbadccbcdbdb	TRUE
adbabbbabdabccbb	TRUE
baaaaaccbdcdbdda	TRUE
baaaacaacbcbcdcc	TRUE
bacccbddbbcbddba	TRUE
baccccadddcdcbcc	TRUE
bbbabcbbcacaccdd	TRUE
bbbabdbddcaaadac	TRUE
bbdcdaddaabdbaac	TRUE
bbdcdbccaaddccbc	TRUE
bcbdddacccdabadd	TRUE
bccaaabddddbdcca	TRUE
bdacdccaacaadaca	TRUE
bdacddaccaaacccd	TRUE
bddabbdaabcaccad	TRUE
bddabcdcdadbdccc	TRUE
cabdadbcdaadbbcc	TRUE
cabdaddabbbcdbda	TRUE
cbabaabcdbbbccac	TRUE
cbabaadbbadbcddc	TRUE
cbcdcbacbbddaaaa	TRUE
cbcdcdacdbadadba	TRUE
ccbcbbdccbdabbad	TRUE
ccbcbccdbcbbdbcd	TRUE
ccddbbbcadddcdcd	TRUE
ccddbbdbaaadddbc	TRUE
cdcababbcdcbaaac	TRUE
cdcabacdbcdcbdcc	TRUE
daacabbdccccaaac	TRUE
daacaccabcaabbcc	TRUE
dadabcddcaaddada	TRUE
dadabdadbdacddda	TRUE
dbbcbcdbbdadbcbd	TRUE
dbbcbdcabacabbac	TRUE
dcaaaccbccacbaba	TRUE
dcaaadabbacbdddd	TRUE
dcdaadacadcdcbbd	TRUE
dcdababbabbbacbd	TRUE
ddbcdccbdcdaaabd	TRUE
ddbcddcbacbcdbcd	TRUE
aaaaaabcabbbdacd	FALSE
aaaaaabcdaadcdba	FALSE
aacdacdccbdbabbd	FALSE
aacdadddcdaabcbd	FALSE
abbbccbaaaaabaaa	FALSE
abbbccddaadabddd	FALSE
abddababadcbcdbc	FALSE
abddacddababaaad	FALSE
acccabdbddcabcba	FALSE
acccacaaccbbcdac	FALSE
adbaaaddaddcacac	FALSE
adbaacdbccaacbad	FALSE
addcacdbcdacccca	FALSE
addcacdcaadcaacc	FALSE
bacbabcacacaccbb	FALSE
bacbabdbbbcbcdab	FALSE
bbabdcdaabcbdbbb	FALSE
bbacaabdbdccaacb	FALSE
bbdbadbaaaabdaab	FALSE
bbdbadbbcaadbcab	FALSE
bcbdabbdbbcacbbb	FALSE
bcbdabbdcdcabddb	FALSE
bdababadbddcbaab	FALSE
bdababcdaadbbbdb	FALSE
bdccaaaadbdcbabb	FALSE
bdccaaacbabddcdb	FALSE
cabadaddbcacddab	FALSE
cabadbabdacdccdb	FALSE
caddbcbcacdaacdb	FALSE
caddcbabdcadaacb	FALSE
cbccbbccdacacadb	FALSE
cbccbcddbbabbacb	FALSE
ccbbdbadcabdbcdb	FALSE
ccbbdcbdcbbcdabb	FALSE
ccddaccaccacbacb	FALSE
ccddaddacaabcadb	FALSE
cdbddacdadcbcddb	FALSE
cdbdddcbdadbcbbb	FALSE
daacbbbacaddbddb	FALSE
daacbbbbdcdabcbb	FALSE
dacdddacdadaabcb	FALSE
dadaabddacdaddab	FALSE
dbbcaddabadcbadb	FALSE
dbbcbacbccbdbddb	FALSE
dcaaccacccbbdccb	FALSE
dcaaccdddbccacbb	FALSE
dccdacaacdabddcb	FALSE
dccdaccabcbaacab	FALSE
ddbbdbbbabdbbaab	FALSE
ddbbdbcdcbdbbbdb	FALSE
aaaaaaddcacbcdccb	TRUE
aaaaabbdddabaaadb	TRUE
aacccadabbccadacb	TRUE
aacccbabddccbbbab	TRUE
abadaddcbabaaaccb	TRUE
abadbccabddbdccdb	TRUE
abdcddcbcddaaaaab	TRUE
abddaaccacdbadadb	TRUE
acbddadcbbbabacbb	TRUE
acbddcadcbbcadbbb	TRUE
adabbddddcdcaccab	TRUE
adabcadbbdabddadb	TRUE
adcdcdcacdbadacbb	TRUE
adcdcddadadbdbadb	TRUE
babbcbbbaacccaaca	TRUE
babbcbcabdbacbbbd	TRUE
baddcaaddaccdccda	TRUE
baddcbdcaacbbbdda	TRUE
bbcccbdcacabadbcc	TRUE
bbcccccbabbccabac	TRUE
bcbaacadddcbcacda	TRUE
bcbaadcaabbbdaacd	TRUE
bcdcbabcddbbdcdba	TRUE
bcdcbadbadcaadabc	TRUE
bdcbadcbacaaabaaa	TRUE
bdcbbaaaacbadaabc	TRUE
caadbaacabbcdaadc	TRUE
caadbbdcbddadbbdd	TRUE
cadcbadabccddccbd	TRUE
cadcbdbdcddaaddba	TRUE
cbcbadcacdaccbbca	TRUE
cbcbbaaadaacdbcca	TRUE
ccacbdbdbcacabddc	TRUE
ccacbddaccddacbbd	TRUE
cccddacdbccdbbaca	TRUE
cccddadbbccaddabd	TRUE
cdbbdadcaddbaddca	TRUE
cdbbdbbccbbdcbcaa	TRUE
daaacbbbbcaaacadd	TRUE
daaaccdbcdbbccadd	TRUE
dacdcacadbcbbdadd	TRUE
dacdcbcdcaaddcdbd	TRUE
dbbcccaaccdbacbdc	TRUE
dbbcdcaabccadaddd	TRUE
dcaaadacdcabadbcd	TRUE
dcaaadbdbbdbccdbd	TRUE
dcdaadcbabdababac	TRUE
dcdabaaaaccacbcaa	TRUE
ddbccabcaddaddacc	TRUE
ddbccadbdabcbddad	TRUE
aaaaaaddcacbcdccd	FALSE
aaaaabbdddabaaadc	FALSE
aacccadabbccadacc	FALSE
aacccbabddccbbbaa	FALSE
abadaddcbabaaaccc	FALSE
abadbccabddbdccdd	FALSE
abdcddcbcddaaaaad	FALSE
abddaaccacdbadadc	FALSE
acbddadcbbbabacba	FALSE
acbddcadcbbcadbbd	FALSE
adabbddddcdcaccac	FALSE
adabcadbbdabddadd	FALSE
adcdcdcacdbadacbc	FALSE
adcdcddadadbdbada	FALSE
babbcbbbaacccaacb	FALSE
babbcbcabdbacbbbb	FALSE
baddcaaddaccdccdb	FALSE
baddcbdcaacbbbddb	FALSE
bbcccbdcacabadbcb	FALSE
bbcccccbabbccabab	FALSE
bcbaacadddcbcacdb	FALSE
bcbaadcaabbbdaacb	FALSE
bcdcbabcddbbdcdbb	FALSE
bcdcbadbadcaadabb	FALSE
bdcbadcbacaaabaab	FALSE
bdcbbaaaacbadaabb	FALSE
caadbaacabbcdaadb	FALSE
caadbbdcbddadbbdb	FALSE
cadcbadabccddccbb	FALSE
cadcbdbdcddaaddbb	FALSE
cbcbadcacdaccbbcb	FALSE
cbcbbaaadaacdbccb	FALSE
ccacbdbdbcacabddb	FALSE
ccacbddaccddacbbb	FALSE
cccddacdbccdbbacb	FALSE
cccddadbbccaddabb	FALSE
cdbbdadcaddbaddcb	FALSE
cdbbdbbccbbdcbcab	FALSE
daaacbbbbcaaacadb	FALSE
daaaccdbcdbbccadb	FALSE
dacdcacadbcbbdadb	FALSE
dacdcbcdcaaddcdbb	FALSE
dbbcccaaccdbacbdb	FALSE
dbbcdcaabccadaddb	FALSE
dcaaadacdcabadbcb	FALSE
dcaaadbdbbdbccdbb	FALSE
dcdaadcbabdababab	FALSE
dcdabaaaaccacbcab	FALSE
ddbccabcaddaddacb	FALSE
ddbccadbdabcbddab	FALSE
aaaaaacbccccbaaadb	TRUE
aaaaababddaadcabbb	TRUE
aacbabdadcacbdabdb	TRUE
aacbacbcabaaddcdcb	TRUE
abaddacdcddbcdabab	TRUE
abaddbbaadbaabccbb	TRUE
abdcbdbbdcbaaaacdb	TRUE
abdcbddadcbaccbbdb	TRUE
accacbbbadbadacdbb	TRUE
accacccddcbbbcdadb	TRUE
adacdccabccacdabdb	TRUE
adadaabcddccabddab	TRUE
addbcbaabacbcbcadb	TRUE
addbcdadbddbbaaccb	TRUE
babdcabdcbccabdadc	TRUE
babdcbacadacabccdd	TRUE
bbacbbccbdddddcacd	TRUE
bbacbcbbabcddcbadd	TRUE
bbdacabcdbcbdadada	TRUE
bbdacabcddbadbacdd	TRUE
bcbbddaaadabccdacc	TRUE
bcbcaacbdbdbdbbcbd	TRUE
bdabdbbabccccbbcbd	TRUE
bdabddcacbdabcddbd	TRUE
bdcdbaadccadaccdda	TRUE
bdcdbbacacbbacbbaa	TRUE
cabbbadaacdadbabad	TRUE
cabbbadbdcbdbaacdd	TRUE
cbaacabaaddbdbbabd	TRUE
cbaacadcadccdacdaa	TRUE
cbccbadabbaaaddbdc	TRUE
cbccbadadbbccbbccd	TRUE
ccbadccaacacbcbbcc	TRUE
ccbadcdaabccaadbaa	TRUE
ccdcacaaddbcabdcdd	TRUE
ccdcaccaadcabbcbad	TRUE
cdcbadcbabbacacbad	TRUE
cdcbbadbbabdcdaacd	TRUE
daadddacdadaabdbac	TRUE
daadddbbbbbdacdcbc	TRUE
dadbccaccdaddadcbc	TRUE
dadbcdbddaaaddddaa	TRUE
dbcabdcccdaccbbbba	TRUE
dbcacacdaacadaccaa	TRUE
dcabcccabbccccacaa	TRUE
dcabccdcbcbaaabaca	TRUE
dccdcbabdaddcbccca	TRUE
dccdcbadcccccbdbbd	TRUE
ddbbbdbdbbccdbcddd	TRUE
ddbbbdcacbbdbbbaad	TRUE
aaaaaaadadcdbaabdc	FALSE
aaaaaadcccabdbaaac	FALSE
aacdddccbbadcadcca	FALSE
aadaaaabbdbaaacbbd	FALSE
abbcbddcdcacbadcbc	FALSE
abbccadcccccbbabaa	FALSE
abdddcabbdaccadbad	FALSE
abdddcdbcbbbcdadca	FALSE
accdabbdddacbacabc	FALSE
accdbbddddbdaccdda	FALSE
adbbdbcdcbdbccbaca	FALSE
adbbdcacbdbdbacbba	FALSE
adddbcaddcddcbdabd	FALSE
adddbcbabcdadaddad	FALSE
bacaaccccdaadaddbb	FALSE
bacaaddcaddcbaccab	FALSE
bbabaabbbcdbbdaadb	FALSE
bbababaadcbcbcdbab	FALSE
bbdabaddcdddbdccbb	FALSE
bbdabbbcbdaaccaabb	FALSE
bcbcacbbdcadccbbdb	FALSE
bcbcacbdaabadcbbab	FALSE
bcdddadaaaabbcdbcb	FALSE
bcdddadbdbacbccbab	FALSE
bdcacabccccacbaabb	FALSE
bdcacabdccbccadadb	FALSE
caadbdcccabdaabcdb	FALSE
caadcadddadddbacdb	FALSE
cadcaadbbbbcdabbbb	FALSE
cadcabdabccdbccacb	FALSE
cbbdbbbcadbddbadab	FALSE
cbbdbcabbbcddaabbb	FALSE
ccadaccbdbbccacdbb	FALSE
ccadaddbabdadcbcab	FALSE
ccdbddacdababdcacb	FALSE
ccdbddbbdabddddccb	FALSE
cdbddcbcbabccdcabb	FALSE
cdbddccbccccdcdaab	FALSE
daaccaadddaccdbdcb	FALSE
daaccadabbdaadaaab	FALSE
dadabdacaabbaadadb	FALSE
dadabdbababcdadadb	FALSE
dbbcaaadadbadababb	FALSE
dbbcacabcbacdaabbb	FALSE
dbddcddcadcbdaddbb	FALSE
dbdddacbdbdcbcbdcb	FALSE
dcccabdcccdaddacab	FALSE
dcccbaacdaccaccadb	FALSE
ddbabdcadbcdbdcbdb	FALSE
ddbabddcacbdbbbdab	FALSE
aaaaaaadadcdbaabdbb	TRUE
aaaaaadccabdbaaaccb	TRUE
aacdddddacdabdbdbcb	TRUE
aadaacaccbbdcaacbdb	TRUE
abbcbaccaabcdcdbacb	TRUE
abbcbcaabbbacdabddb	TRUE
abddddbdaccdbccbccb	TRUE
abddddccbbadaaccbdb	TRUE
accdccabaaacdbabdbb	TRUE
accdcdbbacaddbdddbb	TRUE
adbbcbaaacacdddcdcb	TRUE
adbbccbbcabcddbbcbb	TRUE
adddabaaddbbccbabab	TRUE
adddaccbbbdddabdcab	TRUE
bacbbdbcccdcbddccdc	TRUE
bacbbdccbccddcddabc	TRUE
bbacadbccdbbbacbbda	TRUE
bbacaddccbdaaddadba	TRUE
bbdacdbccddaabcabac	TRUE
bbdacdbdbadcaccdbac	TRUE
bcbdaaacbbabccbbaca	TRUE
bcbdaabbabbaabdcada	TRUE
bdaabcdadcbdabdcadd	TRUE
bdaabcdbbccdbcaacba	TRUE
bdcbdcbabcdbcbdabdc	TRUE
bdcbdcbdbbcacbabadc	TRUE
caadcdaddabbbdccadc	TRUE
caaddabbdddcbdcbcca	TRUE
caddabadaddacabdbdd	TRUE
caddadbcdcbcbbaccba	TRUE
cbcabcdbbbbbbcacbcc	TRUE
cbcabddccccbbbdcacc	TRUE
ccadabacadadbdadbcc	TRUE
ccadabccddcddcbcccd	TRUE
ccdcadbbacaadccddaa	TRUE
ccdcaddacdacbcbbcaa	TRUE
cdcadadcbcdbbdcbcac	TRUE
cdcadbcadcbdcdcccaa	TRUE
daaccdcaacbbcababaa	TRUE
daacdaadbadaadcbcbc	TRUE
dacddabbaddccdcbcbc	TRUE
dacddadadbaadbaccca	TRUE
dbbdaaddcacababddad	TRUE
dbbdabacbaccdccbcda	TRUE
dcaadadbbdcbbbadbca	TRUE
dcaadbabbaddadbbcdc	TRUE
dccdbacbadcbaaabbca	TRUE
dccdbadddbdbbcabcbc	TRUE
ddbcbbadacbadccacdd	TRUE
ddbcbbdaaabdcaaddda	TRUE
aaaaabbbbbdbddcddba	FALSE
aaaaadbddabbbabaabc	FALSE
aacbbadbacbdcbabacc	FALSE
aacbcababcadaaadaaa	FALSE
abadbbddcdacbdbacbc	FALSE
abadbcaadabdcdaabbd	FALSE
abdccdddcbabcbccdcc	FALSE
abdcdacadacaaacbadc	FALSE
accacadaaadaaacaaba	FALSE
accacadcddccabdaccd	FALSE
adabdcabcdcbbacabaa	FALSE
adabdcadbdcadadbdda	FALSE
adcddddcbaababcbdbc	FALSE
adcddddcbcaacbddbad	FALSE
babcdbbbadaabdcadbb	FALSE
babcdcadbcdaadabbcb	FALSE
bbabaadaabdcaddacbb	FALSE
bbabaadbccaddabdaab	FALSE
bbccdccdbabaacdcddb	FALSE
bbccddadbbbdcddcdcb	FALSE
bcbadacbcbabbcbbcab	FALSE
bcbadbaaaaaabacdabb	FALSE
bcdcccbddddddcbcbab	FALSE
bcdcdadcdabcddbadab	FALSE
bdcbcdcbdddccbbbdbb	FALSE
bdcbdbcaadaddabbdbb	FALSE
cabacbbdaabacbdacab	FALSE
cabacbdbdbadbaacbbb	FALSE
cadbdbbbbacccccabab	FALSE
cadbdccaabdaaacbcbb	FALSE
cbbddddcddbcbbbbbab	FALSE
cbcaaabaddbbbaddabb	FALSE
ccacddbaacbdbcadbcb	FALSE
ccacddbaddbdcdcbaab	FALSE
ccdbcbbcbadadadbadb	FALSE
ccdbccaadcbbcaaaacb	FALSE
cdbdadaaacacdbcdccb	FALSE
cdbdadbddbccbbbbddb	FALSE
daabbaaaaadccbdbbdb	FALSE
daabbacaadacdbdccbb	FALSE
dadabdabdabdbdbbbcb	FALSE
dadabdadbcbdbcdcccb	FALSE
dbbcddcbddbaccdcacb	FALSE
dbbcddddddcbbdacadb	FALSE
dcaacbaccdacacbacbb	FALSE
dcaacccccbbabdbabcb	FALSE
dccdbcccdcacacccddb	FALSE
dccdcaccabcadaaaccb	FALSE
ddbcbcacdcabadcadab	FALSE
ddbcbcdbdbdccbbacdb	FALSE
