adadadadad	TRUE
adadadadad	TRUE
adadcdadad	TRUE
adadcdadad	TRUE
adbcbcbcbc	TRUE
adbcbcbcbc	TRUE
adcadaddad	TRUE
adcadaddca	TRUE
adccdcbcad	TRUE
adccdccadd	TRUE
addbcaddcb	TRUE
addbcaddda	TRUE
adddccadad	TRUE
adddccbcbc	TRUE
bcadcbcdbc	TRUE
bcadcbcdcd	TRUE
bcbcbcadad	TRUE
bcbcbcadad	TRUE
bcbcdcdccc	TRUE
bcbcdcdcdc	TRUE
bcccadbcbc	TRUE
bcccadbcca	TRUE
bcdadbcdcc	TRUE
bcdadbcddc	TRUE
bcdcddadad	TRUE
bcdcddbcbc	TRUE
cadbcccdda	TRUE
cadbccdada	TRUE
cbcadaddbc	TRUE
cbcadaddbc	TRUE
cbccbcdadc	TRUE
cbccbcdadc	TRUE
ccbcadcada	TRUE
ccbcadcbcb	TRUE
ccdcadbcbc	TRUE
ccdcadcbca	TRUE
cdcbcbcbcd	TRUE
cdcbcbccdc	TRUE
dadaddaddd	TRUE
dadaddbcbc	TRUE
daddbcdadc	TRUE
daddbcdbca	TRUE
dbccadaddc	TRUE
dbccadaddc	TRUE
dcadcdcbcb	TRUE
dcadcdcdbc	TRUE
dccdbcbcca	TRUE
dccdbccadb	TRUE
ddbcbcbcca	TRUE
ddbcbcbccd	TRUE
aaaaaadccb	FALSE
aaaaabbdad	FALSE
aaccaacabb	FALSE
aaccaadbad	FALSE
abbaaadcdc	FALSE
abbaaccaba	FALSE
abdccddaad	FALSE
abdcdabdda	FALSE
accbdbbbcd	FALSE
accbdddbda	FALSE
adbaaabdcb	FALSE
adbaabbcca	FALSE
addcbbbcbd	FALSE
addcbcdcac	FALSE
bacbcaddcd	FALSE
bacbcbaadd	FALSE
bbacdacdca	FALSE
bbacdadbdc	FALSE
bbdbadcbca	FALSE
bbdbbacabd	FALSE
bcbddcabdd	FALSE
bcbddcdcac	FALSE
bdabddacbb	FALSE
bdabddccdd	FALSE
bdcddcaccc	FALSE
bdcddcbcbc	FALSE
cabdbcbdcb	FALSE
cabdbcdadb	FALSE
cbaaccbbcd	FALSE
cbaaccbccd	FALSE
cbccbdcacb	FALSE
cbcccadbbb	FALSE
ccbadbbdbc	FALSE
ccbadccbac	FALSE
ccdcacdacd	FALSE
ccdcadcbda	FALSE
cdcbbdcbac	FALSE
cdcbbddbab	FALSE
daadcaadcc	FALSE
daadcadbdc	FALSE
dadbdbadac	FALSE
dadbdbbaca	FALSE
dbcabaaadb	FALSE
dbcabacddc	FALSE
dcacdcddbb	FALSE
dcacddbddc	FALSE
dccdbccaac	FALSE
dccdbccdaa	FALSE
ddbbdbddcc	FALSE
ddbbdcaddd	FALSE
adadadadadb	TRUE
adadadadadc	TRUE
adadccadcad	TRUE
adadccadcbc	TRUE
adbcbcadbcd	TRUE
adbcbcadbcd	TRUE
adbcddbccca	TRUE
adbcddbcddb	TRUE
adccadcccda	TRUE
adccadcdadc	TRUE
addaddadcad	TRUE
addaddadcad	TRUE
adddcbccbcd	TRUE
adddcbcddad	TRUE
bcadcbcadad	TRUE
bcadcbcadad	TRUE
bcbcaddadad	TRUE
bcbcaddadad	TRUE
bcbcdbcbcad	TRUE
bcbcdbcbcbc	TRUE
bccbcdcdcda	TRUE
bccbcddadcb	TRUE
bcdadbcbcad	TRUE
bcdadbcbcad	TRUE
bcdcddcadad	TRUE
bcdcddccadc	TRUE
cadbcbcdbca	TRUE
cadbcbcdcbc	TRUE
cbcadadccda	TRUE
cbcadadcdbc	TRUE
cbccccbcccd	TRUE
cbccccbcdbc	TRUE
ccbcbcadbcc	TRUE
ccbcbcadcbc	TRUE
cdadadadccb	TRUE
cdadadaddbc	TRUE
cdcbcbcdbcb	TRUE
cdcbccadadb	TRUE
dadadcadbcd	TRUE
dadadcadcbc	TRUE
daddadccadb	TRUE
daddadcdadb	TRUE
dbcbccdddad	TRUE
dbcbccdddcb	TRUE
dcadaddadad	TRUE
dcadaddadda	TRUE
dcccbcadada	TRUE
dcccbcadadc	TRUE
ddbcadcbcca	TRUE
ddbcadcbcda	TRUE
aaaaaaddbdc	FALSE
aaaaabbcbcc	FALSE
aacbdabdcdc	FALSE
aacbdbadbad	FALSE
abbacccaacb	FALSE
abbadbccaad	FALSE
abddbdcbbab	FALSE
abddcacacda	FALSE
accadbbbdcd	FALSE
accadbdddcb	FALSE
adadcbcbbcc	FALSE
adadccdbcaa	FALSE
addcddbabdd	FALSE
adddaacdcbb	FALSE
baccaddaabb	FALSE
baccbabcbca	FALSE
bbacdcbccac	FALSE
bbacdcbdcdb	FALSE
bbdbbdbbccb	FALSE
bbdbbdbdcab	FALSE
bcbcdadacbd	FALSE
bcbdaabdbda	FALSE
bdabcaaccdb	FALSE
bdabcadabcc	FALSE
bdcdaabdbaa	FALSE
bdcdaacbdda	FALSE
cabbdcacdcc	FALSE
cabcaccabba	FALSE
cbaabcccbdc	FALSE
cbaabdacbaa	FALSE
cbcccbdadbc	FALSE
cbccccbddbb	FALSE
ccbadcbaabd	FALSE
ccbadddbdbc	FALSE
cdaaabbdbdd	FALSE
cdaaaccbabb	FALSE
cdcbcaaccbd	FALSE
cdcbcabcbdb	FALSE
daadcacdaab	FALSE
daadcadadcc	FALSE
dadbbacbdac	FALSE
dadbbbbcbcb	FALSE
dbbcdcbdadd	FALSE
dbbcdcdbbac	FALSE
dcababccdab	FALSE
dcabadbaaad	FALSE
dcccbababcc	FALSE
dcccbadcabc	FALSE
ddbaddbaaad	FALSE
ddbaddcccaa	FALSE
adadadadadbc	TRUE
adadadadadca	TRUE
adadcbcdbcdc	TRUE
adadcbcdccbc	TRUE
adbcbcadcbcb	TRUE
adbcbcadccad	TRUE
adbcddcbcbcd	TRUE
adbcddcdadcd	TRUE
adccbcdbcadd	TRUE
adccbcdbcbcc	TRUE
addadccdcadc	TRUE
addadccdcbcc	TRUE
adddcdadbcbc	TRUE
adddcdcbcdcd	TRUE
bcadcadddbcd	TRUE
bcadcadddcdc	TRUE
bcbcaddadcad	TRUE
bcbcaddadcbc	TRUE
bcbccddadadd	TRUE
bcbccddadbca	TRUE
bccbcdddccad	TRUE
bccbcddddccd	TRUE
bcdadbccadad	TRUE
bcdadbccadbc	TRUE
bcdcdbcddddb	TRUE
bcdcdcbcbccb	TRUE
cadbcbcadcad	TRUE
cadbcbcaddad	TRUE
caddccdddbca	TRUE
caddcdadadda	TRUE
cbccadbcadcc	TRUE
cbccadbcbcad	TRUE
ccadbcdcbcad	TRUE
ccadbcddbcbc	TRUE
cccddadaddcb	TRUE
cccddbcbcbca	TRUE
cdbccdcaddda	TRUE
cdbccdcbccdb	TRUE
dadadcddadad	TRUE
dadadcddbcca	TRUE
dadcdddadada	TRUE
dadcddddcbcd	TRUE
dbcbccaddccc	TRUE
dbcbccbcbccc	TRUE
dbcdddbcdadc	TRUE
dbcdddbcdbcb	TRUE
dcccbcdcbcad	TRUE
dcccbcdddbcd	TRUE
ddbcbcaddadc	TRUE
ddbcbcaddadd	TRUE
aaaaaaddbdcd	FALSE
aaaaabcbcccd	FALSE
aacbcccdddaa	FALSE
aacbccdcddda	FALSE
abbacbadccdc	FALSE
abbacbaddaab	FALSE
abddbcddbcca	FALSE
abddbcddccbc	FALSE
acbdddabbcca	FALSE
accaaabbdccd	FALSE
adacdbdadabc	FALSE
adacdbdcacdc	FALSE
addccdcdabab	FALSE
addcdadbcdac	FALSE
bacacabcaaac	FALSE
bacacbbccbac	FALSE
bbacdadccdcc	FALSE
bbacdbadabbd	FALSE
bbcddbddbbcc	FALSE
bbcddcbbabdd	FALSE
bcbcccbcbddd	FALSE
bcbccccbabad	FALSE
bdabaadbcbdc	FALSE
bdabaadcbddd	FALSE
bdcdbacdaadb	FALSE
bdcdbbacaddd	FALSE
cabbabababbd	FALSE
cabbabbbddbd	FALSE
cadcddbaabaa	FALSE
cadcdddcddab	FALSE
cbcaabbbbdbb	FALSE
cbcaacacbcbd	FALSE
ccabcbbaadaa	FALSE
ccabcbcccdbd	FALSE
cccddababdcb	FALSE
cccddbcababa	FALSE
cdbccbbdbdca	FALSE
cdbcccacdbbd	FALSE
daacdddabdcb	FALSE
daadaabbcdbc	FALSE
dadabadbcabd	FALSE
dadabadbcdac	FALSE
dbbbbcabbdad	FALSE
dbbbbcbacaac	FALSE
dbddcddcbbdd	FALSE
dbdddbcabbcb	FALSE
dcccbcbadcbc	FALSE
dcccbdbcdbdd	FALSE
ddbbadacabcc	FALSE
ddbbadbbbbba	FALSE
adadadadadcad	TRUE
adadadadbcada	TRUE
adadccbcadbcd	TRUE
adadccbcbccdd	TRUE
adbcbcadcbcad	TRUE
adbcbcadcbcbc	TRUE
adbcdcdaddcbc	TRUE
adbcdcdbcdcdd	TRUE
adccadcdcdcbc	TRUE
adccaddadbccd	TRUE
addaddcadbcad	TRUE
addaddcbcdadb	TRUE
adddbcbccddcb	TRUE
adddbccadcbca	TRUE
bcadbcdadadcd	TRUE
bcadbcdadaddb	TRUE
bcbcadadcaddd	TRUE
bcbcadadcbcda	TRUE
bcbccdbcccada	TRUE
bcbccdbcccdbc	TRUE
bccbcbcbccdad	TRUE
bccbcbcbcdadb	TRUE
bccdddaddccdd	TRUE
bccdddccdbcbc	TRUE
bcdccaddbccad	TRUE
bcdccbcadadbc	TRUE
cadbcadbcbcbc	TRUE
cadbcadbcbcbc	TRUE
cadddddddadbc	TRUE
cbcadadadbcdb	TRUE
cbcccbcadbcdb	TRUE
cbcccbcadcbcc	TRUE
ccbcadbcbcdbc	TRUE
ccbcadbccadbc	TRUE
ccdbccdbcdada	TRUE
ccdbccdccdada	TRUE
cdcadbcccadcc	TRUE
cdcadbcdbcadd	TRUE
dadaddccadccb	TRUE
dadaddcccbccd	TRUE
daddbcdccdcbc	TRUE
daddbcddadadc	TRUE
dbccadadcdbcc	TRUE
dbccadbcbccdb	TRUE
dcadbcdadbcbc	TRUE
dcadbcdadbccd	TRUE
dccddcadbccad	TRUE
dccdddadadcdc	TRUE
ddbcbcdcdbcdd	TRUE
ddbccadadbcda	TRUE
aaaaaacadaadd	FALSE
aaaaacdbcdbba	FALSE
aaccbcbddbbaa	FALSE
aaccbcdadaacc	FALSE
abbabcaabdcaa	FALSE
abbabcbbacddd	FALSE
abdcacdccddbd	FALSE
abdcadbdbcbaa	FALSE
accbdddadbcca	FALSE
accbdddddcadb	FALSE
adadbbbbadccb	FALSE
adadbbcbdcdcb	FALSE
addbdcdbaadda	FALSE
addbdcdddcaad	FALSE
babdbadbbbcac	FALSE
babdbbdbddadd	FALSE
bbabacaabdbab	FALSE
bbabaccabddbc	FALSE
bbcdbabbaaadc	FALSE
bbcdbabcabcbc	FALSE
bcbcabbccbdcd	FALSE
bcbcabdbccabd	FALSE
bdabadbdddbbb	FALSE
bdabaddacadcd	FALSE
bdccdacbbddba	FALSE
bdccdcaddabbb	FALSE
cabbaacbbdbaa	FALSE
cabbabbcbdbaa	FALSE
cadddddddadaa	FALSE
cbaaaabbdccbd	FALSE
cbccccabaddab	FALSE
cbccccacccbbb	FALSE
ccbaaccccbcdd	FALSE
ccbaaddacddbb	FALSE
ccdbcddbcdcbd	FALSE
ccdbdabaaaadd	FALSE
cdcabccadbddb	FALSE
cdcabdcbddaaa	FALSE
daadcbcacdcdc	FALSE
daadccdbaccbd	FALSE
dadbcbbdcacac	FALSE
dadbccbdbbbad	FALSE
dbcaadcdddbbc	FALSE
dbcababcdaccb	FALSE
dcabbdbbadbdb	FALSE
dcabbdbcacccb	FALSE
dccddcaabbcad	FALSE
dccdddabaccdc	FALSE
ddbbdbdcdcbad	FALSE
ddbbdcbabcadc	FALSE
adadadadadcadc	TRUE
adadadadbcadad	TRUE
adadccccdcdbca	TRUE
adadccdadaddcd	TRUE
adbcbcadcbcadd	TRUE
adbcbcadcbcdca	TRUE
adbcdccbcadbcc	TRUE
adbcdccbcbccda	TRUE
adccbcbcbcdadb	TRUE
adccbcbccadddd	TRUE
addaddcddcaddd	TRUE
addadddbccbcad	TRUE
adddcadddbcdad	TRUE
adddcadddbcddd	TRUE
bcadbcddbcadbc	TRUE
bcadbcddccbcad	TRUE
bcbcadcbcbcddd	TRUE
bcbcadcbccadcc	TRUE
bcbcdadadadcca	TRUE
bcbcdadadadccc	TRUE
bccbccccadbcdc	TRUE
bccbcccdcadcdb	TRUE
bcdadadcdccddb	TRUE
bcdadadcddadbc	TRUE
bcdccbcadbcbcc	TRUE
bcdccbcadcdadd	TRUE
cadbcbcadbcbcb	TRUE
cadbcbcadbcbcd	TRUE
cadddbcadcadcd	TRUE
cadddbcadcbcda	TRUE
cbcccadbcbcadd	TRUE
cbcccadbcdadad	TRUE
ccbcadadadadbc	TRUE
ccbcadadadadcb	TRUE
ccdbcbcadcbcca	TRUE
ccdbcbcbcadadd	TRUE
cdcadcdbcccdad	TRUE
cdcaddbcdbccbc	TRUE
dadadddbcadadd	TRUE
dadadddbcddbcc	TRUE
daddcdbccadbcb	TRUE
daddcdbccdadad	TRUE
dbccadddadddda	TRUE
dbccadddcdcbcc	TRUE
dcadddadbcccad	TRUE
dcadddcadaddbc	TRUE
dcdbcadbcbcbcc	TRUE
dcdbcadbccbccd	TRUE
ddbccbccbcaddd	TRUE
ddbccbccbcbcad	TRUE
aaaaaadcbcadaa	FALSE
aaaaaaddcddaac	FALSE
aaccbcddacbdab	FALSE
aacccabccddcac	FALSE
abbaacbdacddac	FALSE
abbaacdccbbdcb	FALSE
abdcadaaabbcbd	FALSE
abdcbaaabacacd	FALSE
acbddbccbdaccd	FALSE
acbddcaacaddcd	FALSE
adabdcbbabcadd	FALSE
adabdddbadadda	FALSE
addabacaccdccd	FALSE
addabdaaddabcc	FALSE
babbddcdaaadba	FALSE
babbdddaccaaac	FALSE
baddcdbdbbddad	FALSE
baddcddbddbcca	FALSE
bbcbbbdabbaaba	FALSE
bbcbbcbbdcdbcb	FALSE
bcadadbcccabbc	FALSE
bcadbadbcbdabd	FALSE
bcdbbbabcabada	FALSE
bcdbbcbbdccdcb	FALSE
bdbcddabbadacc	FALSE
bdbcddacabbddd	FALSE
caadbccddaadcc	FALSE
caadbddbdbabdc	FALSE
cadaccdbbaadad	FALSE
cadacdcbbbddac	FALSE
cbbccdacadaccd	FALSE
cbbccddcdaddad	FALSE
ccaadbdabaaaab	FALSE
ccaadcbbbaccbb	FALSE
cccddccbbbdbdc	FALSE
cccdddadddabcd	FALSE
cdbaddacbadddc	FALSE
cdbbaabdbabadc	FALSE
cddccadbbadbab	FALSE
cddccccabbccba	FALSE
dacbcdbaaababd	FALSE
dacbdacbbdcccb	FALSE
dbbcdaacbdbcbb	FALSE
dbbcdadadcbcbb	FALSE
dcabdacdadaaca	FALSE
dcabdcadbdcdcd	FALSE
dcdaacdcbabdcb	FALSE
dcdabbbcddcbac	FALSE
ddbbdddccccdbb	FALSE
ddbcaabccacadb	FALSE
adadadadadadadd	TRUE
adadadadadbcbcb	TRUE
adadcadddadbcda	TRUE
adadcbcadbcbcad	TRUE
adbcbcadadbcdda	TRUE
adbcbcadadcadbc	TRUE
adbcdcdaddadbca	TRUE
adbcdcdbcadcbca	TRUE
adccbcadadcccca	TRUE
adccbcadccbcbcc	TRUE
addadcadbcccddb	TRUE
addadcadcadcadb	TRUE
adddadadddadadb	TRUE
adddadbcbcaddbc	TRUE
bcadbccbcdbcdad	TRUE
bcadbcccadbccbc	TRUE
bcbcadadadbcbca	TRUE
bcbcadadaddadca	TRUE
bcbcccadbcccdbc	TRUE
bcbcccadcbcadcc	TRUE
bccbcadcdaddccc	TRUE
bccbcadcdbcdbcb	TRUE
bccdcccadcdbcda	TRUE
bccdccccdcdddad	TRUE
bcdcadddadcddad	TRUE
bcdcbcadadbcadc	TRUE
cadadccdcdadadb	TRUE
cadadccdddbcbcc	TRUE
caddbccadcdccad	TRUE
caddbccbcaddadc	TRUE
cbccadadbccdadb	TRUE
cbccadadcadbcda	TRUE
ccadcadadbcdbcd	TRUE
ccadcadadddaddb	TRUE
ccdadbccadddbcd	TRUE
ccdadbccbcbcbcc	TRUE
cdbcbcccdadcadd	TRUE
cdbcbcdadadadca	TRUE
cdddaddcadbccbc	TRUE
cdddadddcadccbc	TRUE
dadcdbcadcdaddd	TRUE
dadcdbcbcbcaddb	TRUE
dbcbcdbccccdcbc	TRUE
dbcbcdbccdbcdcd	TRUE
dcadccadadcadbc	TRUE
dcadccbcddadadc	TRUE
dccdcdcdbcbcbcd	TRUE
dccddadddbcbcdd	TRUE
ddbccadaddbcbcd	TRUE
ddbccadbccbcadb	TRUE
aaaaaadcbcadaaa	FALSE
aaaaaaddddaaccc	FALSE
aaccccbacdcadbb	FALSE
aacccccacbcadac	FALSE
abaddcabcccabdc	FALSE
abaddcadaaabdbb	FALSE
abdbdacadbcdcba	FALSE
abdbdbbdbaacdcb	FALSE
acbddddbdaabddd	FALSE
accaaaabcacadac	FALSE
adabbbddcdbdbcb	FALSE
adabbdabbdacbdb	FALSE
adcddcbacadabdb	FALSE
adcdddbcdabaacb	FALSE
babcabbbdabadbd	FALSE
babcabccacbbacc	FALSE
bbaaccbcbdbdccc	FALSE
bbaacddbbaadaad	FALSE
bbcbdabaadddaac	FALSE
bbcbdadbadadbdd	FALSE
bcadddadaadbbdd	FALSE
bcadddddddccdaa	FALSE
bcdcbadccdddbad	FALSE
bcdcbbcdbbccdda	FALSE
bdcadccbbabaabd	FALSE
bdcaddbabbbaccb	FALSE
caacdaadcdabdcc	FALSE
caacdacaddadcbc	FALSE
cadbccbccbcbaac	FALSE
cadbdabacddbbdc	FALSE
cbcaabdbbacdbca	FALSE
cbcaaccbddddddd	FALSE
ccabccbbdcaaacd	FALSE
ccabccbcbcccdcb	FALSE
ccdabacdcabccdb	FALSE
ccdabbacdaaaccc	FALSE
cdbbdbdccabbdca	FALSE
cdbbdccabbdddaa	FALSE
cdddacbaadaabdc	FALSE
cdddadbccaaccbd	FALSE
daccdaadddbadcd	FALSE
daccdccbbddcbcc	FALSE
dbcaaadabbabbaa	FALSE
dbcaaadabddddbb	FALSE
dcacbdbcbbdaaac	FALSE
dcacbdcdabcbcca	FALSE
dccdcdcdbcbbbad	FALSE
dccddacddbabadd	FALSE
ddbcaccdcdbbaba	FALSE
ddbcadaadaadcaa	FALSE
adadadadadbccadb	TRUE
adadadadadcadcda	TRUE
adadcbcdadcdadda	TRUE
adadcbcdbcbcbcad	TRUE
adbcaddddccbccbc	TRUE
adbcaddddcdccada	TRUE
adbcdcbcbcdcadcb	TRUE
adbcdcbccbcdcadc	TRUE
adccadbcddbcdcad	TRUE
adccadbcdddadcad	TRUE
addaddadddbccddd	TRUE
addaddcaddddbcbc	TRUE
adddbccdadadadbc	TRUE
adddbcdadbcadcdd	TRUE
bcadbcdcbcadcada	TRUE
bcadbcdccbcaddad	TRUE
bcbcadbcaddddada	TRUE
bcbcadbcbcbcbcbc	TRUE
bcbccccdadbcdccc	TRUE
bcbcccdadbcadbcc	TRUE
bccbcaddadbcadcb	TRUE
bccbcaddadbcbcad	TRUE
bccddadcdadbcada	TRUE
bccddbcadcadadad	TRUE
bcdcadadbcdadcda	TRUE
bcdcadadcaddbcdb	TRUE
cadadccbccadadbc	TRUE
cadadccbccdadcdb	TRUE
caddaddbcadcccbc	TRUE
caddaddcbcadccca	TRUE
cbcbcdaddbcdadcc	TRUE
cbcbcdbcbcccadbc	TRUE
ccadbcdadcdaddca	TRUE
ccadbcddbcaddcdc	TRUE
ccdaddcbcddadbcc	TRUE
ccdaddcccbcadadc	TRUE
cdbcdbcadcbcdadd	TRUE
cdbcdbcaddadccda	TRUE
dadadaddbcadadca	TRUE
dadadaddcbccdcdb	TRUE
dadcccccbcbcdbcd	TRUE
dadcccdcbcccbcdd	TRUE
dbcbcbcaddcdadca	TRUE
dbcbcbcadddbcdcb	TRUE
dbcddadcbcaddccb	TRUE
dbcddadcccbcbcbc	TRUE
dccbcccdadadbcbc	TRUE
dccbccdadadddbca	TRUE
ddbcadbcbcddccbc	TRUE
ddbcadbccaddcada	TRUE
aaaaaaadaaaadbac	FALSE
aaaaaadccbdadcab	FALSE
aacccbbdccaddacb	FALSE
aaccccdcacdbdcbc	FALSE
abbbbbcbdbabcdba	FALSE
abbbbcdbcbbdbddd	FALSE
abdcdddacaccaaad	FALSE
abddaabccabbbadc	FALSE
accbdddadddcddaa	FALSE
acccabdacccaacbd	FALSE
adadacaadbcacbbd	FALSE
adadacaadcadcdca	FALSE
addbbabdccbabbba	FALSE
addbbaccaabdabca	FALSE
babdabcdcacbbacb	FALSE
babdacbdcbbdbcab	FALSE
bbabbcbaaccadadb	FALSE
bbabbccaadbccacb	FALSE
bbcccdabcaddaadc	FALSE
bbcccdccdddbdbad	FALSE
bcadcdabbddbcdba	FALSE
bcadcdbccaaccacc	FALSE
bcdbcdadddccdcbb	FALSE
bcdbdcadbadcccac	FALSE
bdbdbbccdcbbbbcc	FALSE
bdbdbcdbaaadcaca	FALSE
caabcaabcaccabcd	FALSE
caabcababdaabbbb	FALSE
cadaabbdcadbadbd	FALSE
cadaabbddbdbcbbd	FALSE
cbbcdaccdabcbbad	FALSE
cbbcdcbbdaccbbac	FALSE
ccabccdcdbababda	FALSE
ccabccddcbbcdadd	FALSE
ccdaddbbbcddadbc	FALSE
ccdadddcbaabaacb	FALSE
cdbdabccabbcbbad	FALSE
cdbdadabbaacaadc	FALSE
daaadcdadccaaaba	FALSE
daaadcddbbcabbbd	FALSE
dacccbcdadbaddda	FALSE
dacccbddbbcbbcdc	FALSE
dbbbacadabcabdcd	FALSE
dbbbaccbcbbacbac	FALSE
dbdcdbbcdcabdcad	FALSE
dbdcdcacdbacbabc	FALSE
dccbccbaddbcacac	FALSE
dccbcdbbaacddadd	FALSE
ddbaadaaddaabdab	FALSE
ddbabadbbbdbacbb	FALSE
adadadadadbcbcadc	TRUE
adadadadadcadccdb	TRUE
adadccadcdadcadca	TRUE
adadccadcdcbcadbc	TRUE
adbcaddccddbcccad	TRUE
adbcaddcddadccbcb	TRUE
adbcdcaddadbcbcdd	TRUE
adbcdcaddcdcbcbca	TRUE
adccadcadcdccdbcc	TRUE
adccadcbccdcbcbca	TRUE
addaddbcccdccdada	TRUE
addaddbcdadbcaddb	TRUE
adddcadccbcdcdccd	TRUE
adddcaddcddcbcada	TRUE
bcadbccddddadaddc	TRUE
bcadbcdadadadadcd	TRUE
bcbcadbcadadadccc	TRUE
bcbcadbcadbcadadb	TRUE
bcbccddbcbcadbcbc	TRUE
bcbccddbcbcbcbcad	TRUE
bccbcdadcbcdaddda	TRUE
bccbcdbcadcbccbca	TRUE
bcdadbcadddddddcc	TRUE
bcdadbcbcadadadca	TRUE
bcddadadbcaddbcbc	TRUE
bcddadbcaddcdcccd	TRUE
cadbccadccdcaddbc	TRUE
cadbccaddadccbccc	TRUE
cbcadaddcccadbccb	TRUE
cbcadbcadbcddadbc	TRUE
cbccdddcadadadcad	TRUE
cbcdadadadadbcadd	TRUE
ccbccadccaddadcad	TRUE
ccbccadccdbccadad	TRUE
cdadadcbccbcbcadc	TRUE
cdadadccadadadadc	TRUE
cdcdadadadbcbccbc	TRUE
cdcdadadbcbcdbcad	TRUE
dadbcbcadcadcbcdc	TRUE
dadbcbcadcbcdadad	TRUE
daddcccbccadbcbca	TRUE
daddcdadadadcdadd	TRUE
dbccadadbcdddadda	TRUE
dbccadadcddbcbcdd	TRUE
dcadcdcbcbccbcadc	TRUE
dcadcdcdbcadcddcc	TRUE
dcdadadadadadbcdb	TRUE
dcdadadadadbcbccd	TRUE
ddbccaddaddccadca	TRUE
ddbccaddadddbcadc	TRUE
aaaaaadaadbdbcbcd	FALSE
aaaaaddaadbbaaadd	FALSE
aaccbbaabcaabbcbd	FALSE
aaccbbdaaaaccacda	FALSE
abbabacbbdcbdbaad	FALSE
abbabaccbabbdabad	FALSE
abdbaaaaadaaacbcb	FALSE
abdbaaddaaacbdbdc	FALSE
acbddadcccadcaddb	FALSE
acbddbcddccddcaca	FALSE
adacdddddabdcbdbc	FALSE
adadaabccaadbccca	FALSE
addbbcaadbccbbbba	FALSE
addbbccacccddabdb	FALSE
bacadccbadbcdcccb	FALSE
bacaddbcdadbdacbc	FALSE
bbacabcbdaabbdddc	FALSE
bbacabdadabddcaad	FALSE
bbdbcaddbddabbdba	FALSE
bbdbcbabcccacacbc	FALSE
bcbcdabacdaaadbcc	FALSE
bcbcdabdaddabddac	FALSE
bdabaddbdaccabbbb	FALSE
bdabbacdbacabdcbb	FALSE
bddaabcbdcbccccba	FALSE
bddaabccaadbdbadb	FALSE
cabcabdaddabbcbcd	FALSE
cabcadcccaabdbbdd	FALSE
cbabbaacbabcddcca	FALSE
cbabbaaddcbcccdcc	FALSE
cbcddacacacddcbca	FALSE
cbcddccabcbdacdcc	FALSE
ccbccacadaadcbdda	FALSE
ccbccbdbbcbbabbda	FALSE
cdabaacacadbadbca	FALSE
cdabaccdccdaddaaa	FALSE
cdcdabaabadabdbdb	FALSE
cdcdadbadbbddbaac	FALSE
daadcdcbdbacccbdc	FALSE
daadcddbbbacaadaa	FALSE
dadccbbddcccacbcb	FALSE
dadccbcccacbcdcbd	FALSE
dbcbbcaabbaaccccd	FALSE
dbcbbcabdbcbdddaa	FALSE
dcadacbcccccbbbcb	FALSE
dcadadbadcbdaacdd	FALSE
dcdaaaddabcbdbdab	FALSE
dcdaabaadbaadadda	FALSE
ddbbdcbbcaadacddd	FALSE
ddbbddaccdacdacba	FALSE
adadadadadadcdadcc	TRUE
adadadadadaddbcadb	TRUE
adadcbcdadbccdcadb	TRUE
adadcbcdadbcdcbccd	TRUE
adbcbcadbccbcadddd	TRUE
adbcbcadcadadbcbcc	TRUE
adbcddbcadbcbcddca	TRUE
adbcddbcbcbccadada	TRUE
adccbcccadaddadbcb	TRUE
adccbccccadadadcca	TRUE
addaddcdbcdccccadd	TRUE
addadddadddccadbca	TRUE
adddcbcddadcbcadad	TRUE
adddcbcddccbcbcdcd	TRUE
bcadcbcbcccdadcddc	TRUE
bcadcbcbccdaddbcad	TRUE
bcbcaddadadcddadcc	TRUE
bcbcaddadaddcbcadc	TRUE
bcbcdadcddcdadcadc	TRUE
bcbcdaddadbcadcddb	TRUE
bccbcdadadadcddcda	TRUE
bccbcdadadcbccbcad	TRUE
bcdadbcadcadcbcdad	TRUE
bcdadbcadcbcadbcbc	TRUE
bcdcddadcbcdbccdad	TRUE
bcdcddaddbcdbcbcad	TRUE
cadbcadcdbcdcadada	TRUE
cadbcaddbcccbcadad	TRUE
cadddbcadbcbcdcadc	TRUE
cadddbcadcadadadbc	TRUE
cbccbcadcdbcdadbcd	TRUE
cbccbcbccadbcdbcbc	TRUE
ccadddadcadbcdbcbc	TRUE
ccadddbcbcddcdaddb	TRUE
ccdcbcbccdcddbccca	TRUE
ccdcbcbcdbccddddad	TRUE
cdcbcaddcdcadadadd	TRUE
cdcbcbcadbcbcdcadc	TRUE
dadadcbcccdbcbcadd	TRUE
dadadcbcdadbccadcc	TRUE
dadcdbcadcadadaddc	TRUE
dadcdbcbcadcccadad	TRUE
dbcbcbcddcdddcdadb	TRUE
dbcbccadadcbccadbc	TRUE
dcadbcadcadadbcbcb	TRUE
dcadbcadcadcddcadc	TRUE
dcccdbcddadddbcdcc	TRUE
dcccddcdcddcccadbc	TRUE
ddbcaddbccbcaddadd	TRUE
ddbcaddcadcdddadbc	TRUE
aaaaaaaccabddabcda	FALSE
aaaaaacdaacdddacbd	FALSE
aacccadbccbcbbaacc	FALSE
aacccaddcdbdbccbcb	FALSE
abaddadcbbbacccabb	FALSE
abaddbbcbcbddabccc	FALSE
abddabbddcdcdcabca	FALSE
abddabccadcaacbacd	FALSE
accadaaaadcdddcabd	FALSE
accadaabcbaabbdccb	FALSE
adacbbbcbbbaaccbac	FALSE
adacbcbabcbbcaccbd	FALSE
addbcddabccbdcccda	FALSE
addbdbbcbbadbddbdb	FALSE
babddcdbbbaccdbaad	FALSE
bacaaaccccddbbacac	FALSE
bbacabbbbcacdabaac	FALSE
bbacaccbbdacdbacbd	FALSE
bbdaadbaaddcabdbda	FALSE
bbdabacdcacabcabdd	FALSE
bcbdcabbdcadccacbd	FALSE
bcbddadcddcbdbbddd	FALSE
bdabbcaaadbddaaaba	FALSE
bdabbcacdcdccaddbb	FALSE
bdcdbdcbdcbcdaccca	FALSE
bdcdbddbbadaabaaca	FALSE
cabbccadddbcaaaddd	FALSE
cabbcccadadaaabbcc	FALSE
caddadbabbbcaacbda	FALSE
caddadbdcdbacdccac	FALSE
cbcbbdcddcadabbaba	FALSE
cbcbcabadcadccbbda	FALSE
ccadcdbaaabcadacab	FALSE
ccadcdbbddccbaadcb	FALSE
ccdcbaddacdbaacddc	FALSE
ccdcbbabcbdabbdcdd	FALSE
cdcbabacacbbacbddd	FALSE
cdcbabbbabacbcbbbc	FALSE
daaccbaddbdcdbadba	FALSE
daaccbcbcdbbababba	FALSE
dadacdbdbaaaaabadb	FALSE
dadadaadaaddbdcadb	FALSE
dbbcdddbcaabcbbbac	FALSE
dbbdadaacbdbccdbbd	FALSE
dcaadbbacbdddcbbab	FALSE
dcaadbdcbbbbdddbdd	FALSE
dcccdbdddadddbddcc	FALSE
dcccddcdcddcccadab	FALSE
ddbbabbadcdadbbdab	FALSE
ddbbadbabcdcbdaadb	FALSE
adadadadadbcbcbcbcc	TRUE
adadadadadbcdaddbcd	TRUE
adadcddddccdbcadbca	TRUE
adaddadadbcddbccdad	TRUE
adbcbccccdcbcaddadb	TRUE
adbcbccccdcdaddadad	TRUE
adcadbcadcadcbcbcbc	TRUE
adcadbcbcadddcaddbc	TRUE
adcccccaddddcbcbcca	TRUE
adccccddbcbcdcccadd	TRUE
addbcadddcccadccbca	TRUE
addbcadddcdddadbcad	TRUE
adddcaddcadbcadadcd	TRUE
adddcbcadadadcbcdca	TRUE
bcadcbcadadcccddcdd	TRUE
bcadcbcadbcaddbccbc	TRUE
bcbcaddcbcaddcbccdb	TRUE
bcbcaddcbccadddddca	TRUE
bcbcdbcaddcbcddccad	TRUE
bcbcdbcaddddcccadbc	TRUE
bcccadcbcadadbcdadc	TRUE
bcccadcbcadbcbccbca	TRUE
bcdaddadddcdbcaddbc	TRUE
bcdaddbcadbcccadadb	TRUE
bcddbcbcddaddcbcadd	TRUE
bcddbccaddbcadcadad	TRUE
cadbcdadbccbcbcdbca	TRUE
cadbcdaddadccaddbcd	TRUE
cbcadadbcbccdbcdadb	TRUE
cbcadadbcbcdadcbccc	TRUE
cbcccadcadcddbcbcad	TRUE
cbcccadcbcbcdbcdcad	TRUE
ccbcadddcadaddbcdcb	TRUE
ccbcbcadbccadbcadad	TRUE
ccdcadcdaddddadbccb	TRUE
ccdcadddddcadcbcccb	TRUE
cdcadcadbcadcdbcbcb	TRUE
cdcadcdddccbcdddbcb	TRUE
dadadcbcdcadadadada	TRUE
dadadccadccaddadccb	TRUE
daddbccbcdadbccddbc	TRUE
daddbccddbcbcbcdcca	TRUE
dbccadbccbcbcbcbccd	TRUE
dbccadbcccadbcddadc	TRUE
dcadbcdbcdaddcbcccc	TRUE
dcadbcddaddddadbcdb	TRUE
dccdddccdcadbcddcad	TRUE
dcdadadadbcadbcadbc	TRUE
ddbcccdccadbccddadc	TRUE
ddbccdbccccadbcaddd	TRUE
aaaaadadadbddcddcbb	FALSE
aaaaadcaaaacdbbbcdc	FALSE
aacdadcabbdbdbaacbc	FALSE
aacdbbadaaddcacbacc	FALSE
abbbbcdccdacabcbcac	FALSE
abbbcbaacabbadddddc	FALSE
abdddaaaddcdbacdbcd	FALSE
abdddabdcbbadcaacbd	FALSE
acccdacbbccccdddbdb	FALSE
acccdadabbabacabadd	FALSE
adbbcccccdddacacbba	FALSE
adbbcdbdabccddaccdd	FALSE
adddadbcccdbccbacad	FALSE
adddbadcddbaacdddbd	FALSE
baccbcbcbbacbccadbd	FALSE
baccbccbddbcdbdcdab	FALSE
bbbbadadccbdaaacdbd	FALSE
bbbbadccaccddddcbac	FALSE
bbdbdbabbcdaddcccba	FALSE
bbdbdcbbcaacbdacada	FALSE
bcbdaaabbbcbcdabadc	FALSE
bcbdabcdadacbaccdbd	FALSE
bdaaabdbaabacbbadab	FALSE
bdaaadbbdcdacbbdada	FALSE
bdcddccdddcccabbacb	FALSE
bdcddcddcbacdbcacba	FALSE
cabcbdcbbdbddbabdca	FALSE
cabcbddcdaddcbdaaac	FALSE
cbaacadbaadaddccaac	FALSE
cbaacbcababaabddddb	FALSE
cbcdbaabddbcaabbcbd	FALSE
cbcdbaaddbaddadcdbc	FALSE
ccbbabababaccdddbba	FALSE
ccbbabbbbabccccdbaa	FALSE
ccddacadccdbddcddcb	FALSE
ccddacdcaacadadccab	FALSE
cdcbdddacacbbacccad	FALSE
cdccaaacdbbcdacbcba	FALSE
dabaacacabcacdddbdc	FALSE
dabaadcdbbbcbdbbcac	FALSE
dadcccbaaddcbcbcabb	FALSE
dadcccbbdaadddbdbdc	FALSE
dbcacbddcdbabbabcac	FALSE
dbcaccadaccbaaadddd	FALSE
dcacaccccabadbbbdab	FALSE
dcacadadbdbcddcadcd	FALSE
dccddbdcdbbbdbbdaad	FALSE
dccddcbcccabdbdbbbd	FALSE
ddbbcddbaabddcdabad	FALSE
ddbbdacdaabddbacdbd	FALSE
