adadadadad	TRUE
adadadadad	TRUE
adadccbddc	TRUE
adadccbddd	TRUE
adbadddddc	TRUE
adbbadadad	TRUE
adbdcadbad	TRUE
adbdcadcad	TRUE
adccadcdad	TRUE
adccaddada	TRUE
addadddcdb	TRUE
addbadadda	TRUE
adddbcadcb	TRUE
adddbcadcd	TRUE
badbdccbbb	TRUE
badbdcccad	TRUE
bbadbcaddb	TRUE
bbadbcaddd	TRUE
bbcdbadada	TRUE
bbcdbbbbdd	TRUE
bcbbdbbdbd	TRUE
bcbbdbdadb	TRUE
bcddddbadc	TRUE
bcdddddadc	TRUE
bdcbdcdbdc	TRUE
bdccaddbba	TRUE
cadbadadcd	TRUE
cadbadbcbb	TRUE
cadddadbba	TRUE
cadddadcad	TRUE
cbcbbdccad	TRUE
cbcbcadada	TRUE
ccadccbcbc	TRUE
ccadccdadd	TRUE
ccdccbcadc	TRUE
ccdccbdbad	TRUE
cdcadadcba	TRUE
cdcadaddbb	TRUE
dadadbcada	TRUE
dadadbccad	TRUE
daddadcbba	TRUE
daddadccbb	TRUE
dbbccbddad	TRUE
dbbcccbcad	TRUE
dcadadadbb	TRUE
dcadadbbbb	TRUE
dcccbbcada	TRUE
dcccbcadcc	TRUE
ddbbcadbad	TRUE
ddbbcbcccd	TRUE
aaaaacaaba	FALSE
aaaabcbcdd	FALSE
aaccdbadda	FALSE
aaccdbcdbc	FALSE
abbbbccbdc	FALSE
abbbbcdbad	FALSE
abdbdcdaab	FALSE
abdbddabac	FALSE
accbaadbaa	FALSE
accbababcc	FALSE
adacdcbdac	FALSE
adadaacaca	FALSE
addbccbacd	FALSE
addbcdaccd	FALSE
babdbccbba	FALSE
babdbcdabc	FALSE
bbabcbbcab	FALSE
bbabcbcaac	FALSE
bbcdbadaaa	FALSE
bbcdbbbbac	FALSE
bcbbdbbdac	FALSE
bcbbdbdacb	FALSE
bcddddbaac	FALSE
bcdddddaac	FALSE
bdcbdcdbab	FALSE
bdccaddbaa	FALSE
cabaadbcbc	FALSE
cababaaccb	FALSE
caddacbddc	FALSE
caddadabdb	FALSE
cbcbbdccab	FALSE
cbcbcaadac	FALSE
ccacbccccb	FALSE
ccacbcdabc	FALSE
ccdccbcaac	FALSE
ccdccbdbaa	FALSE
cdcaacadab	FALSE
cdcaadabdb	FALSE
daacbcabcb	FALSE
daacbcbbbb	FALSE
dadabacccc	FALSE
dadabadbcb	FALSE
dbbccbddac	FALSE
dbbcccbcaa	FALSE
dcaaadaccb	FALSE
dcaaaddaab	FALSE
dcccbbcaba	FALSE
dcccbcaccc	FALSE
ddbbcadbaa	FALSE
ddbbcbccac	FALSE
adadadadadb	TRUE
adadadadadb	TRUE
adadccbccdd	TRUE
adadccbdcca	TRUE
adbaddcadad	TRUE
adbaddcadad	TRUE
adbdcaddadc	TRUE
adbdcbadadd	TRUE
adccadddccd	TRUE
adccbadadcb	TRUE
addaddadbbc	TRUE
addaddadbdb	TRUE
adddbaddcad	TRUE
adddbbbadcc	TRUE
badbcdcbadb	TRUE
badbcdccadb	TRUE
bbadbdadbda	TRUE
bbadbdaddad	TRUE
bbdadbdadad	TRUE
bbdadbddbbc	TRUE
bcbdbdbbbcc	TRUE
bcbdbddcdca	TRUE
bdadaddadad	TRUE
bdadaddadca	TRUE
bdcbcdddadc	TRUE
bdcbcdddadd	TRUE
cadbbbbbada	TRUE
cadbbbcadbd	TRUE
caddcccadcb	TRUE
caddcccbcca	TRUE
cbcbadbbbad	TRUE
cbcbaddadbc	TRUE
ccbadbadddc	TRUE
ccbadbcadba	TRUE
ccdcbbcdadc	TRUE
ccdcbbdadbc	TRUE
cdbdcbbddcc	TRUE
cdbdccaddbc	TRUE
dadadcbadda	TRUE
dadadcbcadc	TRUE
daddbbcdcbc	TRUE
daddbcadbcc	TRUE
dbbddadbdbc	TRUE
dbbdddcbccc	TRUE
dcadbddadad	TRUE
dcadcadadbd	TRUE
dccdbaddbad	TRUE
dccdbbbcbbc	TRUE
ddbcbcdaddc	TRUE
ddbcbcdcbdb	TRUE
aaaaacaabad	FALSE
aaaabacddbb	FALSE
aaccdcccada	FALSE
aaccdccdddc	FALSE
abbbabbddda	FALSE
abbbabcdaad	FALSE
abdcbccdbcc	FALSE
abdccaacbda	FALSE
accadbbddcd	FALSE
accadbcdaaa	FALSE
adadabaccca	FALSE
adadacbacbc	FALSE
addbbcbdaaa	FALSE
addbbdbcabb	FALSE
babcddaaada	FALSE
babdabadcba	FALSE
bbacadccabb	FALSE
bbacadcccdb	FALSE
bbdacacdddb	FALSE
bbdacacdddc	FALSE
bcbdbdbbbab	FALSE
bcbdbddcdaa	FALSE
bdaacdcbdca	FALSE
bdaadacdbba	FALSE
bdcbcdddaac	FALSE
bdcbcdddabb	FALSE
cabadbbbbbc	FALSE
cabadbbccbb	FALSE
cadcbdaddaa	FALSE
cadccbaacaa	FALSE
cbcbacacbba	FALSE
cbcbadaacbc	FALSE
ccbabaadada	FALSE
ccbabacdddd	FALSE
ccdcbbcdacc	FALSE
ccdcbbdabbc	FALSE
cdbdcbbddab	FALSE
cdbdccabdbc	FALSE
daacbdcdacb	FALSE
daaccabbbca	FALSE
dadadcbaada	FALSE
dadaddbbdab	FALSE
dbbddacbdbc	FALSE
dbbdddcbcab	FALSE
dcabdbdbcaa	FALSE
dcabdcbcaca	FALSE
dccdbacdbac	FALSE
dccdbbbcbab	FALSE
ddbcbcdabdc	FALSE
ddbcbcdcbab	FALSE
adadadadadbc	TRUE
adadadadadbd	TRUE
adadccbdaddc	TRUE
adadccbddbcc	TRUE
adbadddbadad	TRUE
adbadddbcdda	TRUE
adbdbdbbadbc	TRUE
adbdbdbbbdad	TRUE
adccadcdadba	TRUE
adccaddbbcba	TRUE
addaddbccdbd	TRUE
addaddbcdcdd	TRUE
adddbcdadbbb	TRUE
adddbcddbcdd	TRUE
badcadbadcbd	TRUE
badcadbcdcbc	TRUE
bbadcadaddad	TRUE
bbadcadbadad	TRUE
bbcdccbccadd	TRUE
bbcdccdbadad	TRUE
bcbcbadadadd	TRUE
bcbcbadadcdb	TRUE
bdadadbddadd	TRUE
bdadadcadada	TRUE
bdccbadaddcb	TRUE
bdccbaddadad	TRUE
cadbadbdddcb	TRUE
cadbadcadadd	TRUE
cadddccbaddd	TRUE
cadddccbbddd	TRUE
cbcbcadddddb	TRUE
cbcbcbbcbccd	TRUE
ccaddbbadddb	TRUE
ccaddbbdadda	TRUE
ccdbcbcadadc	TRUE
ccdbcbcdadca	TRUE
cdbdbaddddad	TRUE
cdbdbbcadbdc	TRUE
dadadbdccbad	TRUE
dadadbdcccda	TRUE
daddbadbdccc	TRUE
daddbadcbcad	TRUE
dbbcdaddadda	TRUE
dbbcdbdcccbb	TRUE
dcadadcadadc	TRUE
dcadadcbaddd	TRUE
dccbdaddadad	TRUE
dccbdbbbadca	TRUE
ddbbbbadaddc	TRUE
ddbbbbddbbcc	TRUE
aaaaaaaaccdc	FALSE
aaaaabaddcbc	FALSE
aacccabdcbac	FALSE
aacccacddccd	FALSE
abbcaaacbcbb	FALSE
abbcbadcbadb	FALSE
acaaacaabcdd	FALSE
acaaacccbbca	FALSE
accbddccdcad	FALSE
acccaaaddcdc	FALSE
adbaaddacdcd	FALSE
adbababadbdc	FALSE
addbddadcbab	FALSE
addbddccaabd	FALSE
babdcbcdabba	FALSE
babdccbddada	FALSE
bbacccbddacc	FALSE
bbaccccabacb	FALSE
bbdacaaddbdd	FALSE
bbdacbdddddc	FALSE
bcbcdbddabca	FALSE
bcbcdcbacbdb	FALSE
bdaabbbbccdb	FALSE
bdaabdaaabdd	FALSE
bdccdaadbdbc	FALSE
bdccdacabacc	FALSE
cabaccadabdb	FALSE
cabadaacabcd	FALSE
caddacdadabd	FALSE
caddacdadddc	FALSE
cbcadaabaaad	FALSE
cbcadadacaad	FALSE
ccacbdbdadda	FALSE
ccaccabcbada	FALSE
ccdbbabddaba	FALSE
ccdbbadbcbab	FALSE
cdbdccbcabcc	FALSE
cdbdccdcccaa	FALSE
daacaadcdcba	FALSE
daacacdbddaa	FALSE
dadabcadabba	FALSE
dadabccdaaab	FALSE
dbbccacbbdda	FALSE
dbbccadacbcd	FALSE
dcaababcadcd	FALSE
dcaabacacaad	FALSE
dcccaacbdbaa	FALSE
dcccaadcbacb	FALSE
ddbbaddaabdd	FALSE
ddbbbadcdbab	FALSE
adadadadadadc	TRUE
adadadadadccd	TRUE
adadccccbbcdb	TRUE
adadcccdcbcda	TRUE
adbadddcdcdad	TRUE
adbaddddcadad	TRUE
adbdbddaddadb	TRUE
adbdcadbaddad	TRUE
adccaddbcbcba	TRUE
adccaddbccdbb	TRUE
addadddadbbad	TRUE
addadddadbbad	TRUE
adddbadadbcad	TRUE
adddbadcaddca	TRUE
badbdbddcadcc	TRUE
badbdcdaddbbc	TRUE
bbadbddcddbdb	TRUE
bbadcadadadcd	TRUE
bbcdbbadadada	TRUE
bbcdbbcbccadd	TRUE
bcbbbcadadcba	TRUE
bcbbcdaddcdcb	TRUE
bcddbddadadad	TRUE
bcddbddcbadba	TRUE
bdccaddbddadc	TRUE
bdccbbadcbbda	TRUE
cadbaddbdadba	TRUE
cadbadddadddd	TRUE
cadddcbdcddad	TRUE
cadddcdcaddbd	TRUE
cbcccaddbdcba	TRUE
cbcccbbaddada	TRUE
ccadddbaddadc	TRUE
ccadddcbdaddc	TRUE
ccdcadadcddad	TRUE
ccdcadcdcbadb	TRUE
cdbdcdbddcbad	TRUE
cdbdcdcadaddb	TRUE
dadadcaddadba	TRUE
dadadcbcdbccb	TRUE
daddadcddcada	TRUE
daddaddbbdadd	TRUE
dbbcbadadcbcc	TRUE
dbbcbadcbbdbc	TRUE
dcadbbdadccba	TRUE
dcadbbdbbadad	TRUE
dcdadadaddcbd	TRUE
dcdadadbaddda	TRUE
ddbcddbdadcdd	TRUE
ddbcddcddccba	TRUE
aaaaaaaaccdcb	FALSE
aaaaabddcbcac	FALSE
aacccbcbcbcdc	FALSE
aacccbdccdbcd	FALSE
abbcaaaaccdcc	FALSE
abbcaaaccabbb	FALSE
acaaaccadcbbc	FALSE
acaaacddabbcd	FALSE
acccabacacddb	FALSE
acccabdcaccba	FALSE
adadddaddcbab	FALSE
adbaaabbbbbbc	FALSE
addbbcbdabbbb	FALSE
addbbcccadbab	FALSE
babcccacbdcbb	FALSE
babccccdcadbb	FALSE
bbabddbacccbb	FALSE
bbacaacdbbbac	FALSE
bbcdbbabaaaaa	FALSE
bbcdbbcbccacd	FALSE
bcbbbcabadcba	FALSE
bcbbcdaddcdab	FALSE
bcddbddadaaac	FALSE
bcddbddcbadaa	FALSE
bdccadadddaac	FALSE
bdccbbaccbbda	FALSE
cabbbdaacdcaa	FALSE
cabbbdcdabaad	FALSE
caddbdddaacdd	FALSE
caddcadabacac	FALSE
cbcccabcbdcba	FALSE
cbcccbbaddaca	FALSE
ccaddabcacdca	FALSE
ccaddbabbcbad	FALSE
ccdcabddaddda	FALSE
ccdcadcdcbaab	FALSE
cdbdcdbddcbac	FALSE
cdbdcdcacaadb	FALSE
daacacbbacbcc	FALSE
daacbdbbadadb	FALSE
dadbaaacddadb	FALSE
dadbaabccdcdc	FALSE
dbbcbaadadcbc	FALSE
dbbcbacbbbdbc	FALSE
dcacaabcbcacc	FALSE
dcacacaddabbc	FALSE
dcdaabbddcabd	FALSE
dcdabaadbbdda	FALSE
ddbcddbdaccdd	FALSE
ddbcddcddccaa	FALSE
adadadadadadad	TRUE
adadadadadbadb	TRUE
adadcccadddadc	TRUE
adadccccbcdcba	TRUE
adbbbbdbcdbbad	TRUE
adbbbbdcbadcad	TRUE
adbddcdbcdadad	TRUE
adbdddaddbddcd	TRUE
adcccbcdadcadd	TRUE
adcccbdadadbad	TRUE
addbadccbbdcad	TRUE
addbadcdcbbadd	TRUE
adddbbddbcbbdc	TRUE
adddbcbbdbbbca	TRUE
badcadadbdbdbd	TRUE
badcadaddadada	TRUE
bbadbccbbbbccb	TRUE
bbadbccdbbdcad	TRUE
bbdadcadcbdadd	TRUE
bbdadcdbadddcd	TRUE
bcbdadbadcaddc	TRUE
bcbdaddccbadad	TRUE
bdadbccdcbadbb	TRUE
bdadbccdcdcadc	TRUE
bddadadbccdcbb	TRUE
bddadadcadcbdc	TRUE
cadbcdcadadbad	TRUE
cadbcddbadbcbb	TRUE
cbadbadadadcad	TRUE
cbadbadadcbbda	TRUE
cbcccbbbcaddbd	TRUE
cbcccbcbadadcc	TRUE
ccbcadcadcadda	TRUE
ccbcadcbbbbcbb	TRUE
cdadadcadcdada	TRUE
cdadadcbcddada	TRUE
cdcccbbadbaddd	TRUE
cdcccbbbcaddcc	TRUE
dadaddadddbccc	TRUE
dadaddbadadadc	TRUE
daddadcadddbcd	TRUE
daddadccadccbd	TRUE
dbbccdbdbadbbc	TRUE
dbbccdccbccadb	TRUE
dcadbbbadbcdad	TRUE
dcadbbbbdcccdc	TRUE
dcccdbdddaddca	TRUE
dcccdcaddddbad	TRUE
ddbbbbdcadbbcc	TRUE
ddbbbcadcbdadd	TRUE
aaaaacccacabba	FALSE
aaaaadacbbaddb	FALSE
aaccbacacbdbda	FALSE
aaccbbdbbbcddd	FALSE
abbbcaadddbcdd	FALSE
abbbcbbdacdacd	FALSE
abddaabdabaacb	FALSE
abddabdddabcbc	FALSE
accbccdcbdcdcc	FALSE
accbdbacbdcccd	FALSE
adadabcabcbadc	FALSE
adadadaadbbbcc	FALSE
addadbcbabdaad	FALSE
addadbcbcadaad	FALSE
bacaaadcbdaacd	FALSE
bacaabcdaaadba	FALSE
bbacaadcacdccd	FALSE
bbacacaabdadac	FALSE
bbdacadcaaaabc	FALSE
bbdacbbdacbacd	FALSE
bcbdabbbaacabd	FALSE
bcbdadaccbacad	FALSE
bdabbacdabdcbd	FALSE
bdabbbbdadaacc	FALSE
bddaaacdabacbc	FALSE
bddaaadddacadd	FALSE
cabdaabcdcabcb	FALSE
cabdaaddbaabad	FALSE
cbaacdbddcacaa	FALSE
cbaacddbbdaadb	FALSE
cbcccbbbcabdbd	FALSE
cbcccbcbadabcc	FALSE
ccbcacbdcbdcad	FALSE
ccbcaccdcbbbcb	FALSE
cdaacaddcbcbcb	FALSE
cdaacbcadbacdc	FALSE
cdcccbbadbabdd	FALSE
cdcccbbbcaadcc	FALSE
dabababdbabcab	FALSE
dababaddcabbbc	FALSE
dadaddbdbdcbab	FALSE
dadadddaddacdc	FALSE
dbbccdbdbadbab	FALSE
dbbccdccbccaab	FALSE
dcabcddadccdcc	FALSE
dcabdaacabbaad	FALSE
dcccdbdddaadca	FALSE
dcccdcabdddbac	FALSE
ddbbbbdcadbbab	FALSE
ddbbbcadcbdaad	FALSE
adadadadadadadc	TRUE
adadadadadbbbad	TRUE
adadcccadaddcdc	TRUE
adadcccadbdbdcd	TRUE
adbbbbcbdcdbadd	TRUE
adbbbbcdadadbbd	TRUE
adbdddbcbadadad	TRUE
adbdddbcbcdbcbc	TRUE
adcccbaddcdcbcc	TRUE
adcccbbcbadbcbd	TRUE
addbadbdadcadbc	TRUE
addbadcadaddadb	TRUE
adddbcbccadbddd	TRUE
adddbcbdcbadadb	TRUE
badbdcbadcbccbd	TRUE
badbdcbbadadada	TRUE
bbadcadbcadaddb	TRUE
bbadcadbccbbbad	TRUE
bbdadaddbadcada	TRUE
bbdadbadcbdadad	TRUE
bcbdccccadadadc	TRUE
bcbdcdadcbadadb	TRUE
bdadcbcadadbcad	TRUE
bdadcbddcbadbcc	TRUE
bddadadcbadddbb	TRUE
bddadaddaddcbbd	TRUE
cadbcccdadadcda	TRUE
cadbccdaddcadcd	TRUE
cadddddaddcadbd	TRUE
cbadadadadbdbbd	TRUE
cbcbdadadaddbad	TRUE
cbcbdaddadaddcd	TRUE
ccbadbcadcbcdcc	TRUE
ccbadbcbadaddad	TRUE
ccddcccbbcbcbdb	TRUE
ccddcdbbadbcdcd	TRUE
cdcbcdbddaddcad	TRUE
cdcbcddbdbbbbdb	TRUE
dadbadadbaddbcc	TRUE
dadbadadbbbdcdc	TRUE
daddcbadcdddcca	TRUE
daddcbcccadcccb	TRUE
dbbdcdcaddcadca	TRUE
dbbddadbadbdada	TRUE
dcadbdcccbbadad	TRUE
dcadbdddcbbdcad	TRUE
dccddadadccadbd	TRUE
dccddadbccbdcca	TRUE
ddbbdbcaddbdcca	TRUE
ddbbdbcbadccada	TRUE
aaaaaaabbbdccdc	FALSE
aaaaaabbdcdaacb	FALSE
aacdccbbdcbadcd	FALSE
aacdcdabbbbbaab	FALSE
abbbcdcdabddaad	FALSE
abbbdbabccccdaa	FALSE
acaaddacbaaccbc	FALSE
acabaaaadbddaaa	FALSE
accdbbadbccabac	FALSE
accdbbcabbdaabd	FALSE
adbbccacdddcaad	FALSE
adbbccbdcacacad	FALSE
addcbccbccbbdac	FALSE
addccacdaabddca	FALSE
bacabacdaabbdda	FALSE
bacabadcccadbbc	FALSE
bbabdacbcddcdad	FALSE
bbabdadddddadcb	FALSE
bbdbacdcdbddcba	FALSE
bbdbbaaacabbabc	FALSE
bcbcaaabbcdacdb	FALSE
bcbcaaacbcdbadb	FALSE
bdaabcaadaadcda	FALSE
bdaabcabdaaadab	FALSE
bdcddbacccccdca	FALSE
bdcddbcadccacba	FALSE
cabcbbacbdacdaa	FALSE
cabcbbbdbccccdc	FALSE
caddbabdbdbcadd	FALSE
caddbadabcbbddc	FALSE
cbcaddcadadbacc	FALSE
cbcaddcbadbcabc	FALSE
ccadcbbbadabcbd	FALSE
ccadccbbcabbdca	FALSE
ccdbacdddadcccc	FALSE
ccdbadacdcbdcad	FALSE
cdbcdbdcddababa	FALSE
cdbcdcabbdcadbd	FALSE
daacccabbbbadab	FALSE
daacccacabccbac	FALSE
dadbbcccbcdccab	FALSE
dadbcacaaacaadd	FALSE
dbbcddcdaccbcba	FALSE
dbbcdddabdaaaaa	FALSE
dcaacdbcaacbcbb	FALSE
dcaacdbcbbbbbdb	FALSE
dccdccaccbccccc	FALSE
dccdccccdcaacbc	FALSE
ddbbccdcadadcab	FALSE
ddbbdbdbcdaadcb	FALSE
adadadadadadadad	TRUE
adadadadadbbaddd	TRUE
adadcbcaddadadda	TRUE
adadcbcbadddadca	TRUE
adbbadbcbadadcad	TRUE
adbbadbcdbcadbad	TRUE
adbddadbadcddbba	TRUE
adbddadbbddddbbd	TRUE
adccbadddbadcddb	TRUE
adccbbbccadcadba	TRUE
addaddccadadaddb	TRUE
addaddccaddcadcb	TRUE
adddcbcadbdbcdad	TRUE
adddcbccdadadadc	TRUE
badcadcbbbadadbd	TRUE
badcadcbbcadaddc	TRUE
bbadccdadbdbdcdb	TRUE
bbadcdadadcdcddc	TRUE
bbdbadbbcbdadada	TRUE
bbdbadbbddccadbc	TRUE
bcbdbcccaddcadad	TRUE
bcbdbcccadddbbdb	TRUE
bdadcbccbadcdbad	TRUE
bdadcbdccbadcadb	TRUE
bddadadcadcdcadb	TRUE
bddadadcbddadadd	TRUE
cadbcdadadadbdbb	TRUE
cadbcdcadbbccddc	TRUE
cbadadbadadbdcad	TRUE
cbadadbadadddadd	TRUE
cbccbadaddadbbdc	TRUE
cbccbadbbdadcdda	TRUE
ccadddadadbbdadb	TRUE
ccadddadbccddbda	TRUE
ccdbaddccdcadadd	TRUE
ccdbbadbadccadcb	TRUE
cdcadadadbaddbbc	TRUE
cdcadadaddbadadc	TRUE
dadadcdadadadada	TRUE
dadadcdadadbcdad	TRUE
daddadadcadadcad	TRUE
daddadbbccdcddcb	TRUE
dbbdadbdcaddccbd	TRUE
dbbdaddadbdbbcbc	TRUE
dcadbbcbcdbdaddb	TRUE
dcadbbccadbadcad	TRUE
dccdbdcadddbadba	TRUE
dccdbdcdcadcbccb	TRUE
ddbaddccaddccdca	TRUE
ddbaddccbbdadcad	TRUE
aaaaaadddbadbdad	FALSE
aaaaabaadaaaccbb	FALSE
aaccdabccbbcbaab	FALSE
aaccdadaddacdcda	FALSE
abbabbcbaccdcddb	FALSE
abbabcbaaacaadbd	FALSE
abddbcbdcbddaaca	FALSE
abddbcdcbdcaadbd	FALSE
acccbadcaabccadc	FALSE
acccbadcdddcbcdc	FALSE
adbabccddcccbcac	FALSE
adbabdcabababbab	FALSE
addbddcccbaabbba	FALSE
addcabbdcabbcaba	FALSE
bacacccdabbbacaa	FALSE
bacadbdcdcabcbba	FALSE
bbadbaacbacbcabb	FALSE
bbadbaadcbaddcad	FALSE
bbdaadcbbabaccbb	FALSE
bbdaadcccdcdbaad	FALSE
bcbcccdadcddadac	FALSE
bcbccdcacadcdadc	FALSE
bdaadcabdbbacccc	FALSE
bdaadcadabdcbbbc	FALSE
bdcdbdbcccbbadaa	FALSE
bdcdcadabaacccac	FALSE
cabbcaababcaddac	FALSE
cabbcacddddcddca	FALSE
caddaacdddaccccc	FALSE
caddaccccddccada	FALSE
cbcbbbddbbbbcaad	FALSE
cbcbbbddbbbbddab	FALSE
ccbbabaaabccdcbd	FALSE
ccbbabbbdbcdbadc	FALSE
cdaabacabcdaacdb	FALSE
cdaabbccadcdbaaa	FALSE
cdcbdacadaadbadd	FALSE
cdcbdcccddcbddab	FALSE
dabacbcbbacbadcc	FALSE
dabaccdddbdabada	FALSE
dadcbcacaccacacd	FALSE
dadcbdcdacdbcdac	FALSE
dbcaccabbaaadbcc	FALSE
dbcaccbabcaaacbb	FALSE
dcaddcaccdcbadda	FALSE
dcadddcbdcbdcdaa	FALSE
dcdbadccdcddbbac	FALSE
dcdbbabaadaacdac	FALSE
ddbdabcaacaaadaa	FALSE
ddbdacccadcbdbdc	FALSE
adadadadadbadcdcc	TRUE
adadadadadbdbbcdd	TRUE
adadcdbdadbcbadbd	TRUE
adadcdbdbdbadcbcc	TRUE
adbbadddadcadbcad	TRUE
adbbaddddbdbbdadc	TRUE
adbddbccadadadadb	TRUE
adbddbcddadcaddad	TRUE
adcccaddadadadbad	TRUE
adcccbaddcccbaddc	TRUE
addadddbdbbbdbadc	TRUE
addbadadadadbbbad	TRUE
adddcbdbbbccadbbd	TRUE
adddcbdbbcadccbbd	TRUE
badbddccbbbbccadb	TRUE
badbdddaddadcaddd	TRUE
bbadaddbdbcadaddb	TRUE
bbadaddcadadbadda	TRUE
bbcccadcbadadadda	TRUE
bbcccbbaddbcadbad	TRUE
bcbbadadadadddbca	TRUE
bcbbadbadadddbbcb	TRUE
bdadadadbbadadadb	TRUE
bdadadaddcadaddba	TRUE
bdccadcbadccdbdcc	TRUE
bdccadccdbadbbddd	TRUE
cadbadcadadbadbad	TRUE
cadbadcadbddadbdb	TRUE
caddccadadcbdcdca	TRUE
caddccbcdadcdbbcc	TRUE
cbcbbadbadbdadcdd	TRUE
cbcbbadcbcddbadcc	TRUE
ccbadadccadcadccb	TRUE
ccbadaddbdadcdddd	TRUE
ccdcccbbcaddcadca	TRUE
ccdcccccbadbbbbba	TRUE
cdcbdccbdbadbdbba	TRUE
cdccadcadccbdbcbc	TRUE
dadbadbcadcbadbad	TRUE
dadbadbccbbbcadad	TRUE
daddcadcdcccadada	TRUE
daddcaddcbbcdbbbb	TRUE
dbcadcccdaddcbadd	TRUE
dbcadcdadcbadcbad	TRUE
dcadcdcdbbadbcadc	TRUE
dcadcddadbbbdadad	TRUE
dcdadbadadbddcadd	TRUE
dcdadbadaddaddccb	TRUE
ddbccadbddbadbada	TRUE
ddbccadcaddadbdbd	TRUE
aaaaaaabdbdaaabba	FALSE
aaaaabbdcbaccbacc	FALSE
aaccbcbccdaadcadd	FALSE
aaccbcdcaabacbaac	FALSE
abbabddacbdcccbba	FALSE
abbacbbbcdadbbabd	FALSE
abdcdbaacacdcbdbc	FALSE
abdcdbcaacbadcbbb	FALSE
accadcaabcbacdbac	FALSE
accadcdadccadcdbd	FALSE
adacdbacabdaaadcc	FALSE
adacdbacccbdbdcda	FALSE
addcaabaccaabcdad	FALSE
addcaaccdbbbdcbcc	FALSE
bacabaabbacdcdcda	FALSE
bacabbdbabcaadaac	FALSE
bbacadccddddabbab	FALSE
bbacbbdbabdcabaad	FALSE
bbdabdcaacbbacdaa	FALSE
bbdabddbbcaaadddd	FALSE
bcbcdbbdbdcddccab	FALSE
bcbcdbdabcabacdab	FALSE
bdabcadacccbdcdbb	FALSE
bdabcbaabcdbdcadc	FALSE
bdcccddddaddaadab	FALSE
bdccdacacbdcabbbc	FALSE
cabaccdbdbbddbdad	FALSE
cabadbadbcccbabbd	FALSE
cadcdcdbdbcbdaacd	FALSE
caddaacdcbbcadaad	FALSE
cbcbaabbbabacdbdc	FALSE
cbcbabbaacadacdcd	FALSE
ccadbccbadadbddac	FALSE
ccadbdbadccacadaa	FALSE
ccdbddadbdbaabbab	FALSE
ccdbddcccacbcbcda	FALSE
cdcaddabdbcacddbd	FALSE
cdcaddcacbaabbbdb	FALSE
daacddcdcaddddcac	FALSE
daadaaaccdadbaaaa	FALSE
dadabbaaadcdcabba	FALSE
dadabbbaabbcddaab	FALSE
dbbdbaadaacdcdabc	FALSE
dbbdbacbbbdacacaa	FALSE
dcaccbcadcbdadaad	FALSE
dcaccbcccacdcabbd	FALSE
dcdabcccdcccabadd	FALSE
dcdabcddcdcddcdac	FALSE
ddbcdccbbbbcacaba	FALSE
ddbcdddabdddabcca	FALSE
adadadadadadddcadb	TRUE
adadadadadbbbadcdc	TRUE
adadcccccbcadadada	TRUE
adadcccdbbaddcbdad	TRUE
adbadddddcadadbcbc	TRUE
adbbadadcdbcaddadd	TRUE
adbdccdadcbbccadba	TRUE
adbdccdccddadbbbba	TRUE
adccbadddaddccadad	TRUE
adccbbadadcaddaddb	TRUE
addbadcadadbcbdcdb	TRUE
addbadcbcbbbccbcbc	TRUE
adddcadbddcdadcdbd	TRUE
adddcadcbaddadcadc	TRUE
badbddbadbadadadad	TRUE
badbddbcadaddadcad	TRUE
bbadbcadadbadddadc	TRUE
bbadbcadadcdcaddad	TRUE
bbcddcccbaddcdadcc	TRUE
bbdadadbdbdadcdada	TRUE
bcbcaddbcadcbdcbba	TRUE
bcbcbadadbadccadca	TRUE
bcddbaddddadbdadcb	TRUE
bcddbbaddbddccbcbc	TRUE
bdccadccadaddadcba	TRUE
bdccadcdcbadbbdbad	TRUE
cadbaddcadcaddccdc	TRUE
cadbaddcbaddaddcbb	TRUE
caddbbccadcbcddcad	TRUE
caddbbdbbbcdccaddb	TRUE
cbbddcaddbbccbbada	TRUE
cbbdddbdcbadbbaddc	TRUE
ccadccdbcdcdddbbad	TRUE
ccadcdadbddcdbaddc	TRUE
ccdaddcdadcdddaddc	TRUE
ccdadddcadbadbcbdc	TRUE
cdcadbadadbcddbcbc	TRUE
cdcadbbbadadaddcdb	TRUE
dadadcbbaddadbadad	TRUE
dadadcbbcbbadbadbc	TRUE
daddbdbddbadbbddcd	TRUE
daddbdcbadadadbadb	TRUE
dbcadcadddccbadccd	TRUE
dbcadccbadbbdbddad	TRUE
dcadcbcdaddadadcca	TRUE
dcadcbdccdcdadcdad	TRUE
dcdadadbdadcbdadad	TRUE
dcdadadcadbdbadcbd	TRUE
ddbbbbbddcddcdbbda	TRUE
ddbbbcadbdadbcadba	TRUE
aaaaabaadccbccdcdd	FALSE
aaaaacadadbbbcbdba	FALSE
aacccbccaccbabbcbc	FALSE
aacccddcbdbdbbabba	FALSE
abbaddcbdbdbabcbdb	FALSE
abbadddaaabaacbddb	FALSE
abdddaaaacdddaacbc	FALSE
abdddadbabbcdccaaa	FALSE
acccbbacddcccaddaa	FALSE
acccbbbddbaddcadaa	FALSE
adbacaddabcacdaddd	FALSE
adbacbaccdbdcdccbb	FALSE
addbcaadacdacddadb	FALSE
addbccababbaadcbcb	FALSE
babcdbaaccbadddcab	FALSE
babcdbabaadbabaaad	FALSE
bbaacaadaabaaaaaab	FALSE
bbaaccadddcabddbac	FALSE
bbcccbbdbcaaabacbc	FALSE
bbcccbcababdacadda	FALSE
bcbbaddaaacbdcddab	FALSE
bcbbadddacadbaadac	FALSE
bdaabcccadcbcdaaca	FALSE
bdaabcdbadacaacbcd	FALSE
bdcdaaccbbbbcbcbcb	FALSE
bdcdabbbccdbcacacc	FALSE
cabbddadcbbdbddbca	FALSE
cabbddbadbddbdaddd	FALSE
caddcabddcddcccadc	FALSE
caddccabcacbcbbddb	FALSE
cbccacbabadcaddbad	FALSE
cbccaccacccbbdbbda	FALSE
ccbbadadccadbcdcac	FALSE
ccbbadadccdcdacaab	FALSE
ccdcdbbadbddbbcdac	FALSE
ccdcdbbcacbbcbacaa	FALSE
cdcbbccadacdabbcbd	FALSE
cdcbbdbcdaddcbbbaa	FALSE
daaccaaabababdbbdd	FALSE
daaccabcaabdadcbcd	FALSE
dadadcadbdacbbcddc	FALSE
dadaddbadacbbacdda	FALSE
dbbdabaabddcddcdcd	FALSE
dbbdadcabdabcbccad	FALSE
dcaacbaacbabbabdad	FALSE
dcaaccbcabaaadbccd	FALSE
dccbcdbdcdccaaadba	FALSE
dccbcdccaccbdccacc	FALSE
ddaddbacaabdaababc	FALSE
ddaddcabbdccbcddaa	FALSE
adadadadadadbcadbbb	TRUE
adadadadadadcdbadba	TRUE
adadcbcccdccdbdbadb	TRUE
adadcbcdddbbcbadbdc	TRUE
adbbadadbbadbadbadc	TRUE
adbbadadcadadcadada	TRUE
adbdbbadadadcbccadd	TRUE
adbdbbadadbdcaddbdd	TRUE
adcbcbcaddcccadbbbd	TRUE
adcbcbcbbdcbccdadca	TRUE
addadbcbdccaddadcda	TRUE
addadbdadadcadcadbd	TRUE
adddbadcdbcdbbcdccd	TRUE
adddbaddcadccadadda	TRUE
badbdcbdaddbbdbbcad	TRUE
badbdcbdcaddccadbcb	TRUE
bbadbbadaddbdaddadb	TRUE
bbadbbadbdcdaddbbdb	TRUE
bbcdcddcadddcbbadbb	TRUE
bbcddadadccdbdadbba	TRUE
bcbcbddccbbaddbdcdb	TRUE
bcbcccccdccbbddbccc	TRUE
bdadadadbbdcbbcadca	TRUE
bdadadadcadadbdbdad	TRUE
bdcbbdadbaddbbbdada	TRUE
bdcbbdddcbadcadcbba	TRUE
cadadcccadaddcbdadd	TRUE
cadadccdcdccbbbadcd	TRUE
caddadcadcdcbbaddca	TRUE
caddadcddcccadccdad	TRUE
cbbcdddcccccadcbcdc	TRUE
cbbdadadbbddbdcddad	TRUE
ccadbadadadcadadbad	TRUE
ccadbadadccadbdcadc	TRUE
cccdbbccbcbdccbadad	TRUE
cccdbdadccbbccdadcb	TRUE
cdbcdaddddaddcbadcc	TRUE
cdbdadadadcdadadada	TRUE
dadadbadbbbaddadcad	TRUE
dadadbadccadddcdbad	TRUE
dadccbdddccadaddbca	TRUE
dadcccbbcdadcadbbbc	TRUE
dbbadadddbbadadcdbd	TRUE
dbbadbadcadaddbcdad	TRUE
dbdcccaddadcadcdadb	TRUE
dbdcccdbbbaddbdccdb	TRUE
dccbcadbaddcddadcdd	TRUE
dccbcadcaddaddadbad	TRUE
ddbaddcadadaddcdbcc	TRUE
ddbaddcdadadadadbad	TRUE
aaaaaaccdbccdacdbda	FALSE
aaaaaadcadbbcadbaaa	FALSE
aacccdddbdabcbbccaa	FALSE
aaccdaadaacdddcbaac	FALSE
abbbbbdbabbabcaaaca	FALSE
abbbbdaaabcdcaccada	FALSE
acaabacabaacbdbaaca	FALSE
acaabbcbcabcadbcacb	FALSE
acccbccdbccddaaacdd	FALSE
acccbcdcdcddcdaadbc	FALSE
adadddaccbabcaccbda	FALSE
adadddbcaccdaaccbaa	FALSE
addbcdbcadbacabbabc	FALSE
addbcddacacababbccd	FALSE
babddadabbccdccaabb	FALSE
babddaddaabdcaaabcc	FALSE
bbabaddbdbabbbbcdad	FALSE
bbabbabdbcadcdbacab	FALSE
bbcdcddcabddcbbacbb	FALSE
bbcddabaadccdbdacbb	FALSE
bcbcbddccbbaadbdcdb	FALSE
bcbcccccdccbbddbcab	FALSE
bdaaaacccbcbadadbad	FALSE
bdaaabcddccaadcdddc	FALSE
bdcbbdaabacdbbbdaba	FALSE
bdcbbdddcbaccaacbba	FALSE
caaccabbbddbdbaddcc	FALSE
caaccbdadbbaaabdcad	FALSE
cadacdddaaddccddaca	FALSE
cadadabaacbaccaadac	FALSE
cbbcdddcccccabcbcdc	FALSE
cbbdaabcabbdcddbddb	FALSE
ccaacbbbbbcbbddcbdb	FALSE
ccaacbbdaacbccbabba	FALSE
cccdbbccbcbdccbacad	FALSE
cccdbdabccbbccdadcb	FALSE
cdbcdacdddaddcbaacc	FALSE
cdbdaaaaaadacacddaa	FALSE
daabaddacbdcadcddba	FALSE
daabaddccdaacdccabd	FALSE
daccccacbcbcdadabbd	FALSE
daccccbbcbcabcaaaca	FALSE
dbbacadcacadaaacadb	FALSE
dbbacbbabbbdbcaabdd	FALSE
dbdcccaadadcaacdaab	FALSE
dbdcccdbbbaddbdccaa	FALSE
dccbcaadabdaddcddad	FALSE
dccbcaccdbaddabdadb	FALSE
ddbadbccbbcddcabacd	FALSE
ddbadcacccaaacbaacd	FALSE
