aaaaaaaacd	TRUE
aaaaaaccba	TRUE
aacbbbcadd	TRUE
aacbbbdacb	TRUE
aaddacadad	TRUE
aaddadaaaa	TRUE
acbcacaccb	TRUE
acbcacbdbc	TRUE
acdbbacddb	TRUE
acdbbcbbaa	TRUE
adbaccccda	TRUE
adbaccdcdb	TRUE
addaddcbcc	TRUE
addadddccc	TRUE
bacadbdaad	TRUE
bacadcaaac	TRUE
bbaadccdcc	TRUE
bbaaddaccc	TRUE
bbcbddbcad	TRUE
bbccaacbbd	TRUE
bcbadddcdd	TRUE
bcbbaaacca	TRUE
bcdcdbddcd	TRUE
bcdcdcadda	TRUE
bdcbadbcdb	TRUE
bdcbadcadb	TRUE
caadbccbac	TRUE
caadbdadda	TRUE
caddddbaad	TRUE
cbaaaaaada	TRUE
cbcbbdaccb	TRUE
cbcbcaccaa	TRUE
ccadbdadaa	TRUE
ccadbdaddc	TRUE
ccdcbadaca	TRUE
ccdcbbcbaa	TRUE
cdcacdddca	TRUE
cdcadaacdc	TRUE
daaccadbbb	TRUE
daaccbdaad	TRUE
dadcaccbdd	TRUE
dadcacccbc	TRUE
dbbddcaadb	TRUE
dbbddcacda	TRUE
dcaadccdac	TRUE
dcaaddaddb	TRUE
dcccdcacaa	TRUE
dcccddadba	TRUE
ddbbccaacd	TRUE
ddbbcdcbaa	TRUE
aaaaabaaad	FALSE
aaaaadbaba	FALSE
aaccbcaabb	FALSE
aaccbcbcab	FALSE
abadddbbdd	FALSE
abaddddbba	FALSE
abdbbbdaad	FALSE
abdbbcadaa	FALSE
acbccdbcab	FALSE
acbccdcbab	FALSE
adabbbcbac	FALSE
adabbccdab	FALSE
addabadcbb	FALSE
addabbcbbb	FALSE
babcbdcccc	FALSE
babcbddadb	FALSE
bbababacbb	FALSE
bbababdcbb	FALSE
bbcbddbcab	FALSE
bbccaabbbd	FALSE
bcbaddccab	FALSE
bcbbabacca	FALSE
bcdcdbddab	FALSE
bcdcdcadab	FALSE
bdcbadbcab	FALSE
bdcbadcabb	FALSE
cabaacacca	FALSE
cabababbdb	FALSE
caddddbaab	FALSE
cbaaabaabb	FALSE
cbcbbdacab	FALSE
cbcbcabaca	FALSE
ccadbcadab	FALSE
ccadbcdcab	FALSE
ccdcbacaba	FALSE
ccdcbbcbab	FALSE
cdcaccbcab	FALSE
cdcacdcabb	FALSE
daacdcdabd	FALSE
daacddbcab	FALSE
dadadddcab	FALSE
dadbacbbab	FALSE
dbbddcaabb	FALSE
dbbddcabda	FALSE
dcabbaddad	FALSE
dcabbbbdab	FALSE
dcccdcacab	FALSE
dcccddadab	FALSE
ddbbccabbd	FALSE
ddbbcdcbab	FALSE
aaaaaaaacdc	TRUE
aaaaaacaaad	TRUE
aacbbbdbdbc	TRUE
aacbbcadaac	TRUE
aaddaccbddd	TRUE
aaddacddbad	TRUE
acbcbcdbaca	TRUE
acbccacdbac	TRUE
acdbacaadbb	TRUE
acdbacbaaad	TRUE
adbacbcdbcb	TRUE
adbacbdaddb	TRUE
addbaaccdba	TRUE
addbaadaadd	TRUE
bacaadcaaad	TRUE
bacaaddbacc	TRUE
bbaacadadad	TRUE
bbaacadcaaa	TRUE
bbcbdcbbadd	TRUE
bbccaaaadad	TRUE
bcbbbacdaca	TRUE
bcbbbacdcac	TRUE
bcdcdbccbcc	TRUE
bcdcdbdcbcb	TRUE
bdcbbcbbbdb	TRUE
bdcbbdddbda	TRUE
caadcacbbcd	TRUE
caadcaccbcd	TRUE
caddaadaacb	TRUE
caddaadcada	TRUE
cbcbaaaadcb	TRUE
cbcbaacdaac	TRUE
ccacdaadbba	TRUE
ccacdaddaaa	TRUE
ccdaddadacb	TRUE
ccdbaadacdd	TRUE
cdbdbcdcdbc	TRUE
cdbdcadaacc	TRUE
daaccbaacad	TRUE
daaccbacbcc	TRUE
dadadbdbcad	TRUE
dadadccadbc	TRUE
dbbcaacddbb	TRUE
dbbcacaaadb	TRUE
dcaaccadaac	TRUE
dcaaccccbcc	TRUE
dcccdaddacb	TRUE
dcccdbacdaa	TRUE
ddbcaaacdbb	TRUE
ddbcaadacda	TRUE
aaaaabdcaaa	FALSE
aaaaacdadab	FALSE
aacbbbaacab	FALSE
aacbbbcddab	FALSE
abadcddcdbb	FALSE
abaddacabad	FALSE
abdbbccbdbb	FALSE
abdbbdabbdb	FALSE
acbcccdabad	FALSE
acbcccddaab	FALSE
adabbddbabc	FALSE
adabbddccab	FALSE
addaacbbbab	FALSE
addaaccdbab	FALSE
babdbdaadba	FALSE
babdbdcaaab	FALSE
bbacabcbbbb	FALSE
bbacbacbdab	FALSE
bbcddaabcdd	FALSE
bbcddacbcab	FALSE
bcbaccaacab	FALSE
bcbadaaacab	FALSE
bcdcccabaca	FALSE
bcdccccbbab	FALSE
bdcaaadddab	FALSE
bdcaababada	FALSE
caadbdaadab	FALSE
caadbdabcbc	FALSE
cadbddbabca	FALSE
cadbddccaab	FALSE
cbcbcbdabad	FALSE
cbcbcdbbcab	FALSE
ccbadadbaba	FALSE
ccbadadbabb	FALSE
ccdcbabadbb	FALSE
ccdcbabadcb	FALSE
cdcbdacccab	FALSE
cdcbdbccaab	FALSE
daadadddcab	FALSE
daadbaaccab	FALSE
dadcbabcbcb	FALSE
dadcbacabba	FALSE
dbcaddddbab	FALSE
dbcbaadbcab	FALSE
dcacbbacbab	FALSE
dcacbbdddab	FALSE
dccddbddcab	FALSE
dccddcacbab	FALSE
ddbbbccbcab	FALSE
ddbbbdacdab	FALSE
aaaaaaacbdcc	TRUE
aaaaaaadaacb	TRUE
aacbcbdcccca	TRUE
aacbccaddaaa	TRUE
aaddaaacacbc	TRUE
aaddaaacadcd	TRUE
acbcbbbdcdaa	TRUE
acbcbbdbaddc	TRUE
acdbcacaacad	TRUE
acdbcbaacbdd	TRUE
adbadbaaaaac	TRUE
adbaddbcddcd	TRUE
addbacdbcdcd	TRUE
addbadbcbdaa	TRUE
bacbdadccdac	TRUE
bacbdbadcdad	TRUE
bbadaaaaaacb	TRUE
bbadacdcacaa	TRUE
bbcddbadaaac	TRUE
bbcdddadbdaa	TRUE
bcbaddbadcbd	TRUE
bcbaddbbdaad	TRUE
bcdccdbadcdd	TRUE
bcdccdbbaddd	TRUE
bdcadaaaaddd	TRUE
bdcadadacada	TRUE
caacdddaccad	TRUE
caacdddadccd	TRUE
cadcdaadbacb	TRUE
cadcdadbbdbd	TRUE
cbcacccacbcd	TRUE
cbcacccbaaaa	TRUE
ccbacbacaada	TRUE
ccbacbbdcdda	TRUE
ccdccbddddaa	TRUE
ccdcccadcbcd	TRUE
cdcadcdbbcdd	TRUE
cdcadddcadbc	TRUE
daadadaaaaac	TRUE
daadbaacdacb	TRUE
dadcaadbdbdd	TRUE
dadcacbdadda	TRUE
dbcaaaaaacba	TRUE
dbcaaaaacdbb	TRUE
dcacdcddbbaa	TRUE
dcacddaadadc	TRUE
dcdadacbbccb	TRUE
dcdadadadcbc	TRUE
ddbdaaacdcbb	TRUE
ddbdaacaaacc	TRUE
aaaaabdcaaaa	FALSE
aaaaacaddabc	FALSE
aacbbadbabdc	FALSE
aacbbbacddab	FALSE
abadcddabbcc	FALSE
abaddaadcdcb	FALSE
abdbbdddddbd	FALSE
abdbcabadcdc	FALSE
acbdcadacdab	FALSE
acbdcbbbabdb	FALSE
adabcaaddddb	FALSE
adabcacdbabb	FALSE
addabdcabaad	FALSE
addacadbbdab	FALSE
babddcbccdbd	FALSE
babdddccccda	FALSE
bbacccbbccab	FALSE
bbacccbdadab	FALSE
bbcddbacabab	FALSE
bbcdddacbdab	FALSE
bcbadbdbbbab	FALSE
bcbadcacddab	FALSE
bcdccdbadcab	FALSE
bcdccdbbadab	FALSE
bdcaccbdcdab	FALSE
bdcacccdadab	FALSE
caadcaacbaab	FALSE
caadcbddddab	FALSE
cadcabbcbaab	FALSE
cadcabbcdbbb	FALSE
cbcacabcdaba	FALSE
cbcacadacaab	FALSE
ccbacaaadaab	FALSE
ccbacacaabdc	FALSE
ccdccbddddab	FALSE
ccdcccaccbab	FALSE
cdcadccbbcab	FALSE
cdcadddcadab	FALSE
dabaababddcb	FALSE
dabaabadacca	FALSE
dadbccdddbab	FALSE
dadbcddcadab	FALSE
dbcaaaaaacab	FALSE
dbcaaaaacdab	FALSE
dcaccbbcadab	FALSE
dcacccbadbab	FALSE
dcdacdbdadab	FALSE
dcdacddbcdab	FALSE
ddbdaaacdcab	FALSE
ddbdaacababc	FALSE
aaaaaaadacaaa	TRUE
aaaaaacaaaacd	TRUE
aacbdbaacdcdd	TRUE
aacbdbaadccaa	TRUE
aaddbaccbaaca	TRUE
aaddbadccbaca	TRUE
acbdaacdbadba	TRUE
acbdacadaaacc	TRUE
acdcbbdadbaac	TRUE
acdcbbddbbddd	TRUE
adbcacbdcacaa	TRUE
adbcacccdaacd	TRUE
addcbacccbccd	TRUE
addcbadadaacd	TRUE
bacbadaccbcdd	TRUE
bacbadcacdccb	TRUE
bbaadbcccbadd	TRUE
bbaadcaadbdad	TRUE
bbcddddcbcbcb	TRUE
bbdaaaaccbacc	TRUE
bcbbbdadaadcb	TRUE
bcbbbddccadcc	TRUE
bcddccbdbacdc	TRUE
bcddcdacbadca	TRUE
bdcbcdccbcbaa	TRUE
bdcbdbbacaada	TRUE
caacccdadadcb	TRUE
caacccdbdadcc	TRUE
cadcaaaccaada	TRUE
cadcaaadbddca	TRUE
cbbdaadadadcd	TRUE
cbbdaadcbbbaa	TRUE
ccacbccaadddc	TRUE
ccacbdbcacbaa	TRUE
cccdcccdddbdd	TRUE
cccddbcaaadbb	TRUE
cdbcdcaaaddac	TRUE
cdbcddcadbdbd	TRUE
daacccadcdada	TRUE
daaccdadcddbd	TRUE
dadbcacccdbcb	TRUE
dadbcbaacaadd	TRUE
dbbcadacdbcaa	TRUE
dbbcbacaddaac	TRUE
dcaaacadbaacc	TRUE
dcaaacbadcbdc	TRUE
dcccbaccadcaa	TRUE
dcccbbbbccaca	TRUE
ddbbccbbbbaca	TRUE
ddbbccbbdacdd	TRUE
aaaaaababaaad	FALSE
aaaaabbadadbc	FALSE
aacbdaadaccab	FALSE
aacbdbbdcacab	FALSE
abadcacaddbdb	FALSE
abadcbababccc	FALSE
abdcadcabdcbd	FALSE
abdcbabaaccca	FALSE
accacbbdabaad	FALSE
accacbdcdcbab	FALSE
adacbdbcaaaba	FALSE
adacbddddacab	FALSE
addbbdcdddaab	FALSE
addbbddbbaaab	FALSE
babddadabdabb	FALSE
babddbdcaabda	FALSE
bbaadcbabdcdb	FALSE
bbaadcdbacaab	FALSE
bbcddddcbcbab	FALSE
bbdaaaaaadbab	FALSE
bcbbbdadaadab	FALSE
bcbbbddccacab	FALSE
bcddccbdbacab	FALSE
bcddcdacbadab	FALSE
bdcbcdccbcbab	FALSE
bdcbdbbacaaba	FALSE
caacddacccaab	FALSE
caadaabdbdbcd	FALSE
cadbbadcdcaab	FALSE
cadbbcabbbaba	FALSE
cbbdaadadadab	FALSE
cbbdaadcbbbab	FALSE
ccabdababbbca	FALSE
ccabdaccbccdb	FALSE
cccdcccdddbab	FALSE
cccddbcabadbb	FALSE
cdbcdcaaaddab	FALSE
cdbcddcadbdab	FALSE
daacdabdbcdda	FALSE
daacdbcacbdab	FALSE
dadabdddacbbc	FALSE
dadacadcbdaab	FALSE
dbbcadacabcaa	FALSE
dbbcbabacdaab	FALSE
dcaaacadcbaab	FALSE
dcaaacccddaab	FALSE
dcccbaccadcab	FALSE
dcccbbbbccaab	FALSE
ddbbccbbbbaab	FALSE
ddbbccbbdacab	FALSE
aaaaaaadacaaad	TRUE
aaaaaacaacdcad	TRUE
aacbdbbaaadcdd	TRUE
aacbdcaacbbacc	TRUE
aaddadccccbbcc	TRUE
aaddaddacadcba	TRUE
acbdaddcacdadd	TRUE
acbdaddcbdbdba	TRUE
acdcbdcadbbbaa	TRUE
acdccaadaaacaa	TRUE
adbcacdcbbbacb	TRUE
adbcbaaddcaaac	TRUE
addcaadacddcda	TRUE
addcacaadaacca	TRUE
baccaadcdbbaac	TRUE
baccacddcacccb	TRUE
bbbaaddcacdcaa	TRUE
bbbaaddcdcaccb	TRUE
bbdbcbadcdbbdb	TRUE
bbdbcbcbadbacd	TRUE
bcbdbccbcbbcad	TRUE
bcbdcaadaddcad	TRUE
bdaacbcaccbddd	TRUE
bdaacbcdbdadcd	TRUE
bdcbdacbddadcc	TRUE
bdcbdadadbadca	TRUE
caadaadbaaddaa	TRUE
caadaadbacdddb	TRUE
caddcbdbbbdcbb	TRUE
caddccdcacadcd	TRUE
cbcbbcbaaacdba	TRUE
cbcbbcbbbdcdcd	TRUE
ccaccccbadbccd	TRUE
ccaccdbccdcbbc	TRUE
ccdbaaadcaaacb	TRUE
ccdbaacdcdcbba	TRUE
cdcaaddacdcacc	TRUE
cdcaaddadbdcbd	TRUE
daaccbddddacca	TRUE
daacccaadbdbcc	TRUE
dadcbaaaadbbaa	TRUE
dadcbacdbdcbac	TRUE
dbcaddcbcbbbda	TRUE
dbcbaaacbcddbd	TRUE
dcadcaacbbacdc	TRUE
dcadcacdaaaadd	TRUE
dcdacadbccdacc	TRUE
dcdaccaadcadcb	TRUE
ddbbdcacbddcda	TRUE
ddbbdcbccccddb	TRUE
aaaaaabcbaaabb	FALSE
aaaaaadaacdcab	FALSE
aacdadbcdacabb	FALSE
aacdadbdbdcdab	FALSE
abbacbddbacaca	FALSE
abbaccaccabbdd	FALSE
abdcdccbabcaca	FALSE
abddaabcbdcacd	FALSE
accbaacbddaaba	FALSE
accbaaddbabbad	FALSE
adadcbbbcddaba	FALSE
adadccdcdbcbab	FALSE
addbbbacbbbabc	FALSE
addbbdadbdbcab	FALSE
babdacbacdaaac	FALSE
babdadadadbdbc	FALSE
bbaadcabdaaccb	FALSE
bbaaddbdbbacab	FALSE
bbcddbcabdbdca	FALSE
bbcddbdbbbdbab	FALSE
bcbbcabcdcaaca	FALSE
bcbbcbbbdcddab	FALSE
bcddbcccdbbdab	FALSE
bcddbddaccaaab	FALSE
bdcadabaaacbba	FALSE
bdcadacabcabab	FALSE
caaccbbadaddab	FALSE
caaccdabcddbcb	FALSE
cadbbbaabaaaaa	FALSE
cadbbcccaaddab	FALSE
cbbdbcaaccbcab	FALSE
cbbdbdaacabacd	FALSE
ccabccbadabddd	FALSE
ccabcccddcbdba	FALSE
ccdaabddcbbadb	FALSE
ccdaacbcbbdaab	FALSE
cdbdadcababcab	FALSE
cdbdadcacbcaab	FALSE
daaadadccadcab	FALSE
daaadbcabbccbd	FALSE
dadabdddcccbaa	FALSE
dadacaaccdcdab	FALSE
dbbccdddccdcab	FALSE
dbbccddddadbab	FALSE
dcabccbcaadbad	FALSE
dcabccdaddacad	FALSE
dccddbacabbbdd	FALSE
dccddbdaadbbab	FALSE
ddbcbaaadbbbab	FALSE
ddbcbaabcabbaa	FALSE
aaaaaaacadaacca	TRUE
aaaaaaaddbadbdc	TRUE
aacbbbbbbdaddcc	TRUE
aacbbbccccadbcb	TRUE
aaddcaddacaaaac	TRUE
aaddcdcdbdacbdd	TRUE
acbddcacddacacc	TRUE
acbddddbdaaaddc	TRUE
acdccaaadadaccb	TRUE
acdccacbbbddaac	TRUE
adbccbbdbdcccdb	TRUE
adbccbddaadbdbc	TRUE
addbdcdaadbbdbb	TRUE
addbddcacadcadb	TRUE
bacbdacbddaaacb	TRUE
bacbdadcacdbdcb	TRUE
bbaadbaaadbccda	TRUE
bbaadbbdbdccddb	TRUE
bbccbddadbddada	TRUE
bbcccadacbdcbbc	TRUE
bcbadaccadbacdb	TRUE
bcbadadacdbbaaa	TRUE
bcdccdbbcbacdba	TRUE
bcdccdcdbadacdb	TRUE
bdbddaacbdadcad	TRUE
bdbddaacddbadcb	TRUE
caacbbcdcdbadda	TRUE
caacbccbcdadcca	TRUE
cadbbbbcddaacbd	TRUE
cadbbcaadbcdccb	TRUE
cbbdcddddbccdbb	TRUE
cbbddacddbbadcc	TRUE
ccacdaddadbdbdc	TRUE
ccacdbcbcaddcda	TRUE
ccdaaaccacddacc	TRUE
ccdaacadaacbaac	TRUE
cdbcdacacbdbdad	TRUE
cdbcdbcbcadbbbd	TRUE
daaaccaacdaacda	TRUE
daaaccdadbbcddb	TRUE
dadadbcaccdadbb	TRUE
dadadbcaddddbbc	TRUE
dbbccadcbcaaccc	TRUE
dbbccbdcadaadda	TRUE
dcacdcbadccdbaa	TRUE
dcacdcbcddcaadd	TRUE
dcdaadbaadaaaad	TRUE
dcdacbacccdcbdb	TRUE
ddbccbccbddcbad	TRUE
ddbccbdccbaddad	TRUE
aaaaaadbbccbcab	FALSE
aaaaaadcdaadcab	FALSE
aacdadbcbbcbbab	FALSE
aacdbbbcaccabbd	FALSE
abbbbcddaddcdac	FALSE
abbbbdaaddacbab	FALSE
acaabadddcababc	FALSE
acaabcadcdcacdb	FALSE
accdabcbcccdaac	FALSE
accdabdacaaabbc	FALSE
adbbcbbcdbbddab	FALSE
adbbcbdaadddaab	FALSE
baaacaabbdbbaad	FALSE
baaacdaabdbacdc	FALSE
baccbbdbccdccab	FALSE
baccbccccddbcab	FALSE
bbbadacdbcbdbab	FALSE
bbbadadccdabbbd	FALSE
bbdcdabdabacccb	FALSE
bbdcdabdacbcccc	FALSE
bcbddbddaccdcab	FALSE
bcbddcbcbaabbbb	FALSE
bdabacdcbcdddca	FALSE
bdabadbabbdacbc	FALSE
bdccdcbaacdccab	FALSE
bdccdcbcdabbdbc	FALSE
cabadccdaccccbc	FALSE
cabaddccdacbcbb	FALSE
caddcabcbbddcca	FALSE
caddcabccdcddac	FALSE
cbcbddacbbcadab	FALSE
cbccabbbbbcdabb	FALSE
ccbbcbbdcaabcdd	FALSE
ccbbccbaacbacab	FALSE
cdaacbdbbcadcab	FALSE
cdaaccababdadba	FALSE
cdcbbcdabbdaccb	FALSE
cdcbbdabbdbbccb	FALSE
daaddddabbdacdc	FALSE
dabaaaadcccdbbc	FALSE
dadbcdccbcbacab	FALSE
dadbdaababcaaaa	FALSE
dbcacadcccadcab	FALSE
dbcacbdbbbdcbab	FALSE
dcacaddbcbbccab	FALSE
dcacbababacbddd	FALSE
dcdaabbbdcabaac	FALSE
dcdaaccacbddbab	FALSE
ddbbcddcaadadab	FALSE
ddbbcddcacdcabb	FALSE
aaaaaaaaccbdcdaa	TRUE
aaaaaaaddaadcbcb	TRUE
aacbdcbbcbdacbbc	TRUE
aacbdccdbbaacbad	TRUE
acaacaddaddadbaa	TRUE
acaacbacbdccdadb	TRUE
acbdccbadbdadcaa	TRUE
acbdcddaddbddbbb	TRUE
adaaaaacdbdadbad	TRUE
adaaaacccddcbbca	TRUE
adbdcccdacaadbdd	TRUE
adbdccdbdddbaadc	TRUE
baaaadbcdcdbddba	TRUE
baaaadcdaacdbbcd	TRUE
bacddacbdcaddaaa	TRUE
bacddbacbaadddac	TRUE
bbadaaccdbaacbdd	TRUE
bbadaacdcaacbdba	TRUE
bbdaddddbddbcbcd	TRUE
bbdbaaccccadbbcd	TRUE
bcbcddacbbbaaaca	TRUE
bcbdaccddbadbbda	TRUE
bcdddbcaadcccbad	TRUE
bcdddbcdcacbacbc	TRUE
bdccbdccddcbdaaa	TRUE
bdcccaacaaadbdbd	TRUE
caadcccaadbdcdac	TRUE
caadcdaadbddccbc	TRUE
caddcdddddbcbbda	TRUE
cadddaddaaaadbcb	TRUE
cbccddcbaaacdacd	TRUE
cbcdaaaaacadcdda	TRUE
ccbbbaadcddbccdc	TRUE
ccbbbacaddbacccb	TRUE
ccddacdcdbcdbacd	TRUE
ccddbbacacccaddd	TRUE
cdcbaacaddbbbdda	TRUE
cdcbaadbcadacbda	TRUE
daadbaadbbddaada	TRUE
daadbcddacdbaacc	TRUE
dadcbbbcaaacbacb	TRUE
dadcbbbdcadaaccb	TRUE
dbbdccdccdbddbaa	TRUE
dbbdcdaddccbbcac	TRUE
dcacbbcdcaaaaddc	TRUE
dcacbcbcacdbaacb	TRUE
dccdddbcdadcaacd	TRUE
dcdaaaaccadbccda	TRUE
ddbbdcadacbadaac	TRUE
ddbbdcdadbcdbdbc	TRUE
aaaaaaabdadcabba	FALSE
aaaaaacdcccdcbab	FALSE
aacdadabacaddbbd	FALSE
aacdaddbbdabdacb	FALSE
abbcababaddcdbcd	FALSE
abbcacbcbcdbabca	FALSE
abddcdbcdabaddbb	FALSE
abdddaabcacbdbcc	FALSE
acccccdcbdabbdba	FALSE
acccdadcabdccbcb	FALSE
adbbadcbcdadccab	FALSE
adbbbacabaaaadcc	FALSE
addbcdadcacbbcab	FALSE
addbcddcacccabbd	FALSE
bacaadabdaccccdc	FALSE
bacabaddacaabaca	FALSE
bbacbdbabbdbbdbc	FALSE
bbacbddcbaacaaab	FALSE
bbdabacacdadccad	FALSE
bbdabbabaacadcda	FALSE
bcbdbdbbbdabbbcb	FALSE
bcbdcaaabadaaddc	FALSE
bdabbdbacbabbbaa	FALSE
bdabcacbbdacadbc	FALSE
bdcdbbcabaabddab	FALSE
bdcdcacdaccadabd	FALSE
cabbcbbaaddcaaad	FALSE
cabbcbbcdcbaaaba	FALSE
cbaabdadbdddddbd	FALSE
cbaabddccbcbabab	FALSE
cbcdaccacadbdbab	FALSE
cbcdaccaddccccab	FALSE
ccbadaadddacbbab	FALSE
ccbadabcaadbdcca	FALSE
ccdcaaabcbdcdadd	FALSE
ccdcaabacdcacbba	FALSE
cdcbccbabadccdda	FALSE
cdcbcdccddcadbab	FALSE
dabacddaddabbadb	FALSE
dabacddcddaabdbd	FALSE
dadcbadabbdaddcd	FALSE
dadcbbaadcdabbaa	FALSE
dbcaaaddadbbccab	FALSE
dbcaaaddbaacabda	FALSE
dcacbdcdacdddcab	FALSE
dcaccbacccbbbdab	FALSE
dccddddacbddaaab	FALSE
dcdaabdbddbdbdcb	FALSE
ddbbacbaddcdaaab	FALSE
ddbbaccadbccadab	FALSE
aaaaaaacaaaacbcbc	TRUE
aaaaaaadaacacdaaa	TRUE
aacbdacccaaaccadd	TRUE
aacbdadacbbacbadb	TRUE
acaaaadbdbdccdbda	TRUE
acaaaaddcbcaadada	TRUE
acbdbbdaccaaaddaa	TRUE
acbdbcacdbbdaadcb	TRUE
acddddacdbaacccbb	TRUE
adaaaaaddaaadcbdc	TRUE
adbddaadddcaacbcc	TRUE
adbddadbcaacbbadd	TRUE
addbddacdacccbdcd	TRUE
addbddcacddbdbaac	TRUE
baccddbaaadbdcdcc	TRUE
bacdaacacdcdbadcc	TRUE
bbadcaacaacbbdbcc	TRUE
bbadcaadacdccaadd	TRUE
bbdbaacbbaaadcddb	TRUE
bbdbacadaccaddaac	TRUE
bcbcccbadcdcdaacb	TRUE
bcbcccdbddcddbdbd	TRUE
bdaacdbdbccdbcdba	TRUE
bdaadbaacdaadddad	TRUE
bdcdbcaadaadacaca	TRUE
bdcdbddbbdbbcbbda	TRUE
caadddadbcdbadddb	TRUE
caadddbaaadbccbcd	TRUE
cbaaacbcdaaaaccaa	TRUE
cbaaacdbaaaaaddac	TRUE
cbcdaacaaddcbbbad	TRUE
cbcdaaccadddacdbb	TRUE
ccbbcdadbaddbddda	TRUE
ccbbcdbbdbdbbaadc	TRUE
ccddccacbcaddbacc	TRUE
ccddcdacbdcacbbba	TRUE
cdcbcdcadcaddcacb	TRUE
cdcbcddadaddcbdac	TRUE
daadbdaacaadbdbad	TRUE
daadbdaddadbdaccd	TRUE
daddacbcbcdccdacc	TRUE
daddacbcbdbdcdcca	TRUE
dbcacbdccbdaaddbd	TRUE
dbcaccbaaadbacbbc	TRUE
dcacbdcbdbccbaddb	TRUE
dcaccaacddcccacdc	TRUE
dccdacadadcdcbada	TRUE
dccdacbcadcccadaa	TRUE
ddbcaacbbccbcaaac	TRUE
ddbcaacdbdcdccaac	TRUE
aaaaaabbababaadad	FALSE
aaaaabdbbcaabacad	FALSE
aaccadadbbbdbcdab	FALSE
aaccaddccbababadd	FALSE
abbadabccddcbdcad	FALSE
abbadacbdbabcdaab	FALSE
abdcadcacbaacabcb	FALSE
abdcaddbcbcbcbcba	FALSE
accbbaaadacddbdab	FALSE
accbbacaaccbabdba	FALSE
adaccbcccddcabbba	FALSE
adacdabaaccaaaddd	FALSE
addadbcaacdcaacab	FALSE
addadbcabbddaddab	FALSE
babccdccacbdadaac	FALSE
babccddadacccbccb	FALSE
bbaacbabdcdbadccc	FALSE
bbaacbdbbdbbbddab	FALSE
bbccbcdbcbcacdbab	FALSE
bbccbdacaacccdaab	FALSE
bcbabcbdcbdddbabd	FALSE
bcbabcdabbdaccbdb	FALSE
bcddcccdbaacadaab	FALSE
bcdddadbaccbaacab	FALSE
bdcbcbdbdadbbacab	FALSE
bdcbcdacaabdccbba	FALSE
cabacccabaadbcdbc	FALSE
cabacdadaadbcacbd	FALSE
cadcbcaddbccabddd	FALSE
cadcbdabccbaaadca	FALSE
cbcbbccdadddcadab	FALSE
cbcbbccdbbdcbddab	FALSE
ccaddbbabdabddaba	FALSE
ccaddbbacdcaacaab	FALSE
ccdccbdddadadbbab	FALSE
ccdccddaabcdcccdc	FALSE
cdcbaccdacdbbcdab	FALSE
cdcbaddbadaccccab	FALSE
daaddbbbddcdbdbab	FALSE
daaddccbccaacacab	FALSE
dadcabcbbdadbbdcd	FALSE
dadcacaacabbcddcd	FALSE
dbbdcbabaccacaaca	FALSE
dbbdcbacadcadbdab	FALSE
dcaaccabccdaaaaad	FALSE
dcaacdbbccbbaabba	FALSE
dcccdacaadcddbbab	FALSE
dcccdbbbbbcacbdab	FALSE
ddbbcbcdaadbbdcab	FALSE
ddbbcbdaaccccbcab	FALSE
aaaaaacaacddbadacb	TRUE
aaaaaadaacbacccdba	TRUE
aacbbdcbccbaacadda	TRUE
aacbcaccddcaadcbdb	TRUE
aadddbddadadaddbad	TRUE
aadddbddbaaadaadca	TRUE
acbcdcdddbdbddacac	TRUE
acbcddacbbcccccbda	TRUE
acdcbcaadddcbaadad	TRUE
acdcbcbccaaadbdbac	TRUE
adbcbbdbcdbbacadbb	TRUE
adbcbbdcbddcaccbcd	TRUE
addbdbccccaaccbdcd	TRUE
addbdcaadacaaacaca	TRUE
bacbadacbadcdbcdcb	TRUE
bacbadadaacdbadcac	TRUE
bbacccdcbaaadadcdc	TRUE
bbacccddcddadcccac	TRUE
bbdacaddbbaadcbbaa	TRUE
bbdacbacdccbcacbba	TRUE
bcbcbbdddacbdbdcdd	TRUE
bcbcbcdbdcbbadaddd	TRUE
bdaaaccaddcaacdbac	TRUE
bdaaacccccdacbdcac	TRUE
bdcbcdcbdbacacbccb	TRUE
bdcbdaaacbdccbccbb	TRUE
caaddccccbaddcdbbd	TRUE
caaddcdcaacbbacadb	TRUE
caddacaccacadbcddb	TRUE
caddacdacadcaccaad	TRUE
cbcbcdacbcdaaddbad	TRUE
cbcbcdbcdadbcdacdc	TRUE
ccbadadacaccbcccaa	TRUE
ccbadbadbdcccdddcb	TRUE
ccdccbadacbaccbbbc	TRUE
ccdccbbbadaccbcdba	TRUE
cdcbacadccadddbcac	TRUE
cdcbacdacdaddbbdaa	TRUE
daadcbdbdacdbcbdcb	TRUE
daadccbcbadbddacbc	TRUE
dadcdccbcaaadacbbd	TRUE
dadcddbcbaadadcbcd	TRUE
dbcaccdcadbdcdacbb	TRUE
dbcacdbcdddbbddbcb	TRUE
dcaccaaadcdadbddcd	TRUE
dcaccbaaaccbaccbaa	TRUE
dcdaccbbbaddbccddb	TRUE
dcdacccbcdccdbacdc	TRUE
ddbbddaaacadaadcad	TRUE
ddbbddcbdacbccaadc	TRUE
aaaaabcdcaccbbbaab	FALSE
aaaaacabcccccbbcdb	FALSE
aacccdddccccbddaab	FALSE
aaccdbacaccbdcccab	FALSE
abbbbdddacbdcacdbc	FALSE
abbbcbbababadccddd	FALSE
abddcbdbbbdbacdaaa	FALSE
abddcdababbbdabcbb	FALSE
acccabbcaaabcbbaca	FALSE
acccabdbddcaadccca	FALSE
adadabdabbabdaccbd	FALSE
adadaccaddbabadaac	FALSE
addabadbbbaddabddc	FALSE
addabbbdccbdcadbac	FALSE
babcabaabbbcbabada	FALSE
babcacaadbaccdbabc	FALSE
baddbbdaaccbcadaab	FALSE
baddbcbcbadabbcbcd	FALSE
bbcbbcdbcbcdaccbab	FALSE
bbcbbcdcdccddcacab	FALSE
bcadbcddcbccdccbab	FALSE
bcadbdddbbacdbddab	FALSE
bcdbbdccdbcadcabca	FALSE
bcdbbdddbdcccadcab	FALSE
bdcabccccabdbdaccb	FALSE
bdcabcddbabdcbaaaa	FALSE
caadccacbdadcdbaab	FALSE
caadcdaccadcaaadab	FALSE
cadbcabdbcbaccaddd	FALSE
cadbcadddbcbbbccab	FALSE
cbcbadbccabbaaacba	FALSE
cbcbaddabdabadcaca	FALSE
ccaddbdaadbaaadbab	FALSE
ccaddcaabcbcdbcacb	FALSE
ccddcbacadcbddacab	FALSE
ccddcbddcbbccabbad	FALSE
cdcdbbdbdbdbcadbab	FALSE
cdcdbcaaddddacbdab	FALSE
dabaccbdbccddbcaca	FALSE
dabacccadbabaaddca	FALSE
daddcddcbabbbadcba	FALSE
dadddcbaaacbabbbcb	FALSE
dbcacdbcccadcadabd	FALSE
dbcadaacacbcbddbab	FALSE
dcabdbbbbcdaccabdd	FALSE
dcabdbddbbdadcabcb	FALSE
dccdaaaabaacbccdbc	FALSE
dccdabbcddbabcdbdb	FALSE
ddbcaadcdacaccdabb	FALSE
ddbcabbbcbbcbddacb	FALSE
aaaaaadbbadaadbadad	TRUE
aaaaaadbbbaacddbdba	TRUE
aaccadaaacbdcaadbca	TRUE
aaccadbdcaaddcbbccd	TRUE
acaadbcaaaacadbcaac	TRUE
acaadbcbcdcaaaadcad	TRUE
accadadcbaacbadbbaa	TRUE
accadbbacdaacbbcdba	TRUE
adaadccaacbdccacdac	TRUE
adaaddaccadddcacdcb	TRUE
adcadccaadcddaaaddb	TRUE
adcadcdccdaadadacba	TRUE
baaaacdcaacdbbadbdb	TRUE
baaaacdcadadbaccbad	TRUE
bacdddaaaaddbdbadbd	TRUE
bacdddcbcaacdcbbccc	TRUE
bbaddcbcbbddaacaaac	TRUE
bbaddcbdccaccaaaadd	TRUE
bbdccacadcacacbcddc	TRUE
bbdccadaddacdcadddc	TRUE
bccacdcdbddacadaddd	TRUE
bccadacdcadbaadcdbb	TRUE
bdadbaddcdacaccdadc	TRUE
bdadbcadbadccacadda	TRUE
bddaaaddaddaaccacca	TRUE
bddaacacaacdaacdacc	TRUE
cacbacbcbbaddccbaac	TRUE
cacbacdbccbacbadbdc	TRUE
cbacbcdcaaaacbdacad	TRUE
cbacbddbaaacaadcbdb	TRUE
cbccccbbccbdbbdadad	TRUE
cbccccdbaaddcdacdda	TRUE
ccbbbdacbcdcddccdbd	TRUE
ccbbbdacbdacacdaccd	TRUE
ccdcdbdbbadacbacbbd	TRUE
ccddaacaacccdcadadb	TRUE
cdcbcddcdacacadcdba	TRUE
cdcbdaccacbcadacbad	TRUE
daadbadbaccbcdddcdc	TRUE
daadbbacdaacbaacada	TRUE
dadcddaddcdcdbbcbcd	TRUE
dadcddccadadbccdbad	TRUE
dbcaccacdadbdbcddcd	TRUE
dbcaccdcbbaaacdaddb	TRUE
dcacdbdcaaadcbcbaaa	TRUE
dcacdcacacdbcdbadaa	TRUE
dcdaaacacdaaaaaaaca	TRUE
dcdaaacccaaadbcddda	TRUE
ddbcbcadcaaccdcdbda	TRUE
ddbcbcbcacdccbcccbd	TRUE
aaaaaaabdddbdcaaddd	FALSE
aaaaaccaaaddcbacbab	FALSE
aacddacbaadcacdadab	FALSE
aacddbacbaacddacbab	FALSE
abbcbbbcddbdacabadd	FALSE
abbcbbcdbddacdcddda	FALSE
acabadaddbcdadbdaac	FALSE
acabadbaddcacdacbcb	FALSE
accddaabccacbbbcdaa	FALSE
accddababbabcbbccac	FALSE
adbdbcbcdacdbbbdbab	FALSE
adbdbccccccbdbabadd	FALSE
baaacbcdbadbcacbabd	FALSE
baaaccdadadabcccdac	FALSE
bacccacccdddcaaccab	FALSE
baccccccbdcabcbddcc	FALSE
bbaddccbbcbbddabcaa	FALSE
bbadddbcbcaabacdbbd	FALSE
bbdccabadcabacbcddc	FALSE
bbdccadaddacdcacdab	FALSE
bccaccaabadadddbddd	FALSE
bccaccdcdadbdcadbab	FALSE
bdadbadabcdcdacabcd	FALSE
bdadbdadddcbadccaab	FALSE
bddaaccddacdaaccabc	FALSE
bddaacdbddacaacdaab	FALSE
cabcbbcdcdaccbbcaba	FALSE
cabcbccbdbbcdccdabb	FALSE
cbabdadbcddbbcaaaca	FALSE
cbabdaddcababaabada	FALSE
cbccccbbccbdbbdadab	FALSE
cbccccdbabddcdabdda	FALSE
ccbbbdacbabdcddccdb	FALSE
ccbbbdaccbacabdabcd	FALSE
ccdcdbdbbacabbacbbd	FALSE
ccddaaacdbbabccdcad	FALSE
cdcbcddcdababaccdba	FALSE
cdcbdabcacbcadacbac	FALSE
dabaaddbddcadabdccd	FALSE
dababaacadbcaadcdac	FALSE
dadccdddcbbcbcddcab	FALSE
dadccdddddbccdbadab	FALSE
dbcabcdaddadcdadbdb	FALSE
dbcabdacbcbbababdad	FALSE
dcaccccdcbcbaabcddd	FALSE
dcacccddbcdbadabddb	FALSE
dcdaaababaccdaaaaaa	FALSE
dcdaaaddaaacaabdbcd	FALSE
ddbcbcadcabbcdcdbda	FALSE
ddbcbcbcabdccbcccbd	FALSE
