abababbbac	TRUE
abababcdac	TRUE
abbdcbdbcd	TRUE
abbdcbdcdb	TRUE
abdcccdbbc	TRUE
abdcccdcba	TRUE
acbbddddcc	TRUE
acbcabccab	TRUE
acdbdddbab	TRUE
acdcabdcdc	TRUE
adbbacbddb	TRUE
adbbaccccd	TRUE
addadcadab	TRUE
addaddacdd	TRUE
babdcbdbab	TRUE
babdcccaba	TRUE
baddababac	TRUE
baddabadbc	TRUE
bbcbcabbba	TRUE
bbcbcbacad	TRUE
bcadcddcac	TRUE
bcadcddcac	TRUE
bcddacaddb	TRUE
bcddacdccd	TRUE
bdcccdbaba	TRUE
bdcccdcabc	TRUE
cacabadadd	TRUE
cacabadbba	TRUE
cadcddddad	TRUE
caddabadbd	TRUE
cbcbcddbda	TRUE
cbcbdabcdd	TRUE
ccacdddcba	TRUE
ccacdddcca	TRUE
ccdbadadad	TRUE
ccdbadbdac	TRUE
cdbcbbcbdc	TRUE
cdbcbccbcc	TRUE
dabbadbccd	TRUE
dabbbabbad	TRUE
dadaccccab	TRUE
dadacddccd	TRUE
dbbccbddcb	TRUE
dbbcccbaba	TRUE
dcabacddbc	TRUE
dcabbabddb	TRUE
dccbccdacd	TRUE
dccbdabacd	TRUE
ddbbadbadd	TRUE
ddbbadcbcd	TRUE
aaaaaabdbc	FALSE
aaaaabbbcc	FALSE
aacccccadc	FALSE
aaccccddda	FALSE
abbbdbbcaa	FALSE
abbbdccaaa	FALSE
abdcbbcdaa	FALSE
abdcbbdaac	FALSE
acbdbcdbaa	FALSE
acbdbddcaa	FALSE
adabcabcaa	FALSE
adabcabdaa	FALSE
adcdcadbaa	FALSE
adcdcdabaa	FALSE
babacdcdaa	FALSE
babacddbaa	FALSE
badcbcbbaa	FALSE
badcbdaacb	FALSE
bbcbcaabba	FALSE
bbcbcbacaa	FALSE
bcadcadcaa	FALSE
bcadccabaa	FALSE
bcddabdaad	FALSE
bcddaccdaa	FALSE
bdcccdbaaa	FALSE
bdcccdcaac	FALSE
cabbcaaacb	FALSE
cabbcabaad	FALSE
caddbacdaa	FALSE
caddbcabaa	FALSE
cbcbcddbaa	FALSE
cbcbdaabcd	FALSE
ccacbdccaa	FALSE
ccacbddaac	FALSE
ccdbadadaa	FALSE
ccdbadbdaa	FALSE
cdbcbbcbaa	FALSE
cdbcbccbaa	FALSE
daabdabccc	FALSE
daabdccbdd	FALSE
daccdddbaa	FALSE
dacdaaabbd	FALSE
dbbccbddaa	FALSE
dbbcccbaaa	FALSE
dcaaacddda	FALSE
dcaabadcad	FALSE
dccbccdaad	FALSE
dccbdaaaac	FALSE
ddbbadbaad	FALSE
ddbbadcbaa	FALSE
abababbbaca	TRUE
abababcacbc	TRUE
abbdbdbcdbb	TRUE
abbdcabcdbb	TRUE
abdccbddacd	TRUE
abdcccabdbc	TRUE
acbcbdcccdc	TRUE
acbccabbdcc	TRUE
acdbdcccbac	TRUE
acdbdcddacd	TRUE
adbbbadcbcc	TRUE
adbbbbbdaca	TRUE
addadacbbcd	TRUE
addadadacab	TRUE
babdcdcbcab	TRUE
babddabbcbd	TRUE
baddcacabbb	TRUE
baddcbbacbd	TRUE
bbcbcadacbb	TRUE
bbcbcbacdbd	TRUE
bcbacdbcacd	TRUE
bcbacdddbdc	TRUE
bcdddcbcbdb	TRUE
bcddddbbacd	TRUE
bdcccadddcc	TRUE
bdccccccadb	TRUE
cacacadacca	TRUE
cacacbbadac	TRUE
cadddcbadcb	TRUE
cadddcbbbbb	TRUE
cbcbbccdbcc	TRUE
cbcbbdadcda	TRUE
ccadbcadbdd	TRUE
ccadcabbacd	TRUE
ccdadcadbda	TRUE
ccdaddadcac	TRUE
cdbdabcdcdc	TRUE
cdbdacccddd	TRUE
dabbbdccaba	TRUE
dabbbdddbda	TRUE
dadbddbbbda	TRUE
dadbddbddac	TRUE
dbbcbbacddd	TRUE
dbbcbcacdca	TRUE
dcabbcdbbbb	TRUE
dcabbcdcacc	TRUE
dccdbdcbdbb	TRUE
dccdbdddbbb	TRUE
ddbbddbadcb	TRUE
ddbbddbddbb	TRUE
aaaaabdbaaa	FALSE
aaaaacabbca	FALSE
aacbbccbdda	FALSE
aacbbcccdcd	FALSE
abadcccdcaa	FALSE
abaddaadcbb	FALSE
abdbdadbaac	FALSE
abdbdbccaac	FALSE
acbdcbadbaa	FALSE
acbdccacaad	FALSE
adabcdcdaac	FALSE
adabdaacabb	FALSE
addaccaacbc	FALSE
addacdadcaa	FALSE
babddacbdaa	FALSE
babddacdaad	FALSE
bbaddbddaac	FALSE
bbaddccccaa	FALSE
bbdadddbbaa	FALSE
bbdbaacdadc	FALSE
bcbdaabcddd	FALSE
bcbdaaddcdd	FALSE
bdabaadaadb	FALSE
bdababbaadb	FALSE
bddaabbccbb	FALSE
bddaabcdcdb	FALSE
cabcbcabdaa	FALSE
cabcbcacdaa	FALSE
cbaaadacccc	FALSE
cbaaaddccbd	FALSE
cbcdaaaabcc	FALSE
cbcdaabdcdc	FALSE
ccbbdcbbcaa	FALSE
ccbbdcccdaa	FALSE
cdaabcbccdc	FALSE
cdaacabbadd	FALSE
cdcccbbdcaa	FALSE
cdcccbcccaa	FALSE
dababbdbaac	FALSE
dababdbdcaa	FALSE
dadcbdabaac	FALSE
dadcbdcddaa	FALSE
dbbdccdabaa	FALSE
dbbdcdccbaa	FALSE
dcaadbddcab	FALSE
dcaadcbbdcd	FALSE
dcdaabcccbb	FALSE
dcdaacabdca	FALSE
ddbdaccdcaa	FALSE
ddbdadcdcaa	FALSE
abababdcaddb	TRUE
ababacabdadb	TRUE
abbdadbdaccc	TRUE
abbdadcabbdc	TRUE
abdccbcabdcd	TRUE
abdccbcdbcdb	TRUE
acbbcccdcbab	TRUE
acbbccdabccd	TRUE
acdbcbbdbbac	TRUE
acdbccabacca	TRUE
adbbcabcbbbd	TRUE
adbbcacbabcc	TRUE
addbbbdacbdd	TRUE
addbbcbbcbcd	TRUE
bacbdccabcbd	TRUE
bacbddabcccb	TRUE
bbadccddabdb	TRUE
bbadcdabbadc	TRUE
bbddacbdbcac	TRUE
bbddaccacbda	TRUE
bccbcbcacdcd	TRUE
bccbccccabdb	TRUE
bdadcdabddca	TRUE
bdadcdacadac	TRUE
bddbabcbcdac	TRUE
bddbacbbbaba	TRUE
cacbdbbbbcdd	TRUE
cacbddadbacd	TRUE
cbaccbbcbcdb	TRUE
cbaccbbcbdad	TRUE
cbdacadbccdb	TRUE
cbdacbadabbc	TRUE
ccbbdccbbbbc	TRUE
ccbbdcdbcacd	TRUE
cdabbdbbdcbb	TRUE
cdabcabcdadc	TRUE
cdcccbbabcdd	TRUE
cdcccccccacd	TRUE
dacababddada	TRUE
dacabacbcdab	TRUE
daddbdcabccc	TRUE
daddcbaddacc	TRUE
dbcaccbdadbd	TRUE
dbcaccdabbda	TRUE
dcadabcccbcd	TRUE
dcadabdbbaba	TRUE
dcdadadadbda	TRUE
dcdadbacacbc	TRUE
ddbccdbaccda	TRUE
ddbccdbadcdd	TRUE
aaaaabdbaaad	FALSE
aaaaacbbcaca	FALSE
aacbbcdddcba	FALSE
aacbbdcadadc	FALSE
abbaaaababbd	FALSE
abbaaaabbccb	FALSE
abdbcadcccaa	FALSE
abdbcccabcaa	FALSE
acbdacccddaa	FALSE
acbdbaaadbbd	FALSE
adabcbacddaa	FALSE
adabcbaddaad	FALSE
addacadbcdaa	FALSE
addacadddaad	FALSE
babddbbcacaa	FALSE
babddbdcdbaa	FALSE
bbaddacdabaa	FALSE
bbaddacdbcaa	FALSE
bbddacccabaa	FALSE
bbddaccdbdaa	FALSE
bccbcbcabdaa	FALSE
bccbccccabaa	FALSE
bdadbdaacaad	FALSE
bdadbdababaa	FALSE
bddbaacbcdac	FALSE
bddbabcbbbaa	FALSE
cabdbcdbbdaa	FALSE
cabdbdcbaabd	FALSE
cbabdcddccaa	FALSE
cbabddacccaa	FALSE
cbdababbddaa	FALSE
cbdababdbdaa	FALSE
ccbbdccbbbaa	FALSE
ccbbdcdbcaad	FALSE
cdaaccddaddb	FALSE
cdaacdaccada	FALSE
cdcccbbabcaa	FALSE
cdcccccccaad	FALSE
dabbacacccaa	FALSE
dabbacadccaa	FALSE
daddabacccaa	FALSE
daddadbbbaad	FALSE
dbcacbdabdaa	FALSE
dbcaccbacbaa	FALSE
dcacdbbdaabd	FALSE
dcacdcbddbaa	FALSE
dcdacdbacdaa	FALSE
dcdacdcadaac	FALSE
ddbccdbabcaa	FALSE
ddbccdbadcaa	FALSE
abababadbbabd	TRUE
abababadcacbb	TRUE
abbdccaccdabb	TRUE
abbdccdcdabac	TRUE
abdcdbbdbacac	TRUE
abdcdccadcaba	TRUE
acbcbbacabbdd	TRUE
acbcbcaddcbdd	TRUE
acdbdbcbabbac	TRUE
acdbdbccccadc	TRUE
adbbacbcbaddd	TRUE
adbbacbccbddc	TRUE
addbbcdadcbda	TRUE
addbbcdbbccbc	TRUE
bacaddbdadcda	TRUE
bacaddccbcbcb	TRUE
bbabbbcbbcbbb	TRUE
bbabbbcdadbba	TRUE
bbccdcbadabcb	TRUE
bbccdccdccdcd	TRUE
bcbbdcaccdcca	TRUE
bcbcabdbaddad	TRUE
bdabbbcdbdcac	TRUE
bdabcbbdbcacd	TRUE
bdccdaccbcabb	TRUE
bdccdacddbcac	TRUE
cabdbdccdcabb	TRUE
cabdcaddabbbc	TRUE
cadddbacbadbd	TRUE
cadddbaddbbab	TRUE
cbcbbaccbaccc	TRUE
cbcbbbdaccabc	TRUE
ccaddacdbddab	TRUE
ccaddbcbabcdc	TRUE
ccdbbadaddbad	TRUE
ccdbbadccbcbd	TRUE
cdcacbccccaca	TRUE
cdcacbdbddbdd	TRUE
dabcadacdccdb	TRUE
dabcadbdddcdc	TRUE
dadbdadadaccd	TRUE
dadbdbacbdccd	TRUE
dbbcccacbbcca	TRUE
dbbccccabadcc	TRUE
dcacbbaddddbd	TRUE
dcacbbcdddabc	TRUE
dcdabbbbdadba	TRUE
dcdabbbcbabca	TRUE
ddbdbbdcaccac	TRUE
ddbdbbdcdabca	TRUE
aaaaaacabbddd	FALSE
aaaaaaddbadad	FALSE
aacbbdbadbcaa	FALSE
aacbcbbbcbdbc	FALSE
abbabdbbadcaa	FALSE
abbacacbaadbb	FALSE
abdcacdcabdaa	FALSE
abdcadaddadaa	FALSE
accabbcacaadb	FALSE
accabcbcbccaa	FALSE
adacbbadbbbaa	FALSE
adacbbbccdaaa	FALSE
addadaadcabba	FALSE
addadadcccaad	FALSE
babcabaddddaa	FALSE
babcabbadcbaa	FALSE
bbaabcddaacdd	FALSE
bbaabdcbcaaac	FALSE
bbccdcbadaacb	FALSE
bbccdccdccdaa	FALSE
bcbbdcabcdcaa	FALSE
bcbcaadbaddac	FALSE
bdaacaabdcaba	FALSE
bdaacabcddcdc	FALSE
bdccdabdcbcaa	FALSE
bdccdacbdbcaa	FALSE
cabbabcacddaa	FALSE
cabbabdaacaca	FALSE
caddcdcdddcaa	FALSE
caddcddcadbaa	FALSE
cbcbbaccbabaa	FALSE
cbcbbbdaccaac	FALSE
ccaddabdbddaa	FALSE
ccaddcaaacdcc	FALSE
ccdbbacdaddaa	FALSE
ccdbbadbcbcaa	FALSE
cdcabcbacccaa	FALSE
cdcabcbbabdaa	FALSE
daadbccddaccb	FALSE
daadbdbdccdab	FALSE
dadbaccaabdbb	FALSE
dadbaccddcdaa	FALSE
dbbcccabbbcaa	FALSE
dbbccccaaadcc	FALSE
dcabcadabbdaa	FALSE
dcabcbbdadcaa	FALSE
dcdaacabbdadb	FALSE
dcdaacabcabaa	FALSE
ddbdbbdcaccaa	FALSE
ddbdbbdcdabaa	FALSE
abababadbbabda	TRUE
abababadccbbdd	TRUE
abbdbcacccadcb	TRUE
abbdbdcdccbcda	TRUE
abdcbdbccbdabb	TRUE
abdcbddacacbdd	TRUE
acbcbadadcbaba	TRUE
acbcbadbadbddb	TRUE
acdbdccadabdcc	TRUE
acdbdcdadbabbc	TRUE
adbaddcabbcaba	TRUE
adbaddcdcdccad	TRUE
addadccdbabbdb	TRUE
addadcdbbbacda	TRUE
bacbbabcdbbcda	TRUE
bacbbadabdbaba	TRUE
bbabccaccdcaba	TRUE
bbabccadcabdad	TRUE
bbcdbddbbcbcac	TRUE
bbcdbddbcdbcad	TRUE
bcbccdabaccdcb	TRUE
bcbccdccbdbcbb	TRUE
bdabacbcccbadc	TRUE
bdabacccdbcaba	TRUE
bdcccbabdadabc	TRUE
bdcccbdabbbaca	TRUE
cabdbdacdadadd	TRUE
cabdbdcacaddbd	TRUE
caddaccacabbcc	TRUE
caddadadbddbca	TRUE
cbcacdcbdbabab	TRUE
cbcadbbbcaddca	TRUE
ccbabcbbbbdadb	TRUE
ccbabcddddccdd	TRUE
ccddbcdcacccbd	TRUE
ccddbcddadbddd	TRUE
cdcbddcacadbcd	TRUE
cdccabcdbaddac	TRUE
dabbdcbdbaccac	TRUE
dabbdddabcdbcd	TRUE
dadbccadbcabac	TRUE
dadbccadbcadad	TRUE
dbbdbabdacadbd	TRUE
dbbdbdbdbcabcb	TRUE
dcacdcbcdababc	TRUE
dcacdddbdbdddb	TRUE
dcdacbdccdddad	TRUE
dcdacbddaddcdc	TRUE
ddbccdacadccca	TRUE
ddbccdbdcdccac	TRUE
aaaaaaccabbbaa	FALSE
aaaaabbdbbddcb	FALSE
aaccccdcdabdca	FALSE
aacccdcabbabdc	FALSE
abbaaddddaabca	FALSE
abbabacbdbccaa	FALSE
abdcbbbdddcbaa	FALSE
abdcbcbddbcdaa	FALSE
acccbdcdcadaab	FALSE
accccacdddbaaa	FALSE
adbacabbdadaab	FALSE
adbacacccacaaa	FALSE
addcdbdaadbcda	FALSE
addcdcdcbddcaa	FALSE
bacaabbabddbac	FALSE
bacaaccbcdddca	FALSE
bbacdacdadabaa	FALSE
bbacdbaabddbdb	FALSE
bbdabddaacacbb	FALSE
bbdacacdcadaab	FALSE
bcbcabccbbdbaa	FALSE
bcbcabdabaaccc	FALSE
bdaacccbdacbbc	FALSE
bdaacccddddacb	FALSE
bdccbabdbbabaa	FALSE
bdccbbcacdacaa	FALSE
cabaccabaabdaa	FALSE
cabaccbabbddaa	FALSE
caddccabbddcaa	FALSE
caddcdbbbdaaca	FALSE
cbcbacdccbcbaa	FALSE
cbcbacdcdacaaa	FALSE
ccaccabccbbaab	FALSE
ccaccbdbaadbcd	FALSE
ccdbabaddcdaad	FALSE
ccdbabdcccbdaa	FALSE
cdbdbbbaddabaa	FALSE
cdbdbbccdadcaa	FALSE
daabccaadadabb	FALSE
daabccbddabdac	FALSE
dadabaaabcbcbd	FALSE
dadabbbbbcbdaa	FALSE
dbbcdbdccaabac	FALSE
dbbcdcabbbcaac	FALSE
dcacacdbbcadaa	FALSE
dcacacddadcdaa	FALSE
dcdaaaaacdbbcd	FALSE
dcdaabacbbadcd	FALSE
ddbcbbabaadbad	FALSE
ddbcbbacbddaaa	FALSE
abababacadbbbcd	TRUE
abababcbbcdacdd	TRUE
abbdcdbccbcbdbd	TRUE
abbddabbbddadcc	TRUE
abddcdbcdababab	TRUE
abdddadaddccabc	TRUE
acbdabcbadddbbc	TRUE
acbdabccdbcddca	TRUE
acddcaddadcdacb	TRUE
acddcbcbccacbcc	TRUE
adbdabdbbcbcdbc	TRUE
adbdacbdacbccdd	TRUE
adddadadcabbdab	TRUE
adddadbddadacac	TRUE
bacccbccbbcbcdb	TRUE
baccccbaccbdbbd	TRUE
bbacdcbbbbdccca	TRUE
bbacddacacacadd	TRUE
bbdbdabacadcdad	TRUE
bbdbdacaddaccac	TRUE
bcbdccabddcdadd	TRUE
bcbdcccaccccdcc	TRUE
bdacbabaccbcdcc	TRUE
bdacbdbbbccccad	TRUE
bdcdabcccacacad	TRUE
bdcdacdbaddbabc	TRUE
cabdcadadadabba	TRUE
cabdcbbabccbdbd	TRUE
caddbbdccbaddda	TRUE
caddcbabddcbdbb	TRUE
cbcaccddacdbcdb	TRUE
cbcaccdddbcdbab	TRUE
ccacdcbcdcbdbab	TRUE
ccacdccadabcdcd	TRUE
ccdacdadaddbdac	TRUE
ccdacdcbddbabbc	TRUE
cdbdbbccacababa	TRUE
cdbdbdbacadbbbb	TRUE
dabbcadcbcbdadb	TRUE
dabbcadccbcccda	TRUE
dadaccbcdaccbbb	TRUE
dadaccbdabdaccb	TRUE
dbbbbcacacbbabd	TRUE
dbbbbcddbdacdab	TRUE
dbddcabcacdddbc	TRUE
dbddccdbcacadcb	TRUE
dcccdddcddcbbbc	TRUE
dccdabbcddbcabd	TRUE
ddbbdaccddbdbcc	TRUE
ddbbdadccbbddad	TRUE
aaaaabcbdadbcdc	FALSE
aaaaadabdcbdbcd	FALSE
aacdaabbbbaaaaa	FALSE
aacdaadacacbbdc	FALSE
abbbbadaadcbdcd	FALSE
abbbbbbddbbbaac	FALSE
acaaadcdcddddbb	FALSE
acaaaddbccccbcd	FALSE
accccaaccabdcdc	FALSE
accccaccbadacaa	FALSE
adbbacbddbcbbaa	FALSE
adbbaccaddddbaa	FALSE
baaabbbcadbaaab	FALSE
baaabbcabccddcd	FALSE
bacdcbcddabcbaa	FALSE
bacdcbddaaddbaa	FALSE
bbbbbddbcbacbaa	FALSE
bbbbcaddaabaccc	FALSE
bbdddadbcdddbaa	FALSE
bbdddbadccbccaa	FALSE
bccaddbcdbddbaa	FALSE
bccbaadadddcdda	FALSE
bdacadccdcabdaa	FALSE
bdacadccddcddaa	FALSE
bddadcbabbbdaac	FALSE
bddaddaadbabccc	FALSE
cabdaaaddcdadad	FALSE
cabdaabbcdbaada	FALSE
cbaadddddcaccac	FALSE
cbabaacbcbbcccc	FALSE
cbdabddadaaadca	FALSE
cbdacaabaaadcac	FALSE
ccbbcdabdbdcdaa	FALSE
ccbbcdbadbaadbb	FALSE
cdaaaccccabdbbb	FALSE
cdaaadbbcaccabc	FALSE
cdccbaabcbcacda	FALSE
cdccbaacdcacaac	FALSE
daaddabbdddabbc	FALSE
daaddcadabccdab	FALSE
dadcacbdcccbaac	FALSE
dadcaccccdcaaac	FALSE
dbcaadddccddabd	FALSE
dbcabbbaaaaddcd	FALSE
dcacacadacaabba	FALSE
dcacadbaadacbac	FALSE
dccdbbccbbdaabb	FALSE
dccdbdabadaabab	FALSE
ddbbcaacdccccbb	FALSE
ddbbcadbadbaaac	FALSE
abababbaddcbbccd	TRUE
abababcdadddccdb	TRUE
abcacbadcdbbbbbc	TRUE
abcadacccbdcbdca	TRUE
acabbabbadadadcc	TRUE
acabbacbadcbaddb	TRUE
accaccabdcbdabdc	TRUE
accaccacddacdcad	TRUE
acddddbbbbaccada	TRUE
acdddddaccdcbdcc	TRUE
adcacdcacddbcbbc	TRUE
adcacddcdccacbdc	TRUE
babacbdcbcbdabab	TRUE
babacbdcccdadcca	TRUE
bacdddcdacdbcbdc	TRUE
bacddddbdcdccabc	TRUE
bbbaccdabbccabdd	TRUE
bbbaccdadabccccd	TRUE
bbddcabbaccdabdd	TRUE
bbddcbbbbbdbacbc	TRUE
bccbacbacdbdaddb	TRUE
bccbacbcabdcadcc	TRUE
bdadadbbcccddadb	TRUE
bdadadbbdddbddab	TRUE
bddadbddbcdabcab	TRUE
bddadcddacaddcca	TRUE
cacbacdaccaddddd	TRUE
cacbacdcddcabcbb	TRUE
cbabbbdccabcadad	TRUE
cbabbcadbbdabcab	TRUE
cbccaccbacddbdad	TRUE
cbccacdbbddbddbc	TRUE
ccbabbacbbbbdbad	TRUE
ccbabbdbadccbdad	TRUE
ccddabadbbdbdcac	TRUE
ccddabccddbdbbad	TRUE
cdcbbadcdacccddd	TRUE
cdcbbbdbbaccddcb	TRUE
dabccdadcdcadabc	TRUE
dabccddabddbddac	TRUE
dadcacdbcaccbabc	TRUE
dadcadaddbbdadba	TRUE
dbbcacdbadddbabd	TRUE
dbbcacdbbcbcdabc	TRUE
dcabcddabacaccdc	TRUE
dcabdaccccbadcdb	TRUE
dcccdcbddbccddcb	TRUE
dcccddaccadccbcb	TRUE
ddbabbadabadccba	TRUE
ddbabbbbacaccacb	TRUE
aaaaabbdbbbacadc	FALSE
aaaaacadbbcdadbc	FALSE
aaccbbbaabacabaa	FALSE
aaccbdcbabcdacaa	FALSE
abbadcccccdbdbaa	FALSE
abbaddacaccbccaa	FALSE
abdcbacdcadcabaa	FALSE
abdcbcbadabbdcaa	FALSE
accbabbaadbdcacc	FALSE
accbabbcaaadaadb	FALSE
adbadbcdabccdbaa	FALSE
adbadcacdabaaaca	FALSE
adddacdadabddbaa	FALSE
adddbabdbbdabdaa	FALSE
bacbbbdacbadbcaa	FALSE
bacbcaacbcbaadbc	FALSE
bbacdbcacadcacaa	FALSE
bbacdcbadadaaddc	FALSE
bbdaaccbbaaabaca	FALSE
bbdaacccdabcddaa	FALSE
bcbcabdcccccdcaa	FALSE
bcbcacadbaaadcba	FALSE
bdabbababbbcabaa	FALSE
bdabbacbadbcdbaa	FALSE
bdcbcdcdccadddaa	FALSE
bdcbdadbdabaadad	FALSE
cabbbbbcaccddbaa	FALSE
cabbbbcbcdddcdaa	FALSE
caddcbcdaababccc	FALSE
caddcccadacbccaa	FALSE
cbccdcadbdcbcbaa	FALSE
cbccdcbcdccabdaa	FALSE
ccbabcbcbaaddadc	FALSE
ccbabccdcacdaadc	FALSE
ccddbababcbbdcaa	FALSE
ccddbabacdabaadd	FALSE
cdcbaaacdbcbdbbb	FALSE
cdcbaaaddcdbcadc	FALSE
daadbbddaacacccb	FALSE
daadbdbabccdbbbb	FALSE
dadbccddccaadcbb	FALSE
dadbdaaabdbbddad	FALSE
dbbcdcdcbaacacca	FALSE
dbbcddbdadbbbaad	FALSE
dcabcbdddccdbbaa	FALSE
dcabccadacacccaa	FALSE
dccdaccccbdaddaa	FALSE
dccdadadbabbdcaa	FALSE
ddbbadbddcdbdaaa	FALSE
ddbbbabbcacbcdaa	FALSE
abababbdcbbbbbcab	TRUE
abababccacdcbbdba	TRUE
abbdddaddcddddbad	TRUE
abcababbbdcddbadd	TRUE
abddadacbdcdbcbdb	TRUE
abddadbcacabcbcdc	TRUE
acbcbaccdbccdccbb	TRUE
acbcbbdacacadddca	TRUE
acdcdababacccdbbb	TRUE
acdcdabacabcacbba	TRUE
adbcddcbddabbddcb	TRUE
adbcddccabadbbcdb	TRUE
adddbbbdbdcacbacd	TRUE
adddbbddddbadcbca	TRUE
bacccdbaccadbcdac	TRUE
bacccdcdccdbcacbd	TRUE
bbadadbacbbcddcad	TRUE
bbadbbadabbcdacac	TRUE
bbdadacbddcadccbb	TRUE
bbdadbadaccccabbb	TRUE
bccadbacbbddcdccc	TRUE
bccadbacdcbcbdcab	TRUE
bdacddcacadabdbca	TRUE
bdadabacdabcdadba	TRUE
bdcdcadcbacadccbd	TRUE
bdcdcaddbdacabdbd	TRUE
cabddbdbbabadabbc	TRUE
cabdddaccbdbbbadd	TRUE
caddadbacccacbcca	TRUE
caddbabdacdddcdbd	TRUE
cbcbcadacacadcacb	TRUE
cbcbcadbadccaccdb	TRUE
ccbbabbbbbacbbdac	TRUE
ccbbabbdbaddbdadc	TRUE
ccdcbdbdbacccdcda	TRUE
ccdccbdbbbadbcabd	TRUE
cdcbabcacadcadcdc	TRUE
cdcbabcddadacabbb	TRUE
dabcdabbcdbcdacca	TRUE
dabcdbdcababddacd	TRUE
dadcbddabdbadaddd	TRUE
dadccacacbcadabbc	TRUE
dbbdddabdbbcdbbcb	TRUE
dbcababbcaddccabd	TRUE
dcacbddbdabcdadda	TRUE
dcaccacccacaccdca	TRUE
dccddacabbbacbdbd	TRUE
dccddaccdabcacacd	TRUE
ddbbdbadadcddcdbb	TRUE
ddbbdbdadbbcbcbba	TRUE
aaaaababadbddcbbc	FALSE
aaaaaccadacacdccb	FALSE
aaccdabadadacabdb	FALSE
aaccdabbadacaaddd	FALSE
abbabddbcbaccddaa	FALSE
abbabddcddddcccaa	FALSE
abdbbabaaadcadcda	FALSE
abdbbbbbcacccacaa	FALSE
accabbddadcdadcaa	FALSE
accabccbdbcbbbdaa	FALSE
adadadadacdbdacaa	FALSE
adadbbdaaddbacdda	FALSE
addbbbbcdcbbccbaa	FALSE
addbbcbdbaabccdcc	FALSE
babcbbbddbcadbdaa	FALSE
babcbbcbabbcabdaa	FALSE
bbaabbbbcbccdccda	FALSE
bbaabbbdcbcbdaadc	FALSE
bbcccacddadddcaad	FALSE
bbcccadbdddadcaab	FALSE
bcbabbbbbbbaabbab	FALSE
bcbabbbcdaddcdbaa	FALSE
bcddbbabbabaacaaa	FALSE
bcddbbacddaddcdaa	FALSE
bdcbcccdcbbaadaab	FALSE
bdcbdbabbadadccaa	FALSE
caadddccccdaaaabc	FALSE
cabaabdbbbccbbbdc	FALSE
cadcdbcccabdaadac	FALSE
cadcdccadadadbbaa	FALSE
cbcbdcbcbabdcdcaa	FALSE
cbcbdccdcabacdcaa	FALSE
ccaddadadbbdaabdb	FALSE
ccaddbccacbcbadaa	FALSE
ccdcbccdbacbdadaa	FALSE
ccdccaacccddaaaba	FALSE
cdcbbcdacdbbabbaa	FALSE
cdcbbddaaaaacaacc	FALSE
daaddabdbdbacddcd	FALSE
daaddacacdbdacabb	FALSE
dadaddbcbbcadddaa	FALSE
dadaddcaaabccccdc	FALSE
dbbcddcaabacabadd	FALSE
dbbdaacabdadcabbd	FALSE
dcaaccbadcadadbaa	FALSE
dcaaccbdcadaacaad	FALSE
dcccbddddcabdcbaa	FALSE
dccccbaddccacdaad	FALSE
ddbbddccbbacbbaac	FALSE
ddbcacadcaccaddaa	FALSE
abababbbbbcabcdcca	TRUE
abababcabdadbbdcac	TRUE
abbdbabdabdcdccccb	TRUE
abbdbbbacdbaccacbc	TRUE
abddbdbccdabccabdd	TRUE
abddcacddbddabddac	TRUE
acbdabcabcbdbbdcbc	TRUE
acbdadcccbcbbbdcad	TRUE
acdccdbccbacdaddcb	TRUE
acdcdacbbdddcbcddb	TRUE
adbcbdcddacdbbcabd	TRUE
adbcbddcabbabdbcdd	TRUE
addbbdcdbbabadcdcb	TRUE
addbbddddbbcdaccbd	TRUE
bacbdacbdbadaccbac	TRUE
bacbdadbdbdcabccdc	TRUE
bbabdaddddcddabcbc	TRUE
bbabdbabddcbbaccca	TRUE
bbcdabacbdabadcdcd	TRUE
bbcdacacaddabdadcc	TRUE
bcbbacbddbdadabbac	TRUE
bcbbaccadacaccbbbc	TRUE
bdabbaccabcddddcba	TRUE
bdabbacdbbbcdbabda	TRUE
bdccacbddacabacdad	TRUE
bdccaccbddddbcabda	TRUE
cabdbdcacddbccddab	TRUE
cabdcacacadbcbcdda	TRUE
caddcdbcbabcabdddb	TRUE
caddcdbdcbcdccbbdd	TRUE
cbcadcbbaddbddacda	TRUE
cbcbabacdcabacbbdd	TRUE
ccbabdbbcdcabcbaba	TRUE
ccbabdbcccdcbbdbdb	TRUE
ccddbbadbcdaccdcda	TRUE
ccddbbbacbbbabbbac	TRUE
cdcbdcbabdbadbbbdd	TRUE
cdcbdcbdabdacccadb	TRUE
dabdabddaccdbbacab	TRUE
dabdacabaddabbbbbd	TRUE
dadcbacdbdadbabcdb	TRUE
dadcbaddabdccadddd	TRUE
dbbbdbbcdccbcdbadb	TRUE
dbbbdcbcbadcdddadd	TRUE
dcabacacbcbdcbbacb	TRUE
dcabaccddcabdabdcc	TRUE
dccdcbddbadbdcdbac	TRUE
dccdcccacbbaddacca	TRUE
ddbbccbdbbadbabbcc	TRUE
ddbbcdbabcdcacacbd	TRUE
aaaaaadaaaacaacddd	FALSE
aaaaabbaaacbccdccd	FALSE
aacbbddccdcdddccaa	FALSE
aacbcbbcacdcbdddcd	FALSE
abadcbdccadabbcaab	FALSE
abadccadacaacddaca	FALSE
abdccdbabdccdcdcaa	FALSE
abdcdacbdcdabaacad	FALSE
accaccbdcbaddbdbaa	FALSE
accaccdbcbdadcaabb	FALSE
adadadcccbbccdcbaa	FALSE
adadbcdbdabdbbabaa	FALSE
addbcacdbdbbacdaac	FALSE
addbcadbacdcccbbaa	FALSE
babdcbdadcdcdcccaa	FALSE
babdccccccadadbdaa	FALSE
bbabdcdbaadaccbbcb	FALSE
bbabddcdaccdcdcaac	FALSE
bbdababdbaccaadada	FALSE
bbdabadadbbaccaadd	FALSE
bcbdaabbcdcdacbcba	FALSE
bcbdaaddcdbdddabba	FALSE
bdacabdabbaabbccaa	FALSE
bdacacbdacdcbdcaad	FALSE
bddacdcdcbaaabcacc	FALSE
bddadabcddadbcddaa	FALSE
cabccbbabbdbdbccaa	FALSE
cabccbbabcbdcadcaa	FALSE
caddbddbabddaabddc	FALSE
caddcadbbbaadbabca	FALSE
cbccdaddbaddabcaaa	FALSE
cbccdbabcbaccacdaa	FALSE
ccbbbacaabddbccacd	FALSE
ccbbbaccdcddabbbaa	FALSE
ccddacdcddacbabaad	FALSE
ccddaddbaccabcadaa	FALSE
cdcbdbcaccdbcabbaa	FALSE
cdcbdccbdcbabcccaa	FALSE
daadcddcbadabadcaa	FALSE
daaddabddcbdbadcda	FALSE
dadbdccbdababdbdaa	FALSE
dadbdcdcaacbcbbccd	FALSE
dbbdddaacdadddabab	FALSE
dbbdddbcacacbacdaa	FALSE
dcabddbdbdbacbbcaa	FALSE
dcabddcabbbbcbcaac	FALSE
dccdbdcdaadabddbda	FALSE
dccdcababcccbdccaa	FALSE
ddbccdcdbbbbacbdaa	FALSE
ddbcdadabcdddacdaa	FALSE
abababaccbbabcddbab	TRUE
abababaccdbcabcaccc	TRUE
abbdcbcdaccabdccadb	TRUE
abbdcbdbabdcadbadbc	TRUE
abddddbabdddcdccddd	TRUE
abddddccacddabddbcd	TRUE
acbdbadacdbdadccabb	TRUE
acbdbbcaccbcbabadda	TRUE
acddcacccadbcbadbab	TRUE
acddcadccabccddcbba	TRUE
adbcdaddccabdaccbda	TRUE
adbcdbbcababcacdabd	TRUE
adddadbbbacabbdddda	TRUE
adddaddddcdcaddcacb	TRUE
bacdaccdbcdabcabcdd	TRUE
bacdacddbccbcaccbcd	TRUE
bbbaccadbabdcbbaddd	TRUE
bbbaccbdbdcacbdbdbb	TRUE
bbdcbdbbbbbbacabdac	TRUE
bbdcbdcdacddccbcadc	TRUE
bccacdabbbadddbadbb	TRUE
bccacdbdcddbcdcbabc	TRUE
bdadadbaccdccdbcbab	TRUE
bdadaddbdcdabdbaccb	TRUE
bddadcacabbadbcccad	TRUE
bddaddbbbbbcdcadacc	TRUE
cacbbcababddbdbbacb	TRUE
cacbbcadabddbbdabcb	TRUE
cbabbdacddbacddadba	TRUE
cbabcabcbbcdccddbdd	TRUE
cbcdbbbcccbbabbdacc	TRUE
cbcdbbbdbcadbabacab	TRUE
ccbadaddbacbcabdbbc	TRUE
ccbadadddadcacdbbcc	TRUE
ccdccbcbacadcbdadcc	TRUE
ccdcccbbabbddbcccac	TRUE
cdccbabbadacbbddbba	TRUE
cdccbadbaccddddbacc	TRUE
dabdbbccccbbacdabda	TRUE
dabdbcabddcaddccacd	TRUE
dadcdbbdccbaccabbbd	TRUE
dadcdbdadbbdabcdcad	TRUE
dbcacccabbacddababc	TRUE
dbcaccdacbbddbacaca	TRUE
dcacbbdabacacccaddb	TRUE
dcacbcbdddadddaddac	TRUE
dccdcbccdcdbbdcdacb	TRUE
dccdcddbdccbcdbacab	TRUE
ddbbbdbacabcbbacdbb	TRUE
ddbbcabaddbcacddcba	TRUE
aaaaaaaadddacbcdcbc	FALSE
aaaaaacdadbcaccbbbd	FALSE
aaccbbbcbdbdbbddbdc	FALSE
aaccbbcbadcadbacbdb	FALSE
abbadddabcabcadbdaa	FALSE
abbbaaacdbbaabbdcaa	FALSE
abddcabbaaccbabcaac	FALSE
abddcbbbdddadaddbaa	FALSE
accbdcbbbccabcdadaa	FALSE
accbddbaaccbbdcbabb	FALSE
adbaacaadddcbaaaccb	FALSE
adbaacdaaccbdaadbdd	FALSE
adddadbbbabaabdddda	FALSE
adddaddddcdcaddcaab	FALSE
bacbbbcacddcabdddaa	FALSE
bacbbbcdcbcdbbaddaa	FALSE
bbbabbccdabadbaadcb	FALSE
bbbabbdcadbbdbdcaab	FALSE
bbdcbdbbbbbbacabdaa	FALSE
bbdcbdcdabddccbcaac	FALSE
bccacabbacddbacbbaa	FALSE
bccacadddbcdcbaacdc	FALSE
bdacdbcbcdcdbbcdcaa	FALSE
bdacdcaccddabccccaa	FALSE
bddaddaabbacbcccadd	FALSE
bddaddcbbbbcdcadaac	FALSE
cabccabdadaddbdaacc	FALSE
cabccaccbcdcbdcccaa	FALSE
cbaaccdabddbabddacb	FALSE
cbaaccdaccbababaddb	FALSE
cbcdbbbcccbbaabdacc	FALSE
cbcdbbbdbcadbababaa	FALSE
ccbaccdcbbcbdcdadaa	FALSE
ccbadabdcaccabdbbaa	FALSE
ccdccbcbabaccbdadaa	FALSE
ccdcccbbaabddbcccab	FALSE
cdccbaabadacbbddbba	FALSE
cdccbacbaccddddbaac	FALSE
dabaacddbdbdaccadca	FALSE
dabaadcaabaccbdbdbc	FALSE
dadcdabdaacccbcbddc	FALSE
dadcdacaadcadccaaaa	FALSE
dbcacbaababddaaaacd	FALSE
dbcaccbcdbababacaaa	FALSE
dcabddddaddadbaadbb	FALSE
dcacaaddaddacaabccd	FALSE
dccdcbccdcdbbdcdaab	FALSE
dccdcddbdccbcdbabaa	FALSE
ddbbbdbabaacbbabdbb	FALSE
ddbbcabaddbcacddcaa	FALSE
