aaaaaaadaa	TRUE
aaaaaacaca	TRUE
aacccdaacd	TRUE
aacccdcdcc	TRUE
acaaaaaacc	TRUE
acaaaaccda	TRUE
acccadcdca	TRUE
acccadcdda	TRUE
acddcddcdd	TRUE
acdddaacac	TRUE
adcccaaaac	TRUE
adcccaaadd	TRUE
adddccadca	TRUE
adddcccadc	TRUE
bacdaadccc	TRUE
bacdaadddc	TRUE
bbadaacaaa	TRUE
bbadaacaad	TRUE
bbdbbcdacd	TRUE
bbdbbdadac	TRUE
bcbdbdbcca	TRUE
bcbdbdbcda	TRUE
bdacddaaac	TRUE
bdacdddaad	TRUE
bddcaacadc	TRUE
bddcacaadd	TRUE
cacccccdad	TRUE
caccccdacc	TRUE
cbadaaaaaa	TRUE
cbadaacccd	TRUE
cbdbaaacac	TRUE
cbdbaacdca	TRUE
ccbcaacddc	TRUE
ccbcacdcdd	TRUE
cdaaaddacc	TRUE
cdaaadddad	TRUE
cdcbcadacc	TRUE
cdcbccdcba	TRUE
daadadccdd	TRUE
daadadddca	TRUE
daddaaddac	TRUE
daddacaada	TRUE
dbcacdcaac	TRUE
dbcacdcdcd	TRUE
dcadadcccd	TRUE
dcadaddcac	TRUE
dcdbbbbddb	TRUE
dcdbbbdacd	TRUE
ddbbdacada	TRUE
ddbbdbbdcd	TRUE
aaaaaabaac	FALSE
aaaaaabada	FALSE
aaccabccdb	FALSE
aaccabddbc	FALSE
abbaddbdcc	FALSE
abbbaaaadb	FALSE
acaaabbdcc	FALSE
acaaabdcaa	FALSE
accdadcabd	FALSE
accdbabcad	FALSE
adbcababdd	FALSE
adbcabbbcb	FALSE
adddcaaaba	FALSE
adddcabadd	FALSE
bacbbaabca	FALSE
bacbbacada	FALSE
bbacdcdadb	FALSE
bbacddbdaa	FALSE
bbdbbacdcb	FALSE
bbdbbbbaab	FALSE
bcbcddddab	FALSE
bcbdaadabb	FALSE
bdabbbdacc	FALSE
bdabbddbca	FALSE
bdcdbbcdab	FALSE
bdcdbcabcb	FALSE
cabbdcbaca	FALSE
cabbdccdab	FALSE
cbaadbcabc	FALSE
cbaaddbdbd	FALSE
cbdabddaad	FALSE
cbdaccbaba	FALSE
ccbdacdcbb	FALSE
ccbdadbcbc	FALSE
cdabcbdcaa	FALSE
cdabcdcddb	FALSE
cdcdbaccdb	FALSE
cdcdbbdbab	FALSE
dabbbbabdb	FALSE
dabbbbbcba	FALSE
dbaaacdccb	FALSE
dbaaaddaab	FALSE
dbcabcaabc	FALSE
dbcabcdbac	FALSE
dcabbbaaab	FALSE
dcabbbbcba	FALSE
dccddabccc	FALSE
dccddacccb	FALSE
ddbbdabbbb	FALSE
ddbbdbdaab	FALSE
aaaaaaaaacd	TRUE
aaaaaaadaaa	TRUE
aaccacddcaa	TRUE
aaccacddcca	TRUE
acaaaaacaad	TRUE
acaaaaadcdc	TRUE
accccdccadc	TRUE
accccddcacd	TRUE
adaacadddda	TRUE
adaaccaccda	TRUE
adccdadcaac	TRUE
adccdccdada	TRUE
addddadccda	TRUE
addddaddddc	TRUE
bacddadccaa	TRUE
bacddaddaaa	TRUE
bbbbccbdddc	TRUE
bbbbccdbbac	TRUE
bbdcdbdbcac	TRUE
bbdcdcaccda	TRUE
bccbaadcdcd	TRUE
bccbacccddc	TRUE
bdacccdcdac	TRUE
bdacdadadcc	TRUE
bdcdcdcaacd	TRUE
bdcdcdcacca	TRUE
cacaaccdccc	TRUE
cacaacdccdc	TRUE
cbaacadcacc	TRUE
cbaacadcddc	TRUE
cbccdcddbdb	TRUE
cbccddacdda	TRUE
ccbbaaccdaa	TRUE
ccbbaaccdaa	TRUE
ccddbbacdda	TRUE
ccddbcdaadc	TRUE
cdcbbaacacc	TRUE
cdcbbacdcaa	TRUE
daadcaacdad	TRUE
daadcacccca	TRUE
daddaddaadc	TRUE
daddcacadaa	TRUE
dbcaddccadc	TRUE
dbcadddcaac	TRUE
dcacdcacdca	TRUE
dcacdcadaad	TRUE
dccdbddacad	TRUE
dccdcaadaaa	TRUE
ddbbdbdcbdd	TRUE
ddbbdddbbcb	TRUE
aaaaaabaaca	FALSE
aaaaaabadda	FALSE
aacbddbcddb	FALSE
aaccaabbcaa	FALSE
abbaccbdcbb	FALSE
abbacdabbbc	FALSE
acaaabcdddb	FALSE
acaaacbabca	FALSE
accdacbcdaa	FALSE
accdadaaccb	FALSE
adbbacdadda	FALSE
adbbadcbdbc	FALSE
adddbcbbdab	FALSE
adddbcddbca	FALSE
baccbdacada	FALSE
baccbdccdda	FALSE
bbbbccbddab	FALSE
bbbbccdbbab	FALSE
bbdcdbdbcab	FALSE
bbdcdcaccdb	FALSE
bccbabbbdcd	FALSE
bccbabbdddb	FALSE
bdacabcabad	FALSE
bdacabdcdad	FALSE
bdcdcdcaabd	FALSE
bdcdcdcabca	FALSE
cabbcdcadcb	FALSE
cabbcddbdcc	FALSE
cbaacaadbcb	FALSE
cbaacacccdb	FALSE
cbccdcddbab	FALSE
cbccddaccdb	FALSE
ccbbaacccab	FALSE
ccbbaaddadb	FALSE
ccddbbacdcb	FALSE
ccddbcdaadb	FALSE
cdcbbaababc	FALSE
cdcbbacdcab	FALSE
dababdbddcd	FALSE
dababdccbda	FALSE
dadcbddadad	FALSE
dadcbddbbab	FALSE
dbcaddacbdc	FALSE
dbcaddbbaab	FALSE
dcacbcacdcb	FALSE
dcacbccabbc	FALSE
dccdbddabad	FALSE
dccdcaacdab	FALSE
ddbbdbdcbab	FALSE
ddbbdddbbab	FALSE
aaaaaaaaacdc	TRUE
aaaaaaadaadc	TRUE
aaccaacadadd	TRUE
aaccaaccaadc	TRUE
acaaaaadaacd	TRUE
acaaaaadacad	TRUE
accccddcaacc	TRUE
acccdaadcaad	TRUE
adaaccccdadc	TRUE
adaacccdcccc	TRUE
adccdcaaadca	TRUE
adccdcaacddd	TRUE
addddcaadada	TRUE
addddcadadac	TRUE
bacddddadcad	TRUE
bacdddddadaa	TRUE
bbbacccaccdc	TRUE
bbbacdaaacac	TRUE
bbdcbbccbccd	TRUE
bbdcbcaaddaa	TRUE
bccaccadddac	TRUE
bccaccddcdda	TRUE
bdacccdaacca	TRUE
bdacccdaddac	TRUE
bddaaaaadaad	TRUE
bddaaaacdddc	TRUE
cacaaadaaaaa	TRUE
cacaaccccdac	TRUE
cbaaaccadaaa	TRUE
cbaaacdddaac	TRUE
cbcdcadcadca	TRUE
cbcdcbbcdbdb	TRUE
ccbbdbddcbca	TRUE
ccbbdcaddaaa	TRUE
cdaadcdccaaa	TRUE
cdaaddacaddc	TRUE
cdcccbaadddc	TRUE
cdcccbadacca	TRUE
dacaaaaaacad	TRUE
dacaaaccadaa	TRUE
daddaddcddac	TRUE
daddaddcddcc	TRUE
dbcbadacdcaa	TRUE
dbcbadcadacd	TRUE
dcbaacdacaca	TRUE
dcbacaaaaada	TRUE
dcdbddbcbaaa	TRUE
dcdbddcbbaaa	TRUE
ddbcccdbbbbc	TRUE
ddbccdcaadac	TRUE
aaaaaabaacaa	FALSE
aaaaaabadaca	FALSE
aacbcdaaabda	FALSE
aacbdacbcbda	FALSE
abbbcbdbbbca	FALSE
abbbcbdccada	FALSE
acaaaadddcab	FALSE
acaaabbcbdbc	FALSE
acccdccddccb	FALSE
acccdcdadcab	FALSE
adbbdcddabdb	FALSE
adbbdddacdcc	FALSE
adddbbdadbcd	FALSE
adddbdaadacb	FALSE
baccbbdaaccb	FALSE
baccbdcccaca	FALSE
bbbabcacaaac	FALSE
bbbabddccbaa	FALSE
bbdcbbccbcab	FALSE
bbdcbcaacdba	FALSE
bccacbaddacd	FALSE
bccacbbbbbcb	FALSE
bdacabaccbac	FALSE
bdacabddbadc	FALSE
bddaaaadbbaa	FALSE
bddaaababbdc	FALSE
cabbbbdcabda	FALSE
cabbbdaaddcb	FALSE
cbaabcccdaba	FALSE
cbaacabcdaba	FALSE
cbcdcadcaccb	FALSE
cbcdcbbcdbab	FALSE
ccbbdbddcbab	FALSE
ccbbdcaccaab	FALSE
cdabababbcad	FALSE
cdabababbcdd	FALSE
cdcccbabdcdc	FALSE
cdcccbadabca	FALSE
dabaddcbabbc	FALSE
dabbababccbd	FALSE
dadcddbbccba	FALSE
dadcddddcbba	FALSE
dbcbadabdcab	FALSE
dbcbadbbdabc	FALSE
dcbaabdabaca	FALSE
dcbabababdbc	FALSE
dcdbddbcbaab	FALSE
dcdbddcbbaab	FALSE
ddbcccdbbbab	FALSE
ddbccdcaacab	FALSE
aaaaaaacdccdd	TRUE
aaaaaacaadcca	TRUE
aaccaadccaaad	TRUE
aaccacaccadcd	TRUE
aaddcdacaacca	TRUE
aaddcdaccdcca	TRUE
accadcaadadcd	TRUE
accadcadcadac	TRUE
acdcddddddcac	TRUE
acddaaacacdda	TRUE
adcacaaaacdda	TRUE
adcacaadadddd	TRUE
addcccaadcdca	TRUE
addcccaccaadc	TRUE
bacadacddaadc	TRUE
bacadcaccadad	TRUE
baddccaaaaccd	TRUE
baddccacccdaa	TRUE
bbcaacddcdacd	TRUE
bbcaadaddccac	TRUE
bcacdacdacacd	TRUE
bcacdadadccca	TRUE
bcdbaaadcddad	TRUE
bcdbaacaaacdc	TRUE
bdbcddaadcaad	TRUE
bdbcddacaaacc	TRUE
caaaddaadccdc	TRUE
caaaddcaddcac	TRUE
cadadadcdcdcc	TRUE
cadadcacacddd	TRUE
cbbcdcbdbccbb	TRUE
cbbdaaadadaad	TRUE
ccaccdcacccdd	TRUE
ccaccdcacdccd	TRUE
ccdadcddaccda	TRUE
ccdbacccaadda	TRUE
cdbdbaccdccda	TRUE
cdbdbadaadaac	TRUE
daaadddaacdcc	TRUE
daacaaaacdadd	TRUE
dadaddaaacacc	TRUE
dadcaadcaadda	TRUE
dbbadaadacccc	TRUE
dbbadacacdcac	TRUE
dbddbddaadadd	TRUE
dbddcbcdadcca	TRUE
dccccbdccdaca	TRUE
dcccccbaccadc	TRUE
ddbacacaaccdc	TRUE
ddbacacaddada	TRUE
aaaaaaccccaab	FALSE
aaaaabbbabddd	FALSE
aacbacbbabaaa	FALSE
aacbadbddaaaa	FALSE
abadabcbbddad	FALSE
abadbbcbdbdaa	FALSE
abddababcbcbb	FALSE
abddabdabbdba	FALSE
accacdddadcdb	FALSE
accadabdaccbc	FALSE
adaccddaadaab	FALSE
adaccddcbbbaa	FALSE
addaadabdaadc	FALSE
addababdcbadd	FALSE
babccaccdaaaa	FALSE
babccaccdccaa	FALSE
baddbdacbbbcb	FALSE
baddbdcaabbda	FALSE
bbcaacaacdcbd	FALSE
bbcaadadaddab	FALSE
bcacabcdbbbcd	FALSE
bcacacabaabca	FALSE
bcdbaaadbddad	FALSE
bcdbaacaaabdc	FALSE
bdbcddabbadab	FALSE
bdbcddabbbaac	FALSE
caabcbcdcbcca	FALSE
caabccababbdd	FALSE
cacdcadddccdb	FALSE
cacdccaabbadd	FALSE
cbbcdcbdbccab	FALSE
cbbdaacbcdcdc	FALSE
ccacadcccdcdb	FALSE
ccacbbcaccddd	FALSE
ccdadcddacbca	FALSE
ccdbababbcdba	FALSE
cdbdbabcdbbda	FALSE
cdbdbadabdbbb	FALSE
daabdbbdcabac	FALSE
daabdddcdbacc	FALSE
dadabdbbbaddb	FALSE
dadabdccacadb	FALSE
dbbacdccdabcb	FALSE
dbbadaaabdcac	FALSE
dbddbddaadadb	FALSE
dbddcbcdacbca	FALSE
dccccbdccdacb	FALSE
dcccccbabcadb	FALSE
ddbabbbbaadaa	FALSE
ddbabbdadddba	FALSE
aaaaaacccddaac	TRUE
aaaaaaccdcccdd	TRUE
aaccdcdccdcdcd	TRUE
aaccdcdddcdddc	TRUE
acaaacacccdddc	TRUE
acaaacccadaaad	TRUE
acccccccccadda	TRUE
accccccccdcadc	TRUE
adaaacddcdaadd	TRUE
adaaadaacaaaad	TRUE
adccdcaaaaadac	TRUE
adccdccccadcda	TRUE
baaaadccdacdcd	TRUE
baaaadcdadcdaa	TRUE
badaaaadaaddca	TRUE
badaaaadcaaddc	TRUE
bbbaaccccccaac	TRUE
bbbaacdcacaaaa	TRUE
bbdcbdbbbdbcbb	TRUE
bbdccbaaacccac	TRUE
bccaccaadacacc	TRUE
bccacccdacacad	TRUE
bdacdcdddadddd	TRUE
bdacddaaddcdaa	TRUE
bddacaddddcdad	TRUE
bddaccccdaccda	TRUE
cacacadcaccadd	TRUE
cacacadcdcdadc	TRUE
cbaacadcacdccd	TRUE
cbaaccccdcdada	TRUE
cbccacaddcdcdc	TRUE
cbccaccdddcdda	TRUE
ccbaccccaaadca	TRUE
ccbaccccddcadd	TRUE
ccdbdcadadadaa	TRUE
ccdbdccadacdcd	TRUE
cdcaaadccacdca	TRUE
cdcaacccddaadd	TRUE
daacaadccacaaa	TRUE
daacaadccccccc	TRUE
dadaddaacaadcc	TRUE
dadaddacccdddd	TRUE
dbbcddaadadadc	TRUE
dbbdacdccdaacc	TRUE
dcaacadddcaddc	TRUE
dcaaccdacdcdca	TRUE
dcdaaacdaddadd	TRUE
dcdaacaccccacd	TRUE
ddbcacaddcdadd	TRUE
ddbcadaaccaacc	TRUE
aaaaabadddcbca	FALSE
aaaabacadabbaa	FALSE
aaccddcbbddbcb	FALSE
aaccddcddadcab	FALSE
abbcbcbbbacbab	FALSE
abbcbdbbbbdcad	FALSE
acaaacaaddddcb	FALSE
acaaadbcbabadc	FALSE
acccdaccdbacad	FALSE
acccdbabddaaca	FALSE
adbcacaaadbbdb	FALSE
adbcacadbcabcc	FALSE
baaabacbcdcabd	FALSE
baaabbccbdddda	FALSE
baccbbbadaccda	FALSE
baccbcdacdbccd	FALSE
bbbaadbcabbcbc	FALSE
bbbaadbddbcbda	FALSE
bbdcbdbbbdbcab	FALSE
bbdccbaaacccab	FALSE
bccabcbbdaabdd	FALSE
bccacaaccababa	FALSE
bdacbdcacbcdad	FALSE
bdacbdccddcdba	FALSE
bddabdaacccdcd	FALSE
bddabdbdcddbcd	FALSE
cabcacbadadbdd	FALSE
cabcacbddcdacb	FALSE
cbaabdadcaccbb	FALSE
cbaacabcccdbda	FALSE
cbccaccbaadccd	FALSE
cbccaccbbdaacc	FALSE
ccbacbaadbddda	FALSE
ccbacbdcdcadba	FALSE
ccdbdcadadacab	FALSE
ccdbdccadbcdcd	FALSE
cdcaadcdcbcbcd	FALSE
cdcaaddacbddaa	FALSE
daabbdadbacbca	FALSE
daabcaacbabccb	FALSE
dadabcdbcbaacc	FALSE
dadacbccbccdcd	FALSE
dbbcddaacadacb	FALSE
dbbdacccdaabcc	FALSE
dcaacddcabbbba	FALSE
dcaadaddbbbbdc	FALSE
dcdaabcccdbdda	FALSE
dcdaabdacacccb	FALSE
ddbcabdcdcdadd	FALSE
ddbcadaaccbacc	FALSE
aaaaaacccddaacd	TRUE
aaaaaaccdccddaa	TRUE
aacccdcdddccddc	TRUE
aacccddcdacdadc	TRUE
acaaaadcaaaadac	TRUE
acaaaadcaddaddd	TRUE
acccdcdccacddac	TRUE
acccddcaaadadcc	TRUE
adaaaddddacaacd	TRUE
adaacaacaccadda	TRUE
adccdccacdaaada	TRUE
adccdcdaacaccac	TRUE
baaaacaadcaaaca	TRUE
baaaacacaddadcd	TRUE
bacddadacddccaa	TRUE
bacddadaddaadca	TRUE
bbbbbcadddadcda	TRUE
bbbbbdaacdaddac	TRUE
bbdcbcaccccccda	TRUE
bbdcbcccdcbcccc	TRUE
bccbaaccddcaccc	TRUE
bccbacdaacacaac	TRUE
bdadaddcdcdddda	TRUE
bdadcaacaacaadc	TRUE
bddaaaaaacdacdd	TRUE
bddaaacdcaadccd	TRUE
cacacacacacccca	TRUE
cacacaccaacdacd	TRUE
cbaaacacccaccdc	TRUE
cbaaaccdccccaac	TRUE
cbcbcbbdaaccddc	TRUE
cbcbdadcdccadaa	TRUE
ccacdddccaddadd	TRUE
ccadaaaacddaaad	TRUE
ccdbaddaccaaddd	TRUE
ccdbbaadcddaccc	TRUE
cdbdbbdbcdbcacd	TRUE
cdbdbcbdbccacdc	TRUE
daaadcddaacccca	TRUE
daaadcddadaacda	TRUE
dadaccdcaaccdca	TRUE
dadacdaacdaacac	TRUE
dbbcdbcadddcdcd	TRUE
dbbcdcddaadcdaa	TRUE
dcacddccddccacd	TRUE
dcacddcddccaccd	TRUE
dccdbbccdbcaacc	TRUE
dccdbcbaacaddac	TRUE
ddbacaccccccada	TRUE
ddbacdaaacdcadd	TRUE
aaaaaabbccbcbcb	FALSE
aaaaacbaabddddb	FALSE
aaccacbddaadbda	FALSE
aaccaccdbbddaab	FALSE
abbccdabaccbcbc	FALSE
abbcddadadbcdcd	FALSE
acabbdbbdcddaad	FALSE
acabbdcbbccbbca	FALSE
acccbcbcaabacaa	FALSE
acccbdaabddddbc	FALSE
adbaadccaadacda	FALSE
adbaadccbddadac	FALSE
addcbcaccbacdba	FALSE
addcbccdcabdbad	FALSE
bacaaacacbdcbbb	FALSE
bacaababbbdddad	FALSE
bbabdaddbbdcaad	FALSE
bbabdbacdbdcbcc	FALSE
bbccdaaccdaabad	FALSE
bbccdadbdbaadac	FALSE
bcbaabdbddaddbc	FALSE
bcbaacdbcdccbdd	FALSE
bcdcdcbbaaacdab	FALSE
bcdcdddcbcbddab	FALSE
bdcbbddcdbacddb	FALSE
bdcbcabacddaaac	FALSE
caaddcabcbddbcb	FALSE
caadddadbadcccc	FALSE
caddabcbbdbdbdd	FALSE
caddabdcdcabaaa	FALSE
cbcbdacadbdbabc	FALSE
cbcbdaccdcabcdc	FALSE
ccbaacbdcbbdbdc	FALSE
ccbababcabcddda	FALSE
ccdcdcdcbbcaadb	FALSE
ccdcddbdadbdbdc	FALSE
cdcaadacbcdccba	FALSE
cdcaadadadbbaba	FALSE
daaccabddbacdbd	FALSE
daaccbbabdccaab	FALSE
dadbbcdbbabdaad	FALSE
dadbcaacacaddba	FALSE
dbbdbcaaabccadd	FALSE
dbbdbcccddbdaab	FALSE
dcabddabddcdaab	FALSE
dcabddcdcddbccd	FALSE
dccddbbcdbbaadb	FALSE
dccddcaadbcacdd	FALSE
ddbcdbdcbcabcdb	FALSE
ddbcddacdcddbbd	FALSE
aaaaaaaaaaaddcaa	TRUE
aaaaaaaaaadacaca	TRUE
aaccccdadcadadca	TRUE
aaccccdadcadcdaa	TRUE
acaaccaaacacddda	TRUE
acaaccadacddcddd	TRUE
acccdcacddcdccdd	TRUE
acccdcaddccdcdca	TRUE
adaaacaacaaaddcc	TRUE
adaaaccaaccdcacc	TRUE
adccaccaacadddad	TRUE
adccacccacdddaad	TRUE
adddccacdcacaadc	TRUE
adddccacddccdcca	TRUE
bacdccaaaccdaaaa	TRUE
bacdccaaaddaacdc	TRUE
bbadcadddaaccccc	TRUE
bbadccdacadcaddc	TRUE
bbdadddaacdddaca	TRUE
bbdaddddcdaaccad	TRUE
bcbcdacdcacadccd	TRUE
bcbcdbacdcdadadd	TRUE
bdaaddadaadccccc	TRUE
bdaaddaddcdcdada	TRUE
bdcdacacccaddadd	TRUE
bdcdacdaaccddcaa	TRUE
caadcdcdcaddcdaa	TRUE
caadcdcdcdcdcaaa	TRUE
caddadaaddaadaad	TRUE
caddadcacadcacad	TRUE
cbcadcccddddccaa	TRUE
cbcaddcaadddddca	TRUE
ccadcccacaaaacda	TRUE
ccadccdcaaccaccc	TRUE
ccdbdadaaaacdcdc	TRUE
ccdbdadcacdcaddc	TRUE
cdcaacccaaacaacd	TRUE
cdcaacccddccadad	TRUE
daacaddccccaddcc	TRUE
daacaddcddadcacd	TRUE
dadcacaacdddadcc	TRUE
dadcaccaaaacaada	TRUE
dbbcbbdaccddcada	TRUE
dbbcbbdbddaadaca	TRUE
dcaaaaaaacdaadca	TRUE
dcaaaaaadcddaaac	TRUE
dcccdacacadaddad	TRUE
dcccdccbadadcddd	TRUE
ddbaddcdaaadadac	TRUE
ddbadddaadcadacd	TRUE
aaaaacacabcabbac	FALSE
aaaaadbcacbcaccb	FALSE
aacdbaacccadcbac	FALSE
aacdbbcbddbbdbbb	FALSE
abbcaadaddcccaaa	FALSE
abbcaaddaacadbdb	FALSE
acaacbbbdbabcaba	FALSE
acaaccccdabbaddb	FALSE
accdbdaddbddbccd	FALSE
accdbdcddbcaccad	FALSE
adbbcabaacccadab	FALSE
adbbcabbcabcbdbb	FALSE
baaabccaadbaacdd	FALSE
baaabcdbdcccbbdc	FALSE
bacdcabacdadccba	FALSE
bacdccdbdadabbba	FALSE
bbbccddbbdbdabcb	FALSE
bbbcdbaacdccadab	FALSE
bcaacadaadbcbbac	FALSE
bcaacbadabddbabb	FALSE
bccbbcdbdacddbca	FALSE
bccbbcdddcdbaaab	FALSE
bdadcdacdddadadb	FALSE
bdadcdadcbbdcdaa	FALSE
bddacddbacdbddbc	FALSE
bddacddbbbaadccd	FALSE
cabdbbbdacbbcaab	FALSE
cabdbcabcabababa	FALSE
cbaabbaaddadabba	FALSE
cbaabbbdabcacbdb	FALSE
cbcccbbbbcdacacb	FALSE
cbcccbddddddcacb	FALSE
ccbbabddaabadadc	FALSE
ccbbadbbdaaccdac	FALSE
ccddbadaaadadcdb	FALSE
ccddbadabdaaadab	FALSE
cdcbdccdccabcbdd	FALSE
cdcbddccababdabb	FALSE
daadaabcacbbaadb	FALSE
daadabcabacaaaca	FALSE
dadbaabbdbadbcad	FALSE
dadbaabbdbbcbdcb	FALSE
dbbdbdcaaddccccb	FALSE
dbbdcaaacdcbcadc	FALSE
dcabacabddccccdc	FALSE
dcabadbcdcbaabad	FALSE
dccdabdadacaaacc	FALSE
dccdbbbddbbadcab	FALSE
ddbbbdbddaddcddb	FALSE
ddbbbdcbdbacccbd	FALSE
aaaaaaacadaaadcdc	TRUE
aaaaaacacacadaadd	TRUE
aaccaddaadacdccac	TRUE
aaccadddaacccadac	TRUE
aaddddcaccccadccd	TRUE
aaddddccadacaaaca	TRUE
accccadaacdadccda	TRUE
accccaddcdaaacacc	TRUE
adaaaaaaacdaadcda	TRUE
adaaaacacaaddaadc	TRUE
adcdaadaaddaddcda	TRUE
adcdaaddaaacccdaa	TRUE
baaaccaacacdaacca	TRUE
baaaccaccddccdacc	TRUE
badacaaadddacaddc	TRUE
badacaacaadaacdaa	TRUE
bbbacdddcccadcaac	TRUE
bbbadaaaadcccacda	TRUE
bbdccaaadcddddcad	TRUE
bbdccadaacddcaaca	TRUE
bccbcbbaddccaddcd	TRUE
bccbcbbccaaccacca	TRUE
bdaddcacdcccdacda	TRUE
bdaddcccddcadcaca	TRUE
bddbbaadcdccaddcd	TRUE
bddbbcadadcdaacad	TRUE
cacacddaacdaacadd	TRUE
cacadaaacadcddadd	TRUE
cbacaaccadcccacac	TRUE
cbacaadaddaccdaaa	TRUE
cbcdadcacccccacdd	TRUE
cbcdadccaaaccaadd	TRUE
ccbbccacacdaaccac	TRUE
ccbbccadddcadaaca	TRUE
ccddcdbbadadccadc	TRUE
ccdddaacaaaccadcc	TRUE
cdcbbcdbcdacdcacc	TRUE
cdcbbddddbdaaacda	TRUE
daacccaacdcddcaad	TRUE
daaccccdacddddccd	TRUE
dadcacaaaaccdddcc	TRUE
dadcaccacddadcdcc	TRUE
dbbcaacaaacaddccc	TRUE
dbbcaacccdcdcdaac	TRUE
dcaccaaccddcdcaca	TRUE
dcaccacdcaadccccd	TRUE
dccdcdbdcbbbddcac	TRUE
dccddacaccaccdcca	TRUE
ddbbbdadcccaaacdc	TRUE
ddbbbdadcdccdadda	TRUE
aaaaadcdcddcacadb	FALSE
aaaabacacbbaaccdc	FALSE
aacbdbcaadaccbccb	FALSE
aacbdbcbadcbdbaad	FALSE
abaddbbddbcacbdac	FALSE
abaddbbddbdacdbbb	FALSE
abdbcdcababccacca	FALSE
abdbdababbccdadcc	FALSE
accaaccadccbbdaca	FALSE
accaadcdbbcbdbcbc	FALSE
adacdbbdcbccaadad	FALSE
adacdbddddcccdabc	FALSE
addcaacaaaccbccba	FALSE
addcaadbbcdbcbdab	FALSE
bacabdbbabbdcddca	FALSE
bacacbbaaacdddaac	FALSE
bbabcdadcbcdababc	FALSE
bbabcdbcdadcdbbab	FALSE
bbcdcaacacabcadac	FALSE
bbcdcacdabdaaabca	FALSE
bcbcadbabacdddacc	FALSE
bcbcadcdaadadbacd	FALSE
bdabbcaadbcbbabac	FALSE
bdabcaaaaccdacdbb	FALSE
bdcdcddcbabcbdadb	FALSE
bdcddaadcbdbdbbdc	FALSE
cabbbcabacddccccb	FALSE
cabbbcbcbcbdbaabd	FALSE
cadccdcbacbbbbabc	FALSE
cadccddbbbcdaccba	FALSE
cbbddbbbddadbadbc	FALSE
cbbdddbadcbcbdacb	FALSE
ccaccaaaabbadccad	FALSE
ccaccbabdcbdbabbc	FALSE
ccdabaaabdcbccbbb	FALSE
ccdababcbbbaddabc	FALSE
cdbcbcbcdcdbcabdb	FALSE
cdbcbcdbccdbcccab	FALSE
daaacabbdddaccbcc	FALSE
daaacadadbdbaadca	FALSE
dacdbaaaadccbdabd	FALSE
dacdbadbbbdacbdcb	FALSE
dbbaddbddadadbadd	FALSE
dbbbacababcdcacdc	FALSE
dbddbdcddacdabadd	FALSE
dbddcacddaaddbaaa	FALSE
dcccacccaaddabcab	FALSE
dcccacdabbbacbdcd	FALSE
ddbbaccbccacdbdab	FALSE
ddbbaddbccbbcddad	FALSE
aaaaaaaacaaccdaacc	TRUE
aaaaaaaacddadcaaca	TRUE
aaccccdadaaadccaac	TRUE
aaccccddddddadaddd	TRUE
aadddacccccdaccada	TRUE
aadddacdaccccddaac	TRUE
accaddcaaaacdacdad	TRUE
accaddccaccaadadda	TRUE
acddaacdccadacacad	TRUE
acddaadaccddaccadd	TRUE
adcadaadaadddccdac	TRUE
adcadaaddcaaacdcad	TRUE
adddacaaadadadcaaa	TRUE
adddacaadcacdadaaa	TRUE
bacccddcadaaacdadc	TRUE
baccdaaadacaadddcd	TRUE
bbadaadadadcaaccac	TRUE
bbadaadaddcddddcdc	TRUE
bbdbadadacaaccaccd	TRUE
bbdbbacadcadaddddc	TRUE
bcbdbadcddcddadaac	TRUE
bcbdbaddaadcdcaaca	TRUE
bdaaaccacacaadccca	TRUE
bdaaadaacdacaadadd	TRUE
bdcdadadccdcaaaadc	TRUE
bdcdbacacadadcdccd	TRUE
cacaadccdddaaccadd	TRUE
cacaadcdcdcaccacca	TRUE
cbaacadcdaacdccccc	TRUE
cbaacdadaadcdadcda	TRUE
cbccacaaacaaacacca	TRUE
cbccacacaaaccccdca	TRUE
ccaddcdaadaaacddda	TRUE
ccaddcddaacaaaadac	TRUE
ccdaadddcadcacaddc	TRUE
ccdacaacdddcdcdddd	TRUE
cdbcbaacadddcacadd	TRUE
cdbcbbdaacadddcadc	TRUE
daaaccacdcaccadaaa	TRUE
daaaccddacaddadccd	TRUE
dadaccddddcccdaaac	TRUE
dadacdaadadadcaccd	TRUE
dbbcdcbaacccacdcdc	TRUE
dbbcdccdadaadadacd	TRUE
dcaacddccaccdcadaa	TRUE
dcaadacaddddaaadac	TRUE
dcccdaccddcdccddcc	TRUE
dcccdadcaaaaadddca	TRUE
ddbadacddcdddcdaad	TRUE
ddbadadcdaddccaadc	TRUE
aaaaaacacadbaadabc	FALSE
aaaaacbdbbccaadcaa	FALSE
aacbbdcdacddbdaddc	FALSE
aacbcaccbdacdcddda	FALSE
abadbccdabcbdadabc	FALSE
abadbdbacbbbbcbbdc	FALSE
abdbcaabcbbdddbadb	FALSE
abdbcaacbdadcccdad	FALSE
accbacbabdccddabaa	FALSE
accbacdbbdbaaabbba	FALSE
adadaabbaacdbbacaa	FALSE
adadabbbdccccadcad	FALSE
addbdaaddccccbabad	FALSE
addbdbaacaaabadbbb	FALSE
babdabdabbbcaacabd	FALSE
babdabddbadbbacbba	FALSE
bbabcadccddcadcaab	FALSE
bbabcbadcbdaacdabb	FALSE
bbcddcddbbadbbcccb	FALSE
bbcdddbababbdabccd	FALSE
bcbbbadccbabacbbba	FALSE
bcbbbbaadbabcabddd	FALSE
bcdcadaaaacdbcbcaa	FALSE
bcdcbabbcacdbbbbdd	FALSE
bdbdddaddcadccabdb	FALSE
bdbdddbcbbaccacccb	FALSE
caacdaaabdbdbcadca	FALSE
caacdadadbbdcaadbd	FALSE
cadbccdadcaabddbdb	FALSE
cadbcdadcdbddbaccd	FALSE
cbbdbabbdaadcbdabc	FALSE
cbbdbbbcbacbadbcdb	FALSE
ccabdbbacddadddcaa	FALSE
ccabdcbaddaaccddab	FALSE
ccdbcbbddabddadabb	FALSE
ccdbcbcdaacacacddb	FALSE
cdcacadcabccdacdbb	FALSE
cdcacbddadcddaddaa	FALSE
daacbcdcbabccbbccc	FALSE
daaccacadcdbaaabda	FALSE
dadbaddbccdbbdcbab	FALSE
dadbbaaaabadabdbbb	FALSE
dbbdcaaaabaaddbcca	FALSE
dbbdcaadbaabdadbad	FALSE
dcacaabdbabcaabbcc	FALSE
dcacabbdaadddadcda	FALSE
dcdadcddbbaacacadb	FALSE
dcdaddbabbacbccacc	FALSE
ddbcbbcbcaabdbcdda	FALSE
ddbccabcaacbbddabc	FALSE
aaaaaacaaccccdacdcc	TRUE
aaaaaaccacadacaddac	TRUE
aaccdaaaadddaaaadca	TRUE
aaccdaccdccdaaadaca	TRUE
acaaaadadccccdcdcca	TRUE
acaaacadccacddaddda	TRUE
acccadcdcacadccddda	TRUE
acccaddccdcdadaccca	TRUE
adaaacdadccdddddcad	TRUE
adaaadaaadcddadccaa	TRUE
adcadccddcdaddadcca	TRUE
adcaddccacdadadccaa	TRUE
adddacadcadaacccdda	TRUE
adddaccaadddccdadca	TRUE
baccccdaaaaaccdacca	TRUE
bacccdaddacacccdaaa	TRUE
bbadcadadcadcdadccc	TRUE
bbadcccaadcacacdcac	TRUE
bbdadaadddccacddada	TRUE
bbdadacdcddcaaaaddc	TRUE
bcbcdbadddcdaadddda	TRUE
bcbcddbcccdacdaacac	TRUE
bdaaacdacdadccdaaca	TRUE
bdaaacdaddcdadcadda	TRUE
bdcbdbadadadcdcdaac	TRUE
bdcbdbdcbadacacaaaa	TRUE
caadaacadccddaccccc	TRUE
caadaadacdaaccddccc	TRUE
cadcdadccdaadccccad	TRUE
cadcdcacddacddddcac	TRUE
cbbdbcaaddaccdaddcd	TRUE
cbbdbcdacacddcdcdda	TRUE
ccacaddcdcccaaaacaa	TRUE
ccaccaaaccddddaacdd	TRUE
ccdbcadccccacdadccd	TRUE
ccdbcbdaacaddcaacaa	TRUE
cdcaacaccdcccdaaccd	TRUE
cdcaacdadddccaddcdd	TRUE
daaaddaacdadaaacaaa	TRUE
daaaddaccaadccacaad	TRUE
dadaccddcdccaadddad	TRUE
dadacdaccddadadaccd	TRUE
dbbccdcbddbcdadadac	TRUE
dbbcdbadcadcadaaaca	TRUE
dcadaaccdcdcdcaaddc	TRUE
dcadacacacaacadaacd	TRUE
dcdadaddadddcdaddcd	TRUE
dcdadcdcccccdacdddc	TRUE
ddbcccacdddaaacadda	TRUE
ddbccdbaddddacdddda	TRUE
aaaaaaaddacddbdbccd	FALSE
aaaaaabadccbdcadbaa	FALSE
aacccbdbcdbdaddacdd	FALSE
aaccccbbcacacadcbdb	FALSE
abbcaabbababbcdadca	FALSE
abbcabccaaddbadbbac	FALSE
acaadbcbabbcbdccdca	FALSE
acaadbdadbcabddbaba	FALSE
acccbbadcdaadcbdbcb	FALSE
acccbcdabdddbccbdcc	FALSE
adbadabcacccaacaaac	FALSE
adbadbabdcbcccddaad	FALSE
addbbcccdccbacdccbd	FALSE
addbbdbcbdcbaaccacb	FALSE
bacaaaabcbbccdbadac	FALSE
bacaabdddbaaddcadba	FALSE
bbadaaabaccadcdadcc	FALSE
bbadaaadbbbcddaccab	FALSE
bbdadaaacdcdbcabcda	FALSE
bbdadbbacbbcdbaaaad	FALSE
bcbcdbadddbcaacddda	FALSE
bcbcddbcccdacdbacbb	FALSE
bdaaacdddbcdcbcdaba	FALSE
bdaabbbbccabacbbdbd	FALSE
bdcbdbadadaccdccaab	FALSE
bdcbdbdcbadabacbaba	FALSE
caadddaadccbcbbdbac	FALSE
cabaacacbabadbccbca	FALSE
cadbbbaabcccaddaada	FALSE
cadbbbadddcacddddba	FALSE
cbbdbcaadcacbdadccd	FALSE
cbbdbcdacabddcdccda	FALSE
ccabddaabcbabbadacb	FALSE
ccabddbbacaddbaaadb	FALSE
ccdbcacccccabcbdcbc	FALSE
ccdbcbdaacaddcaabba	FALSE
cdcaaacadabcdcbbdaa	FALSE
cdcaacbbdadddccbddb	FALSE
daabcbaadacbdadcbcc	FALSE
daabccbaaccbddbbcca	FALSE
dacddcbcccdabaaccab	FALSE
dadaaaadabcddddaccb	FALSE
dbbccdcbddbcdadadab	FALSE
dbbcdbaccadcacbaabb	FALSE
dcacdccbcccdcabbbda	FALSE
dcacddcddacbdbcccdc	FALSE
dcdaccddbdbacddcdad	FALSE
dcdadadbcbccdacdddc	FALSE
ddbcccaccddbabbbcdb	FALSE
ddbccdbaccccabdccda	FALSE
