abbbbbccbc	TRUE
abbbbbcddd	TRUE
abcccdbbcb	TRUE
abcccdbbcb	TRUE
acbbbccdcc	TRUE
acbbbdbbcb	TRUE
acccdbccdd	TRUE
acccdbcdbc	TRUE
adbbbcdccb	TRUE
adbbbcdcdc	TRUE
adccbcdddd	TRUE
adccbdccdb	TRUE
addddcbcdd	TRUE
addddccbcd	TRUE
badbbdbddc	TRUE
badbbddbbc	TRUE
bbbacccdbb	TRUE
bbbaccdccc	TRUE
bbdbcdbcdd	TRUE
bbdbdbabbb	TRUE
bcbdcbbdcd	TRUE
bcbdccdbac	TRUE
bdacdcccdb	TRUE
bdacdcdbdc	TRUE
bddabbbdcb	TRUE
bddabbdcdb	TRUE
cacbcdcddd	TRUE
cacbcddbdc	TRUE
cbabccccdc	TRUE
cbabcdbbcd	TRUE
cbccddaccc	TRUE
cbccdddadb	TRUE
ccbacbcdbc	TRUE
ccbacbdbdc	TRUE
ccdcbbacbb	TRUE
ccdcbbbbbd	TRUE
cdcabddddd	TRUE
cdcacbcbbc	TRUE
dabccdcdcb	TRUE
dabccddbbb	TRUE
dadcdcbddd	TRUE
dadcdccbdc	TRUE
dbbdacbbdd	TRUE
dbbdadcdcb	TRUE
dcabbbcddd	TRUE
dcabbcbcbc	TRUE
dccccbccba	TRUE
dccccbdacc	TRUE
ddbaccbccd	TRUE
ddbacccbbd	TRUE
aaaaababbd	FALSE
aaaaabbabd	FALSE
aacbcacdcc	FALSE
aacbccacab	FALSE
abbbaabbca	FALSE
abbbbaadba	FALSE
acacabcdcc	FALSE
acacabdcdc	FALSE
accddaacdd	FALSE
accddacaab	FALSE
adbbdcbcda	FALSE
adbcacaaca	FALSE
adddcbcbca	FALSE
adddcbdcca	FALSE
bacccbbdba	FALSE
bacccdddaa	FALSE
bbbacbbdad	FALSE
bbbacbcacb	FALSE
bbdbcdbcaa	FALSE
bbdbdbaaaa	FALSE
bcbdcbbdaa	FALSE
bcbdccdbaa	FALSE
bdaccabdab	FALSE
bdaccabdad	FALSE
bddaabadda	FALSE
bddaacadcb	FALSE
cabcbdacbd	FALSE
cabcbdaddb	FALSE
cbaadabaab	FALSE
cbaadacbdc	FALSE
cbccddacca	FALSE
cbccdddada	FALSE
ccbabccaba	FALSE
ccbabcccda	FALSE
ccdcbbabaa	FALSE
ccdcbbbbaa	FALSE
cdcabadbbc	FALSE
cdcabadcdd	FALSE
daadbabcaa	FALSE
daadbacbdb	FALSE
dadbdcaaab	FALSE
dadbdcacab	FALSE
dbbdacaadd	FALSE
dbbdadbcba	FALSE
dcaaabbcdc	FALSE
dcaaacabca	FALSE
dccccbccaa	FALSE
dccccbdaba	FALSE
ddbabbdcba	FALSE
ddbabcccab	FALSE
abbbbbccbcb	TRUE
abbbbbcdddb	TRUE
abcccbdcbdd	TRUE
abcccbdcdbc	TRUE
acbbbbdcccd	TRUE
acbbbbdcddc	TRUE
accccbddccc	TRUE
acccccbcbcd	TRUE
adbbbdcccdd	TRUE
adbbbdcdccd	TRUE
adccdddbbdc	TRUE
adccddddddb	TRUE
addddcdbdbc	TRUE
addddcddbbc	TRUE
bacddbdbbdd	TRUE
bacddbdcbcc	TRUE
bbbbabccdbb	TRUE
bbbbabddcdc	TRUE
bbddacbdcdc	TRUE
bbddacdbccd	TRUE
bccbaddbbcd	TRUE
bccbaddbcbc	TRUE
bdacddbdbbd	TRUE
bdadbbbbddd	TRUE
bddacbcddcb	TRUE
bddaccbcdcb	TRUE
cacbcbcbccb	TRUE
cacbcbdcccc	TRUE
cbabbcccccb	TRUE
cbabbdbcdbb	TRUE
cbccdccdcca	TRUE
cbccddbbbba	TRUE
ccbadbbdccd	TRUE
ccbadbcbdbb	TRUE
ccdbdccadbc	TRUE
ccdbddcacdb	TRUE
cdbdbbcbbcb	TRUE
cdbdbbdbbbc	TRUE
dabccdcdbbc	TRUE
dabccdcdcdb	TRUE
dadcdbcbdcb	TRUE
dadcdbdbbbd	TRUE
dbbdbcdbabb	TRUE
dbbdbcddbba	TRUE
dcaccbdbccd	TRUE
dcaccbdbdbb	TRUE
dccdcddbbbc	TRUE
dccddbcbcdc	TRUE
ddbbcbbbdad	TRUE
ddbbccacdcb	TRUE
aaaaababbdc	FALSE
aaaaabbbdbc	FALSE
aacbdbbdcbb	FALSE
aaccabdcaad	FALSE
abbbdbbbcba	FALSE
abbbdbdbaba	FALSE
acabdbbbaab	FALSE
acabdcdbdbd	FALSE
accdcaaabad	FALSE
accdcabbcdc	FALSE
adbacccccbc	FALSE
adbaccdaadb	FALSE
adddadddccc	FALSE
adddbbcacda	FALSE
bacccbcbdca	FALSE
baccdbcbcca	FALSE
bbbbaabcdaa	FALSE
bbbbaaddcdb	FALSE
bbddabbccda	FALSE
bbddabcaacb	FALSE
bccbacdcaac	FALSE
bccbadcbaab	FALSE
bdaccdcccca	FALSE
bdaccddddca	FALSE
bddabcbbdca	FALSE
bddabddcbba	FALSE
cabcaddcdda	FALSE
cabcbbbcadd	FALSE
cbaababbcdd	FALSE
cbaabacabaa	FALSE
cbccdccdcaa	FALSE
cbccddbbbaa	FALSE
ccbacccbacd	FALSE
ccbaccdadab	FALSE
ccdbdccadac	FALSE
ccdbddcabda	FALSE
cdbdbbcbbaa	FALSE
cdbdbbdbbaa	FALSE
daacdbdddcb	FALSE
daacdccdabb	FALSE
dadbcaaacba	FALSE
dadbcaadaad	FALSE
dbbdbcdbaba	FALSE
dbbdbcddbaa	FALSE
dcabdddbdaa	FALSE
dcacaaaaadb	FALSE
dccdcddbbaa	FALSE
dccddbcbcaa	FALSE
ddbbcbbbdaa	FALSE
ddbbccacdba	FALSE
abbbbbccbcbd	TRUE
abbbbbcddbdb	TRUE
abccccdcdccd	TRUE
abccccddbdcc	TRUE
acbbbbcdbbbc	TRUE
acbbbbdbcccc	TRUE
accccccbcdbb	TRUE
acccccccccbd	TRUE
adbbbccbbdbc	TRUE
adbbbccbddcd	TRUE
adccbdcccddc	TRUE
adccbdccdbdd	TRUE
addddbdccbdd	TRUE
addddbddcbcc	TRUE
bacdcbbcbdbd	TRUE
bacdcbbdccbd	TRUE
bbbabbdbccdc	TRUE
bbbabbddbdcb	TRUE
bbdbccdcacdb	TRUE
bbdbcddbaccc	TRUE
bcbddaccbcdb	TRUE
bcbddbabcbcb	TRUE
bdacbdddddbd	TRUE
bdaccbcccbbd	TRUE
bdcdccbcabcc	TRUE
bdcddbcccbdd	TRUE
cacbbccbbdbd	TRUE
cacbbccccddc	TRUE
caddcccdcbcc	TRUE
caddccdbbdbd	TRUE
cbcbdaccdbbb	TRUE
cbcbdbabcdcd	TRUE
ccaddbdddcbb	TRUE
ccaddcdbcdcc	TRUE
ccdcbbdcdcdb	TRUE
ccdcbbddbbdd	TRUE
cdcaccbddccd	TRUE
cdcacccbbdbb	TRUE
dabccdcdccdb	TRUE
dabcdbbbccdd	TRUE
dadcbbbbccbc	TRUE
dadcbbbbcdbb	TRUE
dbbbdacccddd	TRUE
dbbbdbadbcdd	TRUE
dcabdcddbbcc	TRUE
dcabddbbbcdc	TRUE
dccdadccddcc	TRUE
dccdadcdcdbb	TRUE
ddbcadbccbdd	TRUE
ddbcadcbcccd	TRUE
aaaaabbbccad	FALSE
aaaababdbdbc	FALSE
aacdbadaabca	FALSE
aacdbbbaacac	FALSE
abbbdabdcdab	FALSE
abbbdaddcada	FALSE
acaabadcbbdd	FALSE
acaabbaadabd	FALSE
accdaaacbdab	FALSE
accdaacbcdcc	FALSE
adadddbbbdcc	FALSE
adbaabdbcbdc	FALSE
addcaabbdccb	FALSE
addcaadabccc	FALSE
bacaccadacba	FALSE
bacaccccbccc	FALSE
bbaddbcadddc	FALSE
bbaddbdbccba	FALSE
bbdcbddcabba	FALSE
bbdccbcbddaa	FALSE
bccaaaabdada	FALSE
bccaaabaaddd	FALSE
bdacccabdbcc	FALSE
bdacccdaabcd	FALSE
bddabdcaadba	FALSE
bddacaaadaaa	FALSE
cabdaddabbab	FALSE
cabdbaadaadb	FALSE
cbabaaacbacd	FALSE
cbababbaabca	FALSE
cbcdbbbaddad	FALSE
cbcdbbdabacb	FALSE
ccbcabbcaaad	FALSE
ccbcabdbddaa	FALSE
cdaadddaaaab	FALSE
cdabaacbdbac	FALSE
cdccaadbdcab	FALSE
cdccabaaddbc	FALSE
daadbcbddcaa	FALSE
daadbdcacaab	FALSE
dadbbdabccbd	FALSE
dadbbdcadacb	FALSE
dbbdbadcddba	FALSE
dbbdbbaadbdd	FALSE
dcacbcbbccba	FALSE
dcacbccabacd	FALSE
dcdaaccadcbd	FALSE
dcdaadcbcbcb	FALSE
ddbcddccabca	FALSE
ddbdabaababa	FALSE
abbbbbbbdbddb	TRUE
abbbbbbbdcddb	TRUE
abccddbcdcbdd	TRUE
abccddbdbbdcb	TRUE
acbbbcbbcccbb	TRUE
acbbbcbcbbddb	TRUE
acccdcccddbbd	TRUE
acccdcdbcdbdc	TRUE
adbbbbbbbcdbd	TRUE
adbbbbbbddcbd	TRUE
adccccbccdddb	TRUE
adccccbddbdcc	TRUE
adddcbccdcddd	TRUE
adddcbdcbcbbc	TRUE
baccdddcbcddd	TRUE
bacdbbccbdcdb	TRUE
bbacdddcbbbdb	TRUE
bbacdddcdcccd	TRUE
bbdbdaccdcccb	TRUE
bbdbdbabdcbcc	TRUE
bcbdbdcbddacd	TRUE
bcbdcbcbaccbd	TRUE
bdabddddbdcbc	TRUE
bdacbbbbbbddb	TRUE
bddabcdbbddcb	TRUE
bddabcdcbccbc	TRUE
cacbcdbdccbdc	TRUE
cacbcdcbdcdbd	TRUE
cbacbcddbddbc	TRUE
cbacbdccdbcdc	TRUE
cbcdadcbdbdbd	TRUE
cbcdadcdbdbcc	TRUE
ccbcacdcddcdd	TRUE
ccbcadcdccbdd	TRUE
cdabbdcbccbdd	TRUE
cdabbdccccbdd	TRUE
cdcbddacbbddd	TRUE
cdcbddcdadcdb	TRUE
dabdcbccddcbb	TRUE
dabdcbdbcccbb	TRUE
daddbdbcbcdbc	TRUE
daddbdbddbdbb	TRUE
dbcabdcdccbbc	TRUE
dbcabddbdbcdc	TRUE
dcabdddbdbcbb	TRUE
dcabdddcdddbb	TRUE
dccdcabbcdbdb	TRUE
dccdcbbadbcdc	TRUE
ddbbbcadddcdb	TRUE
ddbbbdbacdbbc	TRUE
aaaaabbbccada	FALSE
aaaabbbdbccbb	FALSE
aacdabaabbbbd	FALSE
aacdababcaccb	FALSE
abbbbddcbccda	FALSE
abbbcabbbbada	FALSE
acaacabaaccab	FALSE
acaacbabbbcad	FALSE
acccdcbdabdcd	FALSE
accdaabbdaacc	FALSE
adbadbcabbdaa	FALSE
adbadbdbbacdd	FALSE
addbcaadbddcd	FALSE
addbcbcddcaab	FALSE
bacabddccccab	FALSE
bacacacdbacad	FALSE
bbaccadddcbcc	FALSE
bbaccbacaabac	FALSE
bbdbdacbdccba	FALSE
bbdbdbaaccacb	FALSE
bcbdbdcbddaba	FALSE
bcbdcbcbaccad	FALSE
bdabadcbdcabc	FALSE
bdabbaaddcaab	FALSE
bddaacddddbba	FALSE
bddaadcadaacc	FALSE
cabcbadcacdba	FALSE
cabcbadccbcba	FALSE
cbabcdbaaccbc	FALSE
cbabcddccddab	FALSE
cbcdadbdadaca	FALSE
cbcdadcbadabb	FALSE
ccbcacbddcdda	FALSE
ccbcacdcdbcba	FALSE
cdaaacbcadbda	FALSE
cdaaaccdbcabc	FALSE
cdcbddacaaddd	FALSE
cdcbddcdacbda	FALSE
dabaadaddbbdd	FALSE
dababaaccdcbb	FALSE
dadcbcdddcdba	FALSE
dadccabbcaadc	FALSE
dbcabcbbabbbb	FALSE
dbcabcdbdccda	FALSE
dcabcaccababa	FALSE
dcabcbbdcbcaa	FALSE
dccdcabacdacb	FALSE
dccdcbbacabdc	FALSE
ddbbbcacdccca	FALSE
ddbbbdbacdaab	FALSE
abbbbbbdbccdbc	TRUE
abbbbbccbdcbbc	TRUE
abcccbbcbbdddd	TRUE
abcccbbccbcdcd	TRUE
abdddbdcdcdddd	TRUE
abdddbddddbdcb	TRUE
accbdcbdbdbbbd	TRUE
accbddbddbdddc	TRUE
acddbcbdbcbccb	TRUE
acddbcbdccbdbc	TRUE
adcbccbcbcbbcc	TRUE
adcbccbdccccdd	TRUE
adddcbcddbddbb	TRUE
adddcbdbcbcdcd	TRUE
bacdcbccccbdcb	TRUE
bacdcbcdcddccd	TRUE
bbbacdccdbdbcb	TRUE
bbbadbbdbbbdcc	TRUE
bbddadccbddbcd	TRUE
bbddbadbdddbcd	TRUE
bccacdddcdddbb	TRUE
bccadbdbbdcdbd	TRUE
bdadbdbddccdcd	TRUE
bdadbdcbddcccd	TRUE
bddadccdcbccbd	TRUE
bddadcdccbbcbb	TRUE
cacbcccdddbcbb	TRUE
cacbccdbcbdbdb	TRUE
cbabbddbdcdbcd	TRUE
cbabbddccbddcc	TRUE
cbccabbddcddcc	TRUE
cbccabdbcbcccc	TRUE
ccbadbdddbdbbc	TRUE
ccbadccbccccbb	TRUE
ccdcbccbdabbbc	TRUE
ccdcbccdabccdb	TRUE
cdbddbddcbcddb	TRUE
cdbddcdcbddcdc	TRUE
dabcbdcbdbdbbc	TRUE
dabcbddcdbcdbd	TRUE
dadcbcdccbcccb	TRUE
dadcbcdcddbbcc	TRUE
dbbdbbbdddcddd	TRUE
dbbdbcabdcdccc	TRUE
dcabcccccccddb	TRUE
dcabcccdcccddd	TRUE
dccddcacdcdbdd	TRUE
dcdabbbcbcccbd	TRUE
ddbcbdbabcdcbb	TRUE
ddbcbddabdbcdd	TRUE
aaaaabbdbbabbc	FALSE
aaaaacabcdbcaa	FALSE
aacbbbbbadbccb	FALSE
aacbcabcbdcabc	FALSE
abadcdaacbdcbc	FALSE
abadcddaadccdd	FALSE
abdcdacdcbbabc	FALSE
abdcdbadbcbbad	FALSE
accabdcbbdcbad	FALSE
accabdcbddccda	FALSE
adaccadddcbcad	FALSE
adaccbaadabbdb	FALSE
addccdbcaaabda	FALSE
addccdbccdccad	FALSE
bacbbabbabbbda	FALSE
bacbbbaddcabba	FALSE
bbbacdbbdacbcd	FALSE
bbbacddaddacda	FALSE
bbddacbbaddbbd	FALSE
bbddbadacddabd	FALSE
bccaccbbccbbda	FALSE
bccaccbddadadc	FALSE
bdaccbadadcada	FALSE
bdaccdbbdbdcba	FALSE
bddadbbcaacbca	FALSE
bddadcbbbaacba	FALSE
cabcbcccbbdadc	FALSE
cabcbcddadcada	FALSE
cbaabcacdddcba	FALSE
cbaabdacbcbcaa	FALSE
cbccaaaccbddcc	FALSE
cbccaaccdbaccb	FALSE
ccbadbadadabcb	FALSE
ccbadbdabbbcba	FALSE
ccdcbccbdabbab	FALSE
ccdcbccdabccda	FALSE
cdbddbddcbcdaa	FALSE
cdbddcdcbddcaa	FALSE
daacbbdddabdbd	FALSE
daacbddcbbbcbd	FALSE
dadbaacbbbdbdd	FALSE
dadbaacdacbdad	FALSE
dbbdbbbdddcdaa	FALSE
dbbdbcaaccdbcb	FALSE
dcabbabbdbbcdb	FALSE
dcabbbacaacacd	FALSE
dccddcacdbdacd	FALSE
dcdaaaababbdac	FALSE
ddbcbdbaacccba	FALSE
ddbcbddaadacdd	FALSE
abbbbbbdbccdbcc	TRUE
abbbbbcbdcbbccc	TRUE
abcccdcbbbcddbd	TRUE
abcccdcddcccbdc	TRUE
abdddcbbbbdcbcd	TRUE
abdddcbbdbccccd	TRUE
accbdbbbbcbdccd	TRUE
accbdbbbdbddbcb	TRUE
acddbcddbbcbccd	TRUE
acddbcddddcbccb	TRUE
adccbccbbdbddbc	TRUE
adccbccbddbcdcb	TRUE
adddcdcbcddcbdd	TRUE
adddcdcbdbccbdd	TRUE
baccdcdddbdddbd	TRUE
baccddcdcdbcbcb	TRUE
bbadbccdbddcdbb	TRUE
bbadbccdcdbbbdd	TRUE
bbdbabddcdbccbb	TRUE
bbdbbcbdcbadbcd	TRUE
bcbdbacdcbcdbdb	TRUE
bcbdbbbadbbdddc	TRUE
bdabdbcdcdbdbbc	TRUE
bdabdcbdcbbcbbd	TRUE
bdcddbbbbbcadcc	TRUE
bdcddbcbddadbcb	TRUE
cacbdbdcbddcdcd	TRUE
cacbdcbdbddbdbd	TRUE
cbabcddbdccbdbc	TRUE
cbabdcbbbbbdcbc	TRUE
cbcdabccdbddcdb	TRUE
cbcdacbdbcddbbc	TRUE
ccbabcbdbdbbccb	TRUE
ccbabccccdbccbb	TRUE
ccdccdacdbccddd	TRUE
ccdccdadbdbbccc	TRUE
cdcaccbbddbccbb	TRUE
cdcaccbdcbbdbcc	TRUE
dabcbccbcdcbcbd	TRUE
dabcbccdbbdcbdc	TRUE
dadbdcdcdbbdbbc	TRUE
dadbddbbbbcccbd	TRUE
dbbcadcdbdddcdb	TRUE
dbbcbacbbbcbbcb	TRUE
dcabbdcdccddccb	TRUE
dcabbddbccdccdb	TRUE
dcccdbbbcaddbbc	TRUE
dcccdbcdbcbcccb	TRUE
ddbcaccdbcdcdcd	TRUE
ddbcaccdcccdbbd	TRUE
aaaaaaccddadbdb	FALSE
aaaaabdddadbcab	FALSE
aacaccbaacbaddb	FALSE
aacaccdadbacabc	FALSE
abaccbabcbdcbda	FALSE
abacccbbbcaacbc	FALSE
abdbcbbabbbdbcb	FALSE
abdbcdabbccdcbb	FALSE
acbdacbdacdcddc	FALSE
acbdbabbddbaabb	FALSE
adabaccdbacbbba	FALSE
adabadbaacacbcc	FALSE
addbababdcdbcba	FALSE
addbabbbaadbcad	FALSE
babdcabbdcbcacc	FALSE
babdcadddabcbba	FALSE
bbabdcdddbddbda	FALSE
bbabddddcbabcbb	FALSE
bbdacbdabccabab	FALSE
bbdacdbacdcacba	FALSE
bcbbdabdabccaba	FALSE
bcbbdbbcacdabcc	FALSE
bdabbcaacbaabbc	FALSE
bdabbdcadcdbcad	FALSE
bdcdbdadabadbcb	FALSE
bdcdbddacbdcdba	FALSE
cabbbdccacdbadb	FALSE
cabbcaabdadbaad	FALSE
caddbabbcaaacdd	FALSE
caddbbbbbaabddd	FALSE
cbccadaabbdabdc	FALSE
cbccadcacddcbcc	FALSE
ccbabcdaaacdbba	FALSE
ccbabdadaaaaadc	FALSE
ccdcbbcdaccccac	FALSE
ccdcbbdaabdcbbd	FALSE
cdcababbadabacc	FALSE
cdcababcccccbca	FALSE
daabdbccbddbaaa	FALSE
daabddcbddcbdda	FALSE
dadacccaddabddd	FALSE
dadaccccabcbccd	FALSE
dbbcdababcccbcb	FALSE
dbbcdacbcdabbbb	FALSE
dcaaadcdddabbdb	FALSE
dcaabbaddcdbbbb	FALSE
dcccbbbdcaabcbc	FALSE
dcccbbccacccdab	FALSE
ddbadbbdacbcbca	FALSE
ddbadcbccdddacb	FALSE
abbbbbbdddcdbdcc	TRUE
abbbbbcbcbccbbbc	TRUE
abcbdcdcccccbddb	TRUE
abcbdcddccdcbcbc	TRUE
abddbbbbbccbccdb	TRUE
abddbbbbbdccccdd	TRUE
accbcdbddbbbbbdd	TRUE
accbcdbddcbcbbbb	TRUE
acdcdcdcdbccbdbb	TRUE
acdcdcddbdddbccc	TRUE
adcbcbbbbccccccd	TRUE
adcbcbbcbbccdbbb	TRUE
addccdbdbdbdcdcc	TRUE
addccddbcddccdcb	TRUE
baccdcddbccddbdb	TRUE
baccddbdcdbcbbcc	TRUE
bbadbdcdbdcddcdb	TRUE
bbadcbbccddccdbd	TRUE
bbdbdccbbdabdbcb	TRUE
bbdbdccbddacdddc	TRUE
bccacbbbccbbcbdb	TRUE
bccacbbcdbcbcdcb	TRUE
bdadbddbdcddcbcb	TRUE
bdadcbbcbdcdbbbc	TRUE
bddabdcbdcbddbdc	TRUE
bddabdcddbbcdbcb	TRUE
cacbcbbbbcbcbccb	TRUE
cacbcbbcbbcdbcbb	TRUE
cadddbddcbdbbcbc	TRUE
cadddcbbccdddccc	TRUE
cbccaddddcbbcbbc	TRUE
cbccbbabdcddddcc	TRUE
ccbaccdccdddbbcc	TRUE
ccbacdbcccbcbbbc	TRUE
ccdcacdbbbdddcbb	TRUE
ccdcadcddcddcbcd	TRUE
cdcabcbbccdbdcbd	TRUE
cdcabcccddbbdcdc	TRUE
dabbdcbcccdbbccb	TRUE
dabbdccddbbbdddd	TRUE
dadbcbbbcccdcbdd	TRUE
dadbcbbddbdcdbdd	TRUE
dbbbdcbbadcccdbb	TRUE
dbbbdcccadbbdbbc	TRUE
dcabdbdbddbccdcb	TRUE
dcabdcbcdbccbccb	TRUE
dcccdabccdbcdccb	TRUE
dcccdbacbbdcdccb	TRUE
ddbbccbbbcdbbcdb	TRUE
ddbbccbdbcdbbbcd	TRUE
aaaaaaddcbaacbad	FALSE
aaaabaabdcbdacad	FALSE
aacdaaddcacdbacc	FALSE
aacdabadbbcdccdd	FALSE
abbbadabbadcaabd	FALSE
abbbadccabcbabbb	FALSE
abddaabcdcabdddd	FALSE
abddabadbabbadba	FALSE
accbbaadaaacdacc	FALSE
accbbacacbbadcda	FALSE
adbacbccaaaacdcb	FALSE
adbaccadcaddabcc	FALSE
addbdbdcddacbabd	FALSE
addbddbdbdaabbda	FALSE
babdddacccdbddca	FALSE
bacaaaabbcbbacdb	FALSE
bbacbcadaadcadac	FALSE
bbacbccbaccdddaa	FALSE
bbdbaddbadccddbc	FALSE
bbdbbaaadcbdaaac	FALSE
bccacacaddccdddb	FALSE
bccacbcdcabbbdab	FALSE
bdacacbcadcdbaba	FALSE
bdacacbdaadacdcb	FALSE
bdccddddbdcaccca	FALSE
bdcdaabbadadcadd	FALSE
cabbaddcbacaaddb	FALSE
cabbbadaaddbcdca	FALSE
cadddbbbccdcbaab	FALSE
cadddcacbabcbdbb	FALSE
cbcbadaabdcbcdca	FALSE
cbcbadadcbbdddbc	FALSE
ccadcaccbdadccaa	FALSE
ccadcaddcabbaabc	FALSE
ccdbbbdddccdbaab	FALSE
ccdbbccdaaacaaca	FALSE
cdbdbadbdbbacddb	FALSE
cdbdbbcccddcbdaa	FALSE
daabbacbddcadacd	FALSE
daabbacdabbcabcd	FALSE
dacdbcaabcbbcbcd	FALSE
dacdbcacbdddadbb	FALSE
dbbbcbdbcccdcdaa	FALSE
dbbbcccabadccacc	FALSE
dbddccbcdddccdaa	FALSE
dbdddabbbddbdbaa	FALSE
dcccbddbcddabdda	FALSE
dccccbaabbdacacd	FALSE
ddbcbdabdbcdcaab	FALSE
ddbcbdbbabdcdbac	FALSE
abbbbbbdcdbddcddb	TRUE
abbbbbcbddbccdbdc	TRUE
abcccdcbcccdbdcdc	TRUE
abcccddbbccbdbdcc	TRUE
abddddbddcddcdbcd	TRUE
abddddcbbbcbddbbb	TRUE
accccbbbddbcdddcd	TRUE
accccbbcbddcdcccd	TRUE
acddcdcbcccdbcbdd	TRUE
acddcddbdbcbbbdbc	TRUE
adccbbddbbddbdbdb	TRUE
adccbbdddbcbbcdcb	TRUE
adddbcdbddddbcdcd	TRUE
adddbcdcbddddbddb	TRUE
baccbbddbcbdbcdcd	TRUE
baccbbddcbcbcbdcd	TRUE
bbaccdbcdcbdbdccc	TRUE
bbaccdddbddcdccdc	TRUE
bbdabdcddddbcdcdd	TRUE
bbdacbbbdbbdcbbcc	TRUE
bcbbddadcbdddddcc	TRUE
bcbcabbbbbcddbcbb	TRUE
bdabbbbcdbdcbcddc	TRUE
bdabbcbbbdcddccdd	TRUE
bdccbacbcbbbcdccc	TRUE
bdccbbbccddccccdb	TRUE
cabdcdbbccbdbcddc	TRUE
cabdcdcbbdcbbcbcd	TRUE
caddcbddbbbbcdcdc	TRUE
caddccbbbddbbdccc	TRUE
cbccadcbddcbdbddc	TRUE
cbccbcabbbbccdddd	TRUE
ccbabdbccccdbbbdc	TRUE
ccbacbbddddccdcdd	TRUE
ccdcacdcbcdcdcbcc	TRUE
ccdcadcdcbdccbcdb	TRUE
cdbdcabcccbbccbbb	TRUE
cdbdcbadddcdcbdcd	TRUE
dabbcdccccdbdcbdc	TRUE
dabbcddbbcdbdcccb	TRUE
dacddbdcbbdbbbccd	TRUE
dacddbdcbcbbbdbcc	TRUE
dbbbaddbdbcbbbcbb	TRUE
dbbbadddddbcccbbd	TRUE
dcabccbddcbbdbdbd	TRUE
dcabcdbbbbdcbcbdd	TRUE
dcccaddcdccddddbc	TRUE
dcccbacddcdcbcccd	TRUE
ddbbcaccdbdbbbddc	TRUE
ddbbcbbcabcbdbdcc	TRUE
aaaaadcdcabddadad	FALSE
aaaabbcdddbaccbba	FALSE
aacdcacaddccdcadc	FALSE
aacdcaddbaabadabb	FALSE
abbbabcddcaadbdbb	FALSE
abbbbacbadacbbadc	FALSE
abddacccdbacdbdcd	FALSE
abddacdacdcaabdab	FALSE
accbadddabccbcddc	FALSE
accbbaadbdddcbbcc	FALSE
adbbdcccdbccdaada	FALSE
adbbdcdababcbddcb	FALSE
adddbaadbcacbcbca	FALSE
adddbbadbacdaabad	FALSE
bacbbbbabbdabcbac	FALSE
bacbbbdcbabbabcdd	FALSE
bbadaacabbcbccbdd	FALSE
bbadadcaacabbcbbb	FALSE
bbdadbabdbcdcadbd	FALSE
bbdadbbdddacaabcc	FALSE
bcbbdbbddacbddadd	FALSE
bcbbdcbcbcccabcaa	FALSE
bdaaadbaabbbcbbca	FALSE
bdaaadbcdbccbdcda	FALSE
bddaaaadadbbbbdbb	FALSE
bddaabadddcbacbcc	FALSE
cabbddcadcddaaaca	FALSE
cabbddcbaaaddbdcb	FALSE
caddabcddcdddbdad	FALSE
caddbaabcbbdabcaa	FALSE
cbcbdccdabdccdaad	FALSE
cbcbdcdcbabccbbba	FALSE
ccbacaaaacacbcbba	FALSE
ccbacadadbcbddcad	FALSE
ccddbabddcddcdbca	FALSE
ccddbbbcdccadccca	FALSE
cdccbbcacbbacaaca	FALSE
cdccbcbbccabbbbda	FALSE
dabacbcbbadaacaab	FALSE
dabaccacdccdaacab	FALSE
dadccccbbccadcaab	FALSE
dadccdcbbbbcbcdca	FALSE
dbcaacabaadbbadac	FALSE
dbcaacabacbdadaca	FALSE
dcacacadbacaacddd	FALSE
dcacadabdabdcdcdc	FALSE
dcccdadcdbacadadc	FALSE
dcccdcddaabaadaad	FALSE
ddbccbbabcaabbaca	FALSE
ddbcccaaababbdbda	FALSE
abbbbbbcdbdbcddddb	TRUE
abbbbbbcdbdcdcbccb	TRUE
abccbcbcdbdcdcdcbb	TRUE
abccbcbdcddddccdbb	TRUE
abdcdddcbcbbbbdbbc	TRUE
abddbbbdbddddbbbbd	TRUE
acbddbcccddbddbbbc	TRUE
acbddbdbdbbcbdcccd	TRUE
acdccccdccbbbdddbd	TRUE
acdcccdbddcbbdcdcd	TRUE
adbddddcbdbdbcbbcd	TRUE
adbdddddbdbbdddbbc	TRUE
addcbdbcbcdddcdcdb	TRUE
addcbdcbbdbcddcbdc	TRUE
bacbdccdbcbbddcddb	TRUE
bacbdccdcbcdbcbdcb	TRUE
bbacbcddddddcbcbcb	TRUE
bbacbdbdcdddbddbbc	TRUE
bbcdcacdcbdcdcbdbb	TRUE
bbcdccbccdaddddbcb	TRUE
bcbadbdccdbbdcbbcc	TRUE
bcbadccbdddbccbbcc	TRUE
bcdccddbaddbdbbbbc	TRUE
bcdccddcaccbcdcbbc	TRUE
bdcbadcdbbdcddcdbd	TRUE
bdcbbaccdbccbdcdbd	TRUE
cabcdddbdbbcddcbdc	TRUE
cabcddddcddcdbdbdc	TRUE
cadccdcbbbdccbcccc	TRUE
cadccdcdbbbbbccbcb	TRUE
cbbdadcdbcddccdcbc	TRUE
cbbdadcdcddbbdbcbb	TRUE
ccacdcbbcddbbcccbb	TRUE
ccacdcbbdbbbbddcdb	TRUE
ccdacdccbddcdcccdd	TRUE
ccdacdcddccbdbddcc	TRUE
cdbdcacdcbbdcdbbcd	TRUE
cdbdcbabcbdbddbcbb	TRUE
dabcbbcbccddbbdcdd	TRUE
dabcbbdbbcbdbbdbdb	TRUE
dadcbcbcdbddcccbdb	TRUE
dadcbcccdbbbccdcbc	TRUE
dbbcdbacbcbbdbcdcd	TRUE
dbbcdbbcbcdbbacbcd	TRUE
dcacccdddcdccbcccb	TRUE
dcaccdbcbbdcbbdbbd	TRUE
dcdabddddddcdddbcd	TRUE
dcdacbcbbdddbcbcbd	TRUE
ddbcccabddccdbcbbc	TRUE
ddbcccbbbbadccbbbb	TRUE
aaaaaabaaadbaddbad	FALSE
aaaaaabdaacbbddcdb	FALSE
aacbbbcdabcccbbdcb	FALSE
aacbbbddbcbadacdab	FALSE
abaccdcbbdbccdcbcb	FALSE
abaccdcdbbbbcaadba	FALSE
abdaadbcbdabccbcbd	FALSE
abdaaddadbbdadbcab	FALSE
acbbdddaccaadbaccd	FALSE
acbcaadadcacdbbdca	FALSE
adaacbcbddcddbbcca	FALSE
adaacdaddabacacddb	FALSE
adcddacadacadaccad	FALSE
adcddbbcacbaaaadcb	FALSE
babcbcbdadbdddaddb	FALSE
babcbcdbabaaacdabc	FALSE
bbabcbdacdadcdbcba	FALSE
bbabccbcbcbdabcbcd	FALSE
bbcdcaccccacdcadaa	FALSE
bbcdccbccdaddcdaba	FALSE
bcbadacbdbacbaabcc	FALSE
bcbadadcbdcdabcaac	FALSE
bcdccddbaddadaaaac	FALSE
bcdccddcabcacdbaab	FALSE
bdcbadcdaadbddcdbd	FALSE
bdcbbacbdaccadbcac	FALSE
caadbbcdcbadaaccdb	FALSE
caadbcddbbddbdbdac	FALSE
cadbdbbbbabbdadcbd	FALSE
cadbdbbcddcabbcabc	FALSE
cbbdadccbbddbcdcab	FALSE
cbbdadcccddaadabab	FALSE
ccaccadabdbcdbabdd	FALSE
ccaccdbaaababaccbd	FALSE
ccdacbaddcdcccddcd	FALSE
ccdacbbaacbcbcbbac	FALSE
cdbdcabccaadbdabbd	FALSE
cdbdcbabaaddabaaca	FALSE
daacaacbcadbacabad	FALSE
daacacabbbdcabdccb	FALSE
dadabbcccbcccdccbc	FALSE
dadabccbcacadcbcba	FALSE
dbbcdbabababdacdcd	FALSE
dbbcdbbcbcdbbacbba	FALSE
dcacadbdddcabdcdcb	FALSE
dcacbaadcccaadcabd	FALSE
dcdaadbdccdbcdcbcd	FALSE
dcdabbbcabdddbbabb	FALSE
ddbcccaadcbcdabaab	FALSE
ddbcccbbbbadbcaaaa	FALSE
abbbbbbbdddbbbbcddc	TRUE
abbbbbccbddbddddccb	TRUE
abcbddcdbbcbbbcbbdb	TRUE
abcbddcdcdcdbbccddd	TRUE
abddbcbdbdcbbcbdddb	TRUE
abddbcbdcbccbdcddbc	TRUE
accbcccdbbbdcbdbdbb	TRUE
accbcccdbcbbcccddcb	TRUE
acddbbbbbccdccbdcdc	TRUE
acddbbbbcdccbdbcdcc	TRUE
adcbcdbbbcbdddbccdc	TRUE
adcbcdbbbdbdcdbbdbd	TRUE
addcccbbdcbcbccbbdb	TRUE
addcccbdccbdcdcccbb	TRUE
bacbbddccddbdbccbdb	TRUE
bacbcbbcccdbdcdbcbd	TRUE
bbabbbcdcbcccccdcbc	TRUE
bbabbbcdccbccbbcdcb	TRUE
bbcbadccbbbbcccbcdb	TRUE
bbcbbabdccdbcbdddcd	TRUE
bcadcddcbcccddcbbbd	TRUE
bcadcddcdbbbdddddcb	TRUE
bcdcdadcdbbbccccdbb	TRUE
bcdcdbabbbcccbbbcdb	TRUE
bdcadbddbbccbdbcbcb	TRUE
bdcadcdbcccbbbddbdc	TRUE
cabcdbdcccbdcdcdcbc	TRUE
cabcdcbbbcccbbdbbbc	TRUE
caddbbdbcdddbddbbdd	TRUE
caddbcbbccddcbcbccb	TRUE
cbcadcbdcdcbdbbddcd	TRUE
cbcadcdccbcbddddbbb	TRUE
ccaccdddcbddcdbdddd	TRUE
ccacdbbbbdbddddbccc	TRUE
ccdabddbdbccbcbdbdb	TRUE
ccdacbbdcbbddcdcbdd	TRUE
cdbbbdddadddbbdcddc	TRUE
cdbbcacdcddddddcdbc	TRUE
dabbbcddbddcdddbdbd	TRUE
dabbbdbdbddcbcbdcdc	TRUE
dacddddbbdbcdbccccd	TRUE
dadbbbcbccdbbbdcbdb	TRUE
dbbbbccacbbbcbdbdcb	TRUE
dbbbbccbbcabdcccccd	TRUE
dcabcbcbcdbccbdbcdd	TRUE
dcabccbcddccdcdddbb	TRUE
dccccdcbadcdcdcbccc	TRUE
dcccdabbbbcddbcdccd	TRUE
ddbbcbddcbcbadbcbbc	TRUE
ddbbccacdbcddbbbcbc	TRUE
aaaaabaacdddbcabbbc	FALSE
aaaaabbccaadcddddcd	FALSE
aacbcdbbcdbacbcabda	FALSE
aacbdaadccacabddacb	FALSE
abadacdbdcccdabdbbc	FALSE
abadadcdbdacccbcbdb	FALSE
abdbcdcabadbacbaaac	FALSE
abdbdaaaabaacdbaaba	FALSE
accabcbdcacbdbbacdd	FALSE
accabccabcddcaabdba	FALSE
adacdbbaabbcdbddcab	FALSE
adacdbdabadbddddcbd	FALSE
adcdddbdbddaabcaaad	FALSE
addaaaadbabdcddccad	FALSE
babbdcacdaacbdbcdad	FALSE
babbdcbacbaadbddcac	FALSE
bbaaacadcadcdbdcccd	FALSE
bbaababbdcacdbcddad	FALSE
bbcbadbcaaabbcbabda	FALSE
bbcbbabdbcdbbacddcc	FALSE
bcadaccbaaddbbbddbb	FALSE
bcadadaaacdccdcabcd	FALSE
bcdcdadcdaaacbccdaa	FALSE
bcdcdbaaabbcbabacdb	FALSE
bdcadacbaccadbbacac	FALSE
bdcadadbbbcaabdcacb	FALSE
caadadbdbcccbaadcdc	FALSE
caadbacccbacbdcadcc	FALSE
cadcaabbdadbccccbdc	FALSE
cadcacbbbcddbdacaad	FALSE
cbcadbcbccbadbaddbd	FALSE
cbcadbccbbcabadddda	FALSE
ccacbaacdddbbadabcb	FALSE
ccacbcaacaaddaadacd	FALSE
ccdababdbacccddbabb	FALSE
ccdababdcbdbaaddcdb	FALSE
cdbbbdddacddabdbcdc	FALSE
cdbbcabccddccdcbdab	FALSE
daaabbddcabbdabdaad	FALSE
daaabcdaccccadaabdb	FALSE
daccbdbcddcbcadccaa	FALSE
dacccaddbcaddbbddbd	FALSE
dbbbbccacaaacadacba	FALSE
dbbbbccbbcabdbcccba	FALSE
dcaabbdbdacccbbaabd	FALSE
dcaaccdbaccaabacdcb	FALSE
dccccdcbaccdccbacbc	FALSE
dcccdaaabacdcabdbbc	FALSE
ddbbcbddcbcbadacabb	FALSE
ddbbccacdabdcaabcac	FALSE
