aaaaaabdad	TRUE
aaaaacaadb	TRUE
aacdbcaada	TRUE
aacdbcacdc	TRUE
abaddcaaac	TRUE
abaddcadac	TRUE
abddcdddcc	TRUE
abddcddddc	TRUE
accbdaadac	TRUE
accbdaddcd	TRUE
adbadacdcd	TRUE
adbadadcda	TRUE
addcadccba	TRUE
addcadddab	TRUE
bacacdaddc	TRUE
bacacddadc	TRUE
baddccacac	TRUE
baddccacdc	TRUE
bccaddccca	TRUE
bccaddccdc	TRUE
bcddcaccdd	TRUE
bcddcacddd	TRUE
bdccaaccaa	TRUE
bdccaadaca	TRUE
bdddaddaad	TRUE
bdddcaaaac	TRUE
cacacdbcaa	TRUE
cacacdbdaa	TRUE
cbacacddaa	TRUE
cbacacddac	TRUE
cbdcaaccdc	TRUE
cbdcaacddd	TRUE
ccbddadcdd	TRUE
ccbddaddda	TRUE
cdabcccaac	TRUE
cdabcccdda	TRUE
cdcdabadcc	TRUE
cdcdacabcd	TRUE
dabadccadd	TRUE
dabadccccd	TRUE
dadccbcdcd	TRUE
dadcccbaad	TRUE
dbcdaaaacd	TRUE
dbcdaaaacd	TRUE
dcacddbadc	TRUE
dcadaaccab	TRUE
dcdabadcda	TRUE
dcdabcaaca	TRUE
ddbcdcccac	TRUE
ddbcdccccd	TRUE
aaaaaabcbd	FALSE
aaaaacaadc	FALSE
aacdbcabad	FALSE
aacdbcbbca	FALSE
abbbadabac	FALSE
abbbadaddd	FALSE
abddcadbdc	FALSE
abddcbabbb	FALSE
accbdadacb	FALSE
accbdadacb	FALSE
adbbabbbcd	FALSE
adbbaccdcd	FALSE
addcadccbb	FALSE
addcadddaa	FALSE
bacaadbcbd	FALSE
bacabaccdc	FALSE
bbadacbdba	FALSE
bbadadaacb	FALSE
bbdbdcdbdd	FALSE
bbdcaaabaa	FALSE
bccacbcdca	FALSE
bccacccccb	FALSE
bdadbacdca	FALSE
bdadbacddc	FALSE
bddbddddca	FALSE
bddcaacbba	FALSE
cacacdbcba	FALSE
cacacdbdab	FALSE
cbacbcddbc	FALSE
cbacbdbccc	FALSE
cbdadaaabd	FALSE
cbdadabbaa	FALSE
ccbdbddaca	FALSE
ccbdcccddb	FALSE
cdabcadcab	FALSE
cdabcbabdc	FALSE
cdcdabadcb	FALSE
cdcdacabbc	FALSE
dabbaaccdc	FALSE
dabbaadada	FALSE
dadccbcdcb	FALSE
dadcccbbac	FALSE
dbcbacddcb	FALSE
dbcbaddbba	FALSE
dcacddbadb	FALSE
dcadaaccac	FALSE
dcdabbbbda	FALSE
dcdabbbdcd	FALSE
ddbccbaacc	FALSE
ddbccdaadb	FALSE
aaaaaabdadc	TRUE
aaaaacacbda	TRUE
aacdacadaba	TRUE
aacdadaabcd	TRUE
abadcdcddaa	TRUE
abaddaaaaad	TRUE
abddccddcdd	TRUE
abddcddcadc	TRUE
acccaccadab	TRUE
acccacccbdd	TRUE
adbaccdcdcc	TRUE
adbacdadacc	TRUE
addbcdaddda	TRUE
addbcdcacad	TRUE
bacaadddaaa	TRUE
bacaaddddda	TRUE
baddaacadda	TRUE
baddaacdcdc	TRUE
bccacdccdda	TRUE
bccacdcddad	TRUE
bcddacdccac	TRUE
bcddacdcdaa	TRUE
bdcacdaacdd	TRUE
bdcacdcaaac	TRUE
bdddcaddcca	TRUE
bdddccadadc	TRUE
cacbcaadddc	TRUE
cacbcacdcad	TRUE
cbadaaaacca	TRUE
cbadaaaccda	TRUE
cbdccdaaddd	TRUE
cbdccdcdcca	TRUE
ccccaaabdaa	TRUE
ccccaadaacb	TRUE
cdacdabadcd	TRUE
cdacdbacdac	TRUE
cdcdacacbdc	TRUE
cdcdacbdcdc	TRUE
dabaccdacdc	TRUE
dabaccdccda	TRUE
dadcaaddabd	TRUE
dadcacbacac	TRUE
dbcccddadaa	TRUE
dbcccddcdcd	TRUE
dcacadacaab	TRUE
dcacadcaddb	TRUE
dcdabacdadd	TRUE
dcdabaddacd	TRUE
ddbcccaacdd	TRUE
ddbccdcaccd	TRUE
aaaaaabcbdb	FALSE
aaaaacacbcb	FALSE
aacdacadabb	FALSE
aacdadaabbd	FALSE
abbbacaccdb	FALSE
abbbaccaadb	FALSE
abddacbbdcd	FALSE
abddadbdbbd	FALSE
acccaccadad	FALSE
acccacccbdb	FALSE
adbacdbdbdd	FALSE
adbadacaaab	FALSE
addbbdcdbcc	FALSE
addbcacbdcb	FALSE
babdccdcdcd	FALSE
babdcdbcadd	FALSE
bbadacaccab	FALSE
bbadaccbaab	FALSE
bbdbbcadbdc	FALSE
bbdbbdbbdcb	FALSE
bccbabbccdb	FALSE
bccbabcbcdb	FALSE
bdadbddabdb	FALSE
bdadcbbcbaa	FALSE
bddcacabbaa	FALSE
bddcaccdccb	FALSE
cacbbbbbbad	FALSE
cacbbcdccbd	FALSE
cbadbdadbca	FALSE
cbadbdbdabc	FALSE
cbdcbadadda	FALSE
cbdcbbdbaba	FALSE
ccccaaabcab	FALSE
ccccaadaaca	FALSE
cdacdabaccb	FALSE
cdacdbabdab	FALSE
cdcdacacbdb	FALSE
cdcdacbdbdc	FALSE
dabacbdaccd	FALSE
dabacdccadb	FALSE
dadcaaddabb	FALSE
dadcacbabac	FALSE
dbcabcadadd	FALSE
dbcacaaaadb	FALSE
dcacadacaac	FALSE
dcacadcaddd	FALSE
dcdababdbcd	FALSE
dcdabaddacb	FALSE
ddbbdddcadb	FALSE
ddbbddddcac	FALSE
aaaaabadcada	TRUE
aaaaacdcddcb	TRUE
aacccabcdcdc	TRUE
aacccbcddcad	TRUE
abaddaacccac	TRUE
abaddadadacc	TRUE
abddaaaaaaaa	TRUE
abddaacaaaca	TRUE
accaccabaacd	TRUE
accaccaccaab	TRUE
adadaacbaddd	TRUE
adadabccccad	TRUE
addaccadadcb	TRUE
addacccbaaaa	TRUE
baaddddaaada	TRUE
baaddddadaca	TRUE
badccaaddcdd	TRUE
badccadddddc	TRUE
bccaaadaaaad	TRUE
bccaaadccdca	TRUE
bcdccdaacaaa	TRUE
bcdccdacadaa	TRUE
bdaddacdcddd	TRUE
bdaddcaaacdd	TRUE
bddccacdcadc	TRUE
bddccadadcdd	TRUE
cabccdddaadd	TRUE
cabcdcacddca	TRUE
cbaacccdccad	TRUE
cbaaccdaaacd	TRUE
cbdaacaaaaca	TRUE
cbdaaccadcaa	TRUE
ccbadadcccac	TRUE
ccbaddaaacda	TRUE
ccddbcddadcc	TRUE
ccddbdaadacc	TRUE
cdcbadaddcdc	TRUE
cdcbadcdcaca	TRUE
daacccbaccac	TRUE
daacdadacadb	TRUE
dadbcacccddd	TRUE
dadbcaddddda	TRUE
dbcccddadcad	TRUE
dbcccddcacca	TRUE
dcabadadccdc	TRUE
dcabadadddda	TRUE
dccdaacdbdcc	TRUE
dccdabcacaca	TRUE
ddbccadaadaa	TRUE
ddbcccaadaad	TRUE
aaaaabadcadb	FALSE
aaaaacdcddca	FALSE
aacccabcdcdb	FALSE
aacccbcddbbc	FALSE
abbabdadaccc	FALSE
abbabdcbcdda	FALSE
abdccaabcdbb	FALSE
abdccaacdbac	FALSE
accaccabaacb	FALSE
accaccaccaac	FALSE
adadaacbacdb	FALSE
adadabcbbcac	FALSE
addaccadadcd	FALSE
addacccbaaba	FALSE
babdbdbbabda	FALSE
babdccbbddbd	FALSE
bbabcdadacdd	FALSE
bbabcdcbccba	FALSE
bbccdcdbbaca	FALSE
bbccddcbbbdc	FALSE
bcbdaacadacc	FALSE
bcbdaacccddd	FALSE
bdacdbaadaab	FALSE
bdacdbabdbab	FALSE
bddacccaddcb	FALSE
bddacdcdcaab	FALSE
cabcadcdcaab	FALSE
cabcaddcbada	FALSE
cbabadbadadb	FALSE
cbabbacacada	FALSE
cbcdadcbdbbb	FALSE
cbcdbaacdbdc	FALSE
ccbbababddab	FALSE
ccbbabdcabad	FALSE
ccddbccdadcb	FALSE
ccddbdaadabb	FALSE
cdcbaddabddc	FALSE
cdcbbaacaabd	FALSE
daacccbabcac	FALSE
daacdadacadd	FALSE
dadbbbdbbcdc	FALSE
dadbbccaaabc	FALSE
dbbddadcddaa	FALSE
dbbddbcdaadc	FALSE
dcabacddcbac	FALSE
dcabadddbcad	FALSE
dccdaacdbdcb	FALSE
dccdabbacbca	FALSE
ddbcaadaaabb	FALSE
ddbcabcbcdda	FALSE
aaaaabadcadac	TRUE
aaaaaccddcaab	TRUE
aacdaaaacabac	TRUE
aacdaacbdcaca	TRUE
abadddcaddaad	TRUE
abcaaaaaaddcc	TRUE
abddaccaddaac	TRUE
abddacccdaacc	TRUE
accabaaadaacc	TRUE
accabaacdadcc	TRUE
adacbacacccca	TRUE
adacbdcacaacc	TRUE
adcddcaabccdd	TRUE
addaaaaaaaadb	TRUE
baadccacaacac	TRUE
baadccaccdaac	TRUE
badadacadcdcc	TRUE
badadadcdaddc	TRUE
bcadcaaccdddc	TRUE
bcadcaadddddd	TRUE
bcdcadcaccdda	TRUE
bcdcadccaadaa	TRUE
bdadddcdaaaaa	TRUE
bdadddcdccdad	TRUE
bddcadddcacad	TRUE
bddccaaddcadc	TRUE
cabcdaddddadd	TRUE
cabcdcadacacd	TRUE
cbaacccaaacad	TRUE
cbaacccdaaadd	TRUE
cbdaccdcdccca	TRUE
cbdacdcadcdda	TRUE
ccbadcdacccac	TRUE
ccbadcdaccdcc	TRUE
ccdcdbaadddda	TRUE
ccdcdcdbadddc	TRUE
cdcabcadcccda	TRUE
cdcabccdaaaac	TRUE
daadaacbaacdc	TRUE
daadaccccbaad	TRUE
dadcabcaddcad	TRUE
dadcacbaaacda	TRUE
dbcdcdaaccadc	TRUE
dbcdcdcdccccd	TRUE
dcacbacddddca	TRUE
dcacbaddccdcc	TRUE
dccdbdacdadcc	TRUE
dccdbddaacdcc	TRUE
ddbaccadacaac	TRUE
ddbaccadacaca	TRUE
aaaaaabbadbda	FALSE
aaaaaaddbcddb	FALSE
aacbdcdcddddb	FALSE
aacbddcbbdbab	FALSE
abbaabdacbadd	FALSE
abbaaddbdcccb	FALSE
abdccbdaadccb	FALSE
abdccbddbdadd	FALSE
accaadcabcddb	FALSE
accaadccdcbdb	FALSE
adabdddaacadb	FALSE
adacaadcdbacb	FALSE
adcdddcbdbbba	FALSE
addaabacacdcb	FALSE
babdaadbadcda	FALSE
babdabdbaadda	FALSE
bbacbabbbdadb	FALSE
bbacbabcbcddc	FALSE
bbdabacbbdcdd	FALSE
bbdabaccbdacd	FALSE
bcbccaddbabdb	FALSE
bcbccbddbccac	FALSE
bdaadbaccbdab	FALSE
bdaadbcabccca	FALSE
bdccacbcabdbc	FALSE
bdccacbcdcbac	FALSE
cabacbbaddcaa	FALSE
cabacbdccacda	FALSE
caddbaddcaaab	FALSE
caddbbadcbbab	FALSE
cbcaccabddddb	FALSE
cbcacdbbbbcca	FALSE
ccadcdbcbabdd	FALSE
ccadddaadcbcb	FALSE
ccdccddccdaad	FALSE
ccdcdaaabbdac	FALSE
cdcbaaaccdcab	FALSE
cdcbaabcdadac	FALSE
daadabdacccdb	FALSE
daadadcadcdca	FALSE
dadbdcadbbbdb	FALSE
dadbdcbbaaaba	FALSE
dbcababddbbaa	FALSE
dbcabacdcabcc	FALSE
dcacdccbadacb	FALSE
dcacdcddbabac	FALSE
dcdaadaccdbdb	FALSE
dcdabbbdaabcc	FALSE
ddbbbbddabdbb	FALSE
ddbbbcacbdbcc	FALSE
aaaaaabcadcdaa	TRUE
aaaaaadbddddac	TRUE
aacbdadcacdddc	TRUE
aacbdccdddddcc	TRUE
abadcadadaadda	TRUE
abadcadcdcddcc	TRUE
abddcdaacadddc	TRUE
abddcdaadaadad	TRUE
accbadcdacddaa	TRUE
accbcadcaadadd	TRUE
adacbaddaaaaad	TRUE
adacbaddadcadd	TRUE
addacdcaacdbaa	TRUE
addacdcdcccbdc	TRUE
baaddacdcdacac	TRUE
baaddadaacdcdd	TRUE
badcadcccaddcc	TRUE
badcadcddadddd	TRUE
bcadcadacddcda	TRUE
bcadcadddcadcc	TRUE
bcdadaadcaacdc	TRUE
bcdadadcaaccdc	TRUE
bdadcaadcdaaca	TRUE
bdadcacadcccdc	TRUE
bddacccacaadad	TRUE
bddacccaccadcd	TRUE
cabadaddaadaca	TRUE
cabadaddcaccca	TRUE
caddcdadbddaaa	TRUE
cadddadbaccadc	TRUE
cbcddcccddaccc	TRUE
cbcddcdacaccdc	TRUE
ccbcadcaacacda	TRUE
ccbcadccdaaccd	TRUE
ccdddabcddadcd	TRUE
ccdddacaccbdad	TRUE
cdcbacdaadcdad	TRUE
cdcbadcdcdcacd	TRUE
daaddccdadaddb	TRUE
dabaaaaadaddcd	TRUE
dadbcdaacaaacd	TRUE
dadbcdddacccda	TRUE
dbcadddaacccaa	TRUE
dbcadddaacdaca	TRUE
dcabcdddddccdd	TRUE
dcabdaaadddddc	TRUE
dccdbdcadcdaac	TRUE
dccdbdccccacda	TRUE
ddbcacdcadddac	TRUE
ddbcacddccadac	TRUE
aaaaaabbadbdaa	FALSE
aaaaaadbcdddbb	FALSE
aacbdabcabdddc	FALSE
aacbddddccbcdb	FALSE
abbacaaaaddaba	FALSE
abbacbadadabba	FALSE
abddbaadbbbcad	FALSE
abddbabcabaaca	FALSE
accbadcdacdcab	FALSE
accbbcbccdbacc	FALSE
adacbbababbaaa	FALSE
adacbbadabaddd	FALSE
addacdcaacdbab	FALSE
addacdcdcccbcb	FALSE
babcdcccdadaca	FALSE
babdabdadadccb	FALSE
bbabaabdadddba	FALSE
bbabaabddbaccd	FALSE
bbccacadcdbbba	FALSE
bbccacbbddbbac	FALSE
bcadbdbdadaadc	FALSE
bcadcaadbadbdb	FALSE
bcddbbadbdbcdc	FALSE
bcddbbdddacdcc	FALSE
bdcbdbdadcbcda	FALSE
bdcbdbdbcccccb	FALSE
cabbaabacdacab	FALSE
cabbaabcdbbadb	FALSE
caddcdadbddaab	FALSE
cadddadbabcbdb	FALSE
cbccaaabaaacdc	FALSE
cbccaacacbbbcc	FALSE
ccbbcbbdbacccc	FALSE
ccbbccdaaacacc	FALSE
ccdddabbddacbd	FALSE
ccdddacaccbcab	FALSE
cdcbadbabdcdac	FALSE
cdcbaddaddbdba	FALSE
daaddccdadadda	FALSE
dabaaabdbacbab	FALSE
dadbcacbddabab	FALSE
dadbcbbbbdcada	FALSE
dbbdbdcadbcadc	FALSE
dbbdcaadcacdac	FALSE
dcabccbdcbddca	FALSE
dcabcdbaadddcd	FALSE
dccdbdadbdbcba	FALSE
dccdbdcbacdabc	FALSE
ddbbcdaccdacba	FALSE
ddbbcdadcdbbdb	FALSE
aaaaaabccdddcda	TRUE
aaaaabdcacaacaa	TRUE
aacbddcccccddcd	TRUE
aacbddcddacddcd	TRUE
abadacaaaaccaac	TRUE
abadacaddccdaac	TRUE
abdcccdcddadadd	TRUE
abdccdaaacdcadc	TRUE
acbdaaaccdaaaaa	TRUE
acbdaacddadaaad	TRUE
adabacdaaacaada	TRUE
adabacdacddddcd	TRUE
adcccddbdaaaddd	TRUE
adccdaaddcccbaa	TRUE
baaddacaddaadda	TRUE
baaddadaadaacca	TRUE
badcaaaaaacacad	TRUE
badcaaaadcccaad	TRUE
bcadaccaaaddcdc	TRUE
bcadaccdcdcadcd	TRUE
bcdacadcddccdda	TRUE
bcdacccaddacdaa	TRUE
bdaccddccdaaada	TRUE
bdaccdddccdaacd	TRUE
bddaadaadccddcc	TRUE
bddaadacdacacac	TRUE
cabaacaacdaaacc	TRUE
cabaacacacaccdd	TRUE
cadaccdabcdddac	TRUE
cadaccddbacccaa	TRUE
cbccaaaddacadad	TRUE
cbccacacdddadad	TRUE
ccabccccdaaddcd	TRUE
ccabcddcaaaadaa	TRUE
cccdcaadcadcbdc	TRUE
cccdcabacddaddc	TRUE
cdbcaacddcacacc	TRUE
cdbcaaddaccdccc	TRUE
daaaadacabcacaa	TRUE
daaabadacaaadca	TRUE
dacddbaaccacada	TRUE
dacddbdcdaadadd	TRUE
dbcacaddacddcca	TRUE
dbcaccaaddcaccd	TRUE
dcabaccdadacddc	TRUE
dcabadaccadadcd	TRUE
dcdabaddcdccddd	TRUE
dcdabdcdccdddaa	TRUE
ddbcdcdddadacda	TRUE
ddbcddcccacadcc	TRUE
aaaaaabbcdddcca	FALSE
aaaaabccbbbabaa	FALSE
aacbdcdabccddcd	FALSE
aacbdcdbcabdcbd	FALSE
abbaaaccbadbadb	FALSE
abbaabacacaccad	FALSE
abdbdaddadacdbc	FALSE
abdbdbaddddcbac	FALSE
acbccdcdaaaadbc	FALSE
acbccddabccadba	FALSE
adabaadbbbcddab	FALSE
adabacaaaabaabc	FALSE
adcccddbdaaaddb	FALSE
adccdaaddcccbab	FALSE
babbcbdbbbdacda	FALSE
babbcddbbdaacda	FALSE
baddbbccbdbbdcc	FALSE
baddbcaacbccdcc	FALSE
bbcbdccaaaacdbb	FALSE
bbcbddaadcdbcda	FALSE
bcbaabdcbabadda	FALSE
bcbaacbbabacadd	FALSE
bcdcdadadccbcba	FALSE
bcdcdbaacbadbdc	FALSE
bdcadcccdaadbaa	FALSE
bdcaddcbacdcadb	FALSE
cababaadcabcccc	FALSE
cababadacdabaac	FALSE
cadaccdabbcdcab	FALSE
cadaccddbbbbbaa	FALSE
cbbdadcddbbddac	FALSE
cbbdaddcbadadba	FALSE
ccabcbaddccadbd	FALSE
ccabcbcabaadabd	FALSE
cccdcaadcadcbdb	FALSE
cccdcababddbddc	FALSE
cdbbbacddcbbdca	FALSE
cdbbbadacadbcdd	FALSE
daaaadacabbacaa	FALSE
daaabadabbaaccb	FALSE
dacddbaabbabada	FALSE
dacddbdcdaadadb	FALSE
dbbbdacadcbacdb	FALSE
dbbbdadbcadcdca	FALSE
dcabaccbabdadac	FALSE
dcabaddbacdcdca	FALSE
dcdabaddbdcbcdc	FALSE
dcdabdcdccdddab	FALSE
ddbcbcbcabdcbad	FALSE
ddbcbdacbcdcdad	FALSE
aaaaaaacdacccbca	TRUE
aaaaaabadccaddcd	TRUE
aacdbcacdddcddcc	TRUE
aacdbdcccaadaaac	TRUE
abcaacdccacaacda	TRUE
abcaacdcdacdddcd	TRUE
abddccccdcaccdda	TRUE
abddcdaadadcaaac	TRUE
acccadbcacdadaad	TRUE
acccadbcdaacadaa	TRUE
adbaaacdcacadcdc	TRUE
adbaaaddadacdcad	TRUE
addbdddadcdddddd	TRUE
addcacbdccccadcd	TRUE
bacaddaaaacddadc	TRUE
bacaddaccaddaddc	TRUE
baddadadaadddccd	TRUE
baddadaddadddccc	TRUE
bccacccacdadadda	TRUE
bccacccadccdaacc	TRUE
bcddaacacacdaaad	TRUE
bcddaaccccdacdac	TRUE
bdcacdcccadcccca	TRUE
bdcacdcccaddccdc	TRUE
bdddaadaddadacad	TRUE
bdddaadcdcddccad	TRUE
cabdaadaadccaccd	TRUE
cabdacadcddaddca	TRUE
cadddddccaaadbac	TRUE
cbaaaaadaccacaad	TRUE
cbcdcccccacaacac	TRUE
cbcdccdcccccaacd	TRUE
ccadbcdaccddadda	TRUE
ccadbdaccaaaacaa	TRUE
ccdabddccddcdadc	TRUE
ccdabddcdaadcddd	TRUE
cdbcdcaaadcdcddc	TRUE
cdbcddaccaadaada	TRUE
daacaadadaddcbad	TRUE
daacabdcdaaaaaaa	TRUE
dacdcdddbcacdada	TRUE
dacddaccbdddcacd	TRUE
dbcaaddddcaaadcd	TRUE
dbcacadadadaccca	TRUE
dcaaccbadacacaad	TRUE
dcaaccbcaadcadcd	TRUE
dcccbdadddaddacd	TRUE
dccccaacdaadbdad	TRUE
ddbadcddadddddca	TRUE
ddbaddaaddaaadca	TRUE
aaaaaaacdacccbba	FALSE
aaaaaabadbbadccd	FALSE
aacdbcdbbddbdcbc	FALSE
aacdbdbcbacaacaa	FALSE
abbcadcbcccabdba	FALSE
abbcaddccbdbdbba	FALSE
abddbcdbddcdbbcc	FALSE
abddcaaaaaddcadb	FALSE
acccadbbaabdacaa	FALSE
acccadbccbacadaa	FALSE
adbaabcccbaacdbc	FALSE
adbaacbdabacdbbd	FALSE
addbdddadbcddddd	FALSE
addcacbccbbcadbd	FALSE
bacaabbadbcbcccc	FALSE
bacaadbabdaaaacc	FALSE
bbacdbcbdaaababc	FALSE
bbacdbcdabbccdad	FALSE
bbdbdbccccdbadda	FALSE
bbdbdcdadbdbcadc	FALSE
bccbbaaccbdbdbad	FALSE
bccbbabacccabaaa	FALSE
bdadadddcbddabcb	FALSE
bdadbabbdbddcada	FALSE
bddcaccdcacdcacb	FALSE
bddcacdaaaddbbdd	FALSE
cabcddbacadaaabc	FALSE
cabdaaacdcababcb	FALSE
cadddddccaaadbab	FALSE
cbaaaabcdadacbbb	FALSE
cbcbcbdbcbabdcbc	FALSE
cbcbccdadacccacd	FALSE
ccadbbdabbcdbdda	FALSE
ccadbdbcbabaabba	FALSE
ccdabdbdabaddccc	FALSE
ccdabdccbbadcddd	FALSE
cdbcdcbddbacdbba	FALSE
cdbcddaabdcacaac	FALSE
daacaadadaddcbab	FALSE
daacabdbdaaabbaa	FALSE
dacdcdddbcabdaca	FALSE
dacddaccbddccacb	FALSE
dbbbcbdcbdaabaab	FALSE
dbbbcbddadddaaaa	FALSE
dcaaccbadacbcaad	FALSE
dcaaccbbaaccbdcd	FALSE
dcccbdaccdaddbcd	FALSE
dccccaacdaadbdab	FALSE
ddbbaccaccbddabb	FALSE
ddbbbbadcbbddacb	FALSE
aaaaaacccdbadadaa	TRUE
aaaaabaccaccddaaa	TRUE
aaccbccacdaadcdac	TRUE
aaccbdaadcdaaccad	TRUE
abaddaaaddcddddad	TRUE
abaddacacdddacaad	TRUE
abddcadadadaddddc	TRUE
abddccccdaaaadcdd	TRUE
accbcacaadacccdcc	TRUE
accbcacccadacacaa	TRUE
adaddacaaddcdcadb	TRUE
adaddcbcaaaddcdca	TRUE
addbdaaacacddaddc	TRUE
addbdaacddcddadcc	TRUE
bacaadaacacdcccdc	TRUE
bacaadaddacaccdac	TRUE
badccacaaacccaaca	TRUE
badccacaacdcaacdc	TRUE
bcaddacaadcccddad	TRUE
bcaddacdadcddcddd	TRUE
bcdccdccdcdcacccc	TRUE
bcdccddaccaccaacd	TRUE
bdaddaaadcaddcdcc	TRUE
bdaddacaadaacadac	TRUE
bddacadacdacccdda	TRUE
bddacaddaadadaadd	TRUE
caadddbacccacccdd	TRUE
caadddbddaddacadd	TRUE
cadcbccdaadcaddad	TRUE
cadcbccdccaaccaaa	TRUE
cbcdaaacdacdccdad	TRUE
cbcdaaadaaaaddacc	TRUE
ccacdbaccaacdacdc	TRUE
ccacdbdaddddccdcc	TRUE
ccdaaadbdcdcddcac	TRUE
ccdaaadcaddabdaca	TRUE
cdbccdcacdcaacada	TRUE
cdbccddcacadadcda	TRUE
daaaacbcadddddcdd	TRUE
daaaacbddacaddaad	TRUE
dacdabddacccadcda	TRUE
dacdacacccbdaaaad	TRUE
dbcacdacacadddccd	TRUE
dbcacdcacccacaccc	TRUE
dcaabdcaccadcaada	TRUE
dcaabdcaddccaaddd	TRUE
dcccdccbcddccaddd	TRUE
dcccddacccdccbddc	TRUE
ddbaccdaacaacaaad	TRUE
ddbaccdadadccaadd	TRUE
aaaaaadabdabdcdca	FALSE
aaaaacabddbbdcbda	FALSE
aaccbcbcabbbcdaca	FALSE
aaccbdccdadadcaba	FALSE
abadbabcdbbacccca	FALSE
abadbdcbccddddcab	FALSE
abdbcbcacdcaaacdc	FALSE
abdbcdabcaaabdbbd	FALSE
acbdacdacdbddcadd	FALSE
acbdadadcdadbcabc	FALSE
adaacdbdbbabacccc	FALSE
adaadbacbcccbbdcc	FALSE
adccadadcdaccabbd	FALSE
adccbcbdccadddcda	FALSE
babcbacadbcaddada	FALSE
babcbbccacadccada	FALSE
bbaacdaadacacbbaa	FALSE
bbaadaadcbaaaaccb	FALSE
bbccbdcdccbcccbdc	FALSE
bbcccaacbddccaccb	FALSE
bcadddcdacacdddbd	FALSE
bcbaacaabbdddadcc	FALSE
bcdccaabcdcbdabbb	FALSE
bcdccacadbccdcddc	FALSE
bdcacdabbaaaabacb	FALSE
bdcacdacabbddcdcd	FALSE
caacddaccbabaaddc	FALSE
caacddbddbadaacac	FALSE
cadacdabcbbdbadad	FALSE
cadadbdddbbddbbbd	FALSE
cbcaaabaadcdbccbd	FALSE
cbcaaadcdacbdabbc	FALSE
ccabcdadcbddccadb	FALSE
ccabcdccbbbccbacb	FALSE
ccdadbcbbbbdbbadb	FALSE
ccdadbcbcacccadbc	FALSE
cdbcddcdcdcaccdbb	FALSE
cdbdaaccdddadccba	FALSE
cddddadabcaacdacb	FALSE
cddddbaccaabaabba	FALSE
daccbabadcaabbbba	FALSE
daccbabcaaabadbdc	FALSE
dbbabcadbcdadaaca	FALSE
dbbadaadabcbcaddb	FALSE
dbddcababacdadabd	FALSE
dbddcbbcbcadccdbc	FALSE
dccbcbacbabcbdacb	FALSE
dccbcbcabaddbdbcc	FALSE
ddbbbbcaddbbdbcbc	FALSE
ddbbbddcdcababdaa	FALSE
aaaaaadabdacdcdcac	TRUE
aaaaacbddacddcdacc	TRUE
aacccbdadcaadddcaa	TRUE
aacccccbacdacaccac	TRUE
abacddadadcdadaaca	TRUE
abacdddaaacdaadaad	TRUE
abdcddacadaaacccda	TRUE
abdcddadaccaccdddd	TRUE
acbdacaccdcdccaada	TRUE
acbdacccaccacdcadc	TRUE
adaacbadadadddadca	TRUE
adaacdbdaccaacaaac	TRUE
adcbddaddcdcaacacc	TRUE
adccaccabdcdaadadd	TRUE
baadaccdccaacacaad	TRUE
baadacddccdccadadd	TRUE
badaccddcccdccccdc	TRUE
badacdadacdccadcaa	TRUE
bcacdccdcdcadadcda	TRUE
bcacddacdaadcdaadc	TRUE
bcdacccddcddaccddd	TRUE
bcdaccddcacdaddccd	TRUE
bdacdddccccadcdddc	TRUE
bdacdddcdaaccadcad	TRUE
bddaaadcdcdddaddad	TRUE
bddaaadcddcdddacac	TRUE
caacccbcdaccdaacac	TRUE
caaccccacbdcadddac	TRUE
cadbccddddacacaaca	TRUE
cadbccdddddcccacca	TRUE
cbcacddcadaddccddd	TRUE
cbcacddddcdccccacd	TRUE
ccaadbddadacdacaad	TRUE
ccabaaadaccdcccdcc	TRUE
cccddcdacaccaaaaab	TRUE
cccddcdcacdbaadaaa	TRUE
cdbcaccddaccadacdd	TRUE
cdbcacdadaaaadcada	TRUE
cdddbcaddcdcdcacdc	TRUE
cdddbdcadccadddddd	TRUE
dacbccddccdcccccdc	TRUE
dacbcdcccccaadcdca	TRUE
dbadaddacddaccacdc	TRUE
dbadaddcaacaaaacdd	TRUE
dbddaccacdccaaddca	TRUE
dbddacdcdaaacacdda	TRUE
dccdaaddcccbcaaaad	TRUE
dccdabaaaaadddaddc	TRUE
ddbcaaddccccddacad	TRUE
ddbcacaddccaaddada	TRUE
aaaaabbdbcbacbdbad	FALSE
aaaaabcacddbabdccd	FALSE
aacbbcdcbbcabdcdab	FALSE
aacbbdbcbccbddbbdc	FALSE
abadadabbaddbdaabb	FALSE
abadadbdaccbaaddcd	FALSE
abdbaabadcbdbdcacb	FALSE
abdbadbdbdabbbbaba	FALSE
acbdbabaaccccabdaa	FALSE
acbdbabacdcdccbccd	FALSE
adabdcbdbbbdccaccb	FALSE
adabdccadabcdbacdb	FALSE
addaaabddbddbadccc	FALSE
addaabcaaadbacaccb	FALSE
babbbcdbbadcbabbaa	FALSE
babbbcddaaabcbdccb	FALSE
baddccbadbcabdbaca	FALSE
baddccbccbcdbbbddc	FALSE
bbcdadaacccaaaaadc	FALSE
bbcdbadbbcdcabbadb	FALSE
bcbbdabdbddcaaccdd	FALSE
bcbbdacbbdaaabdccc	FALSE
bcdcdbadccdcbbdcdd	FALSE
bcdcdbcbbacdccddba	FALSE
bdccadbabddccbddad	FALSE
bdccadbcbdcacaabcb	FALSE
cabaccacbcdacbabdc	FALSE
cabaccdaddbadcadba	FALSE
cadcdacbaadcbbbbdc	FALSE
cadcdacdccbabaacac	FALSE
cbcadbccddbaacbacb	FALSE
cbcadbdccadbaaaaab	FALSE
ccaccabccddbbbcbbd	FALSE
ccaccaddcdcbbcccba	FALSE
ccdabcbccdcbdababa	FALSE
ccdabccabaacccccac	FALSE
cdbddbbabcccdcaccb	FALSE
cdbddbccdcdcdccdac	FALSE
daacbbadcaddcdbbda	FALSE
daacbdbcbacbbaccda	FALSE
dadbadadadababccbc	FALSE
dadbbabacbcacabacc	FALSE
dbcaaccddabbcabadd	FALSE
dbcaacddccdbbadbbc	FALSE
dcabcbcbbdbbccdacb	FALSE
dcabccaaacbcbbcdca	FALSE
dccdbacbbabcdccbad	FALSE
dccdbcdabcadababba	FALSE
ddbbacabdbabdcdcab	FALSE
ddbbbaacddbdaaaaad	FALSE
aaaaabcaccadcdaaddc	TRUE
aaaaabccddcacdccdad	TRUE
aacbacddcccaaaacdcd	TRUE
aacbacddcccdacddcaa	TRUE
abacdaaddadaaacaaca	TRUE
abacdacadcaadddccda	TRUE
abdcadaacdcccccadcc	TRUE
abdcadccdcddcaddccc	TRUE
acbdddadcdacacacddd	TRUE
acbdddcddaccadaaddd	TRUE
adacbaadaaacdddacca	TRUE
adacbccddadcdccddda	TRUE
adcdcaaacccbcccaadc	TRUE
adcdcabdccdadaacaaa	TRUE
baadccdaacccdadcacc	TRUE
baadccdacaaadcddaaa	TRUE
badaddaccacaaaadadd	TRUE
badaddcaaddacadcaaa	TRUE
bcacddcddaddccdcacc	TRUE
bcadaaaadadaacaadca	TRUE
bcdacadaccddcacadca	TRUE
bcdacadddadacdcdacd	TRUE
bdacdaddaddadacdaaa	TRUE
bdacdaddcddaacdcaca	TRUE
bddadcdaaaccddacdcd	TRUE
bddadcdaccdadcdacca	TRUE
cabaaddcdadadaadcdc	TRUE
cabacacdadadccdcdcc	TRUE
cadbaddcacaacaddddd	TRUE
cadbadddadddadaaaad	TRUE
cbccaaaaddaddddacdc	TRUE
cbccaaacdacccacdddc	TRUE
ccadbdccdaccdcccddd	TRUE
ccadcbaddaccdacaaad	TRUE
ccdbadaddaaadaccccd	TRUE
ccdbaddaddcaddaaddc	TRUE
cdcaacdacabcddcacda	TRUE
cdcabaaaaadcadddadc	TRUE
daabccadcccaccdddac	TRUE
daabccaddacaaddcccc	TRUE
dadabadacccccadcccc	TRUE
dadabcacacdacaaacda	TRUE
dbcacadcddcaacdcddc	TRUE
dbcacadddacdacddada	TRUE
dcaaaccacbcaacaacac	TRUE
dcaaadaabdaaadddaca	TRUE
dcccdbdcdcaadcdccda	TRUE
dcccdcadbcddadcdccc	TRUE
ddbaddddadaaacccacd	TRUE
ddbcaaacdcaaaaddccd	TRUE
aaaaaabdbbddcacdbad	FALSE
aaaaaacabbacccbacac	FALSE
aacdabadaaddbdbbccc	FALSE
aacdabbacbddadbdcab	FALSE
abbababbccccdccacaa	FALSE
abbabacaadadabbabbb	FALSE
abdbcacccadacccadda	FALSE
abdbcbdabbdbcbbbdac	FALSE
acbdaadaddcbdbdadcc	FALSE
acbdbaabacdbaabcccb	FALSE
adaaccaabbaddccaccd	FALSE
adaaccdbbaddcddbaba	FALSE
adcccbcdbdababcdccb	FALSE
adccccadbabdbcddcdc	FALSE
babbaacccdacccbddda	FALSE
babbaacdacabddbcbad	FALSE
baddcbacadcaccbdbcc	FALSE
baddcbcdaccbdbddcba	FALSE
bbccbdbaabbcabdacca	FALSE
bbccbddbcddcbccbccc	FALSE
bcbccccbbdbcacbbadb	FALSE
bcbccdbadbaadcacabd	FALSE
bcddcadaabbbacccaaa	FALSE
bcddcadbcbabdcbdbaa	FALSE
bdcabddccbbbbadcbcb	FALSE
bdcacadcdadcddaccdb	FALSE
caabbcbaccdbbababcb	FALSE
caabbdbcccabcccbbab	FALSE
cacdbcaaccdccdcabda	FALSE
cacdbcbabdadcbacbbd	FALSE
cbbcbacbcbdacbdbdbc	FALSE
cbbcbbbccbcbcdbaccc	FALSE
cbddddbdcbdabbccabb	FALSE
ccaaaaacdabaabbdbbd	FALSE
ccccbaabcddddcabcbb	FALSE
ccccbabbdcdbddcaaba	FALSE
cdbadcddadadcadbadc	FALSE
cdbaddabccddabdcaaa	FALSE
daacbdcbabbcdbbdaab	FALSE
daacbdcbadabadbaabc	FALSE
dadacbccddbbbdacbab	FALSE
dadacdbdcbdaabdbdbc	FALSE
dbbddbdcccaddcbabdd	FALSE
dbbddcacdbccdbcbbda	FALSE
dcacccccacccaaddcca	FALSE
dcaccdacdaabbadcaab	FALSE
dcdaabbadbdccdbdcba	FALSE
dcdaacbbdaaadadccaa	FALSE
ddbcacacbccccababbb	FALSE
ddbcacbabbacabacaab	FALSE
