aaaaabdada	TRUE
aaaabaaada	TRUE
aacbdaaaca	TRUE
aacbdcbdac	TRUE
abaccdbcab	TRUE
abaccdbcca	TRUE
abdcccbdac	TRUE
abdccccaab	TRUE
accacabacc	TRUE
accacabddd	TRUE
adabdcddcd	TRUE
adabddacbc	TRUE
adcddabaad	TRUE
adcddbcdab	TRUE
baadccabda	TRUE
baadccabdd	TRUE
badadcabcb	TRUE
badadcacab	TRUE
bcadbccdbc	TRUE
bcadbdadda	TRUE
bcccbadccd	TRUE
bcccbdaaaa	TRUE
bdacabaacc	TRUE
bdacabdcad	TRUE
bddaacdaca	TRUE
bddaadaaaa	TRUE
caadcbcaaa	TRUE
caadcbccdb	TRUE
cadccadcab	TRUE
cadccbccca	TRUE
cbccaaadba	TRUE
cbccaabaaa	TRUE
ccadacbaaa	TRUE
ccadacbcbd	TRUE
ccdbacdbca	TRUE
ccdbadadda	TRUE
cdbdcbadcb	TRUE
cdbdcbdaad	TRUE
daabdcccab	TRUE
daabdcdcba	TRUE
dacdcbcdcd	TRUE
dacdcccbdd	TRUE
dbcbacadac	TRUE
dbcbaccdcb	TRUE
dcabaccabd	TRUE
dcabcabcdb	TRUE
dcdaaabcab	TRUE
dcdaaabcba	TRUE
ddbcaacddb	TRUE
ddbcabacbc	TRUE
aaaaaaaabb	FALSE
aaaaaaacbb	FALSE
aacbdbcadc	FALSE
aacbdbcdac	FALSE
abadccbddb	FALSE
abadcdccbb	FALSE
abdcbcaabb	FALSE
abdcbdddbb	FALSE
accadadabb	FALSE
accadbbccd	FALSE
adacdabaab	FALSE
adacdabcbb	FALSE
addbbcbbba	FALSE
addbbcdaaa	FALSE
babddbbaaa	FALSE
babddcabac	FALSE
bbadaadaca	FALSE
bbadacadbb	FALSE
bbdacddcda	FALSE
bbdadabbab	FALSE
bcbbdcdbdc	FALSE
bcbbdcdccb	FALSE
bdaadbcaba	FALSE
bdaadbcadc	FALSE
bdccbdacbb	FALSE
bdcccaacbb	FALSE
cabacdcabb	FALSE
cabadaccbb	FALSE
cadcdacbdb	FALSE
cadcdbabbc	FALSE
cbcacddabb	FALSE
cbcacdddbb	FALSE
ccacdcacbb	FALSE
ccacddbaab	FALSE
ccdacccabb	FALSE
ccdacdaabb	FALSE
cdbcdbdabb	FALSE
cdbcdcbcbb	FALSE
daabacddbb	FALSE
daabbbaddd	FALSE
dacdbddadb	FALSE
dacdbddcbb	FALSE
dbbaddbacd	FALSE
dbbaddcbac	FALSE
dcaaccacbb	FALSE
dcaaccdbdb	FALSE
dccdbadadb	FALSE
dccdbbabdc	FALSE
ddbcdbcdbb	FALSE
ddbcdccbdb	FALSE
aaaaaaaaabd	TRUE
aaaaaaacacc	TRUE
aacbdddaccb	TRUE
aacbdddcccd	TRUE
abadadccadc	TRUE
abadcaacacb	TRUE
abdcddaadaa	TRUE
abddaaaddca	TRUE
accadddbcdc	TRUE
accbaaacdac	TRUE
adaccaabada	TRUE
adacccaadcc	TRUE
addbcbdacdb	TRUE
addbccaabcc	TRUE
bacadbcbaad	TRUE
bacadbdaaac	TRUE
badcdbdadac	TRUE
badcdbdcdba	TRUE
bcbadddccdb	TRUE
bcbcaabcdba	TRUE
bcdacaacacd	TRUE
bcdacabacba	TRUE
bdadaaacacb	TRUE
bdadaaadaad	TRUE
bddacdacacb	TRUE
bddacdadcbd	TRUE
cabacbccccd	TRUE
cabacbdcccd	TRUE
cadbdaaaddd	TRUE
cadbdaadcca	TRUE
cbcbddaacab	TRUE
cbcbdddddcb	TRUE
ccacbadaadc	TRUE
ccacbaddccd	TRUE
ccdabaaaaad	TRUE
ccdabaaadad	TRUE
cdbccaacdcc	TRUE
cdbccabcdaa	TRUE
daabcabcadc	TRUE
daabccacbcd	TRUE
daccbddacbc	TRUE
daccbddcaaa	TRUE
dbaddcaaada	TRUE
dbaddcaccdd	TRUE
dcaaaabddcd	TRUE
dcaaaadadac	TRUE
dccccdbcbaa	TRUE
dccccdcaabd	TRUE
ddbcccaccdd	TRUE
ddbcccbacaa	TRUE
aaaaaaaaabb	FALSE
aaaaaaacabb	FALSE
aacbdcbddab	FALSE
aacbdddccbb	FALSE
abbacbbcdbd	FALSE
abbacbcaabb	FALSE
abdcdbaadab	FALSE
abdcdbacbbb	FALSE
accadddbcbb	FALSE
accbaabddbc	FALSE
adaccaabadb	FALSE
adacccaadbb	FALSE
addbbbddacd	FALSE
addbbdcacbd	FALSE
babcbdccdad	FALSE
babccbbddba	FALSE
bbabaacddca	FALSE
bbabaadabca	FALSE
bbccddccaac	FALSE
bbccddcdacd	FALSE
bcbbbcdadbc	FALSE
bcbbbdcbadc	FALSE
bdaaadbccbc	FALSE
bdaabaadbbb	FALSE
bdccbaccbab	FALSE
bdccbacdcbb	FALSE
cabaccbbcad	FALSE
cabacdcacbb	FALSE
cadbcdbcdbb	FALSE
cadbdaacbba	FALSE
cbcaadccdbb	FALSE
cbcabcaddbb	FALSE
ccacbacddbb	FALSE
ccacbaddbcd	FALSE
ccdabaabbaa	FALSE
ccdabacddbb	FALSE
cdbcaacdcbb	FALSE
cdbcabaabab	FALSE
daabcabbada	FALSE
daabcabddbb	FALSE
daccbdcabbb	FALSE
daccbddcabb	FALSE
dbbbacddbac	FALSE
dbbbadccadb	FALSE
dcaaaabddbd	FALSE
dcaaaadadbb	FALSE
dccccdbcbab	FALSE
dccccdcaabb	FALSE
ddbcadabcbb	FALSE
ddbcbaabcaa	FALSE
aaaaaaaaabdc	TRUE
aaaaaaacccda	TRUE
aaccbacdbddd	TRUE
aaccbcabddad	TRUE
abaddacaabac	TRUE
abaddadadaaa	TRUE
abddacaaccdd	TRUE
abddacabaddd	TRUE
accbccbacdda	TRUE
accbccdbccbc	TRUE
adadabaacdad	TRUE
adadacabcbdd	TRUE
addbadaaacdb	TRUE
addbcaccabad	TRUE
bacadcaddbac	TRUE
bacadcbdcddc	TRUE
badccaabcbcd	TRUE
badccabaacdb	TRUE
bcbacdabccca	TRUE
bcbacdcccdbd	TRUE
bcdaacdccdac	TRUE
bcdaadcbdcab	TRUE
bdaddacabdca	TRUE
bdaddadaccac	TRUE
bddacdddbddd	TRUE
bddadaaacbcc	TRUE
cabadaaddaca	TRUE
cabadacabadc	TRUE
cadcbaadaaac	TRUE
cadcbaccccdd	TRUE
cbccdbcaadda	TRUE
cbccdbccadbd	TRUE
ccbaaaaadcdc	TRUE
ccbaaacdacdc	TRUE
ccdcabaaaacb	TRUE
ccdcabdaaaac	TRUE
cdbddaddccba	TRUE
cdbddcabadda	TRUE
daabdadaacab	TRUE
daabdcaabcab	TRUE
dacdcaacaabd	TRUE
dacdcabcbcaa	TRUE
dbcabadcabaa	TRUE
dbcabcbdcddd	TRUE
dcaaaaabaccd	TRUE
dcaaacadcabc	TRUE
dccbcabacbac	TRUE
dccbcaddadbc	TRUE
ddbaaddcbaac	TRUE
ddbaadddacdc	TRUE
aaaaaadaacbb	FALSE
aaaaabacbbca	FALSE
aacbadccdbdb	FALSE
aacbaddbadac	FALSE
abaddaaccbdb	FALSE
abaddacdacbb	FALSE
abdcaaadcdbb	FALSE
abdcabcddbbd	FALSE
accaddadacbb	FALSE
accbacabcbba	FALSE
adbabdcbaacc	FALSE
adbacbbadddc	FALSE
addbccbaacbb	FALSE
addbcdcbaabc	FALSE
babddcbaabab	FALSE
babdddbaddcd	FALSE
bbabbbccdcdd	FALSE
bbabbcdaaaad	FALSE
bbcdbbbdadcc	FALSE
bbcdbcccbbda	FALSE
bcbbcbabbdca	FALSE
bcbbcbdacbcd	FALSE
bdaacdacccbb	FALSE
bdaacdbabdcb	FALSE
bdccbdadcabb	FALSE
bdcccaaaabab	FALSE
cabbaabccbcd	FALSE
cabbaacbdcca	FALSE
cbaabaabcbbc	FALSE
cbaababbbcba	FALSE
cbcbbdacddbd	FALSE
cbcbcaacbaab	FALSE
ccaddddbbbdb	FALSE
ccbaabadaaad	FALSE
ccdccaaccabb	FALSE
ccdcccaabbdc	FALSE
cdcbacdcbdab	FALSE
cdcbaddaaabd	FALSE
daadcccbdcbb	FALSE
daadcdbccabb	FALSE
dadcacaadbdb	FALSE
dadcaddbadbd	FALSE
dbbdbbaddddd	FALSE
dbbdbbccbcac	FALSE
dcabdccbcabb	FALSE
dcabdcccccbb	FALSE
dcccdddcabbb	FALSE
dccdaabccbab	FALSE
ddbadcddddbb	FALSE
ddbaddddbbcb	FALSE
aaaaaadaacdcb	TRUE
aaaaabcbacbdd	TRUE
aacaddadbccdc	TRUE
aacaddccbcbdc	TRUE
abadadddcdaaa	TRUE
abadcaaadbadd	TRUE
abdccbacddbac	TRUE
abdccbdcabdac	TRUE
accbccdadccaa	TRUE
accbccdbaccab	TRUE
adbaaacddbacc	TRUE
adbaaadcabaad	TRUE
addbadcdcdcaa	TRUE
addbaddaaaccd	TRUE
bacabcdcdacab	TRUE
bacabdccccccc	TRUE
badccacddbada	TRUE
badccadbdccbd	TRUE
bcbcaaabccadb	TRUE
bcbcaacacddbd	TRUE
bcdaadaddcaca	TRUE
bcdabcadcdaba	TRUE
bdadcbccdcbad	TRUE
bdadcccaddaad	TRUE
bddadcbcdbacc	TRUE
bddadccdacbcd	TRUE
cabacabdddada	TRUE
cabacacabcdad	TRUE
caddbadcbcddc	TRUE
caddbcccaadba	TRUE
cbdaacadcdaaa	TRUE
cbdaaccacadcd	TRUE
ccbcbcbaccbdd	TRUE
ccbcbcbddcdca	TRUE
ccdddaabdccab	TRUE
ccdddabaadadd	TRUE
cdcbcbcaabccc	TRUE
cdcbcbcddacba	TRUE
daadbacaaddcb	TRUE
daadbacccbdaa	TRUE
dadbdccacabcd	TRUE
dadbdcccccaba	TRUE
dbcbacbaccddb	TRUE
dbcbacbadacaa	TRUE
dcaadbcbaacdb	TRUE
dcaadbdacdbdc	TRUE
dcdaaabaacaba	TRUE
dcdaaabaacddd	TRUE
ddbcdbaddacaa	TRUE
ddbcdbcbddddc	TRUE
aaaaacccdcdbb	FALSE
aaaaacdbccbab	FALSE
aacdaaaabbcba	FALSE
aacdaadabcabb	FALSE
abbbabbbdbbcd	FALSE
abbbabcddaaac	FALSE
abdcdbaadccbb	FALSE
abdcdbabdadca	FALSE
accbbdacaadbd	FALSE
accbbdcaccbbc	FALSE
adbaaadbabbbb	FALSE
adbaabbcacdac	FALSE
addcbdaabbbdb	FALSE
addccaabaddbc	FALSE
bacaddbdbbbcd	FALSE
bacaddccadbdb	FALSE
bbadbcaaddcdd	FALSE
bbadbccbcbcdd	FALSE
bbdadcadaadba	FALSE
bbdaddcdcacdc	FALSE
bcbcccbdacabb	FALSE
bcbcccbdcaabb	FALSE
bdabaacdbacac	FALSE
bdababaabdbac	FALSE
bddaaabcccddd	FALSE
bddaabacaabdc	FALSE
cabbbcabaabdb	FALSE
cabbbcacbabbd	FALSE
cadddcbacaabb	FALSE
caddddbcacdbb	FALSE
cbcdacdbaaadb	FALSE
cbcdadddddbdb	FALSE
ccbbaacbbadba	FALSE
ccbbaacbdccdb	FALSE
ccdccaaabbbab	FALSE
ccdccadabcbbb	FALSE
cdcbcddbbbcbb	FALSE
cdcbdacdbcabb	FALSE
daaddadbbddac	FALSE
daaddbbadbccd	FALSE
daddbdbddcada	FALSE
daddcaacbabcc	FALSE
dbcabdccbaabc	FALSE
dbcabddaabbdc	FALSE
dcacbacbabbda	FALSE
dcacbbadcbbdd	FALSE
dcdaadbadddab	FALSE
dcdaadddcddbb	FALSE
ddbccddccdbbc	FALSE
ddbcdabbbadcd	FALSE
aaaaacccdcdbac	TRUE
aaaaacdccbadda	TRUE
aacdbacaacbcad	TRUE
aacdbaccaddcdc	TRUE
abcabacabccabd	TRUE
abcabdaacdcdbc	TRUE
abddccbddcbddd	TRUE
abddcdbcacdccb	TRUE
accbddcbdcdabd	TRUE
accbddddaaccdd	TRUE
adaddbcbadddcd	TRUE
adaddcadadaaad	TRUE
addccddccbacdc	TRUE
addcdbacaddcbd	TRUE
bacabadaaaaccc	TRUE
bacabadcadbcca	TRUE
badcabdddacdda	TRUE
badcacdbcccbdd	TRUE
bcbaacdbdcbaad	TRUE
bcbaacddcdaccc	TRUE
bcdaadbacacaca	TRUE
bcdaaddabcadda	TRUE
bdaddaadcdbcab	TRUE
bdaddacbacacbc	TRUE
bddcbaaccdcacd	TRUE
bddcbaacdcdcdb	TRUE
cabcbadaddadaa	TRUE
cabcbadcaacbcc	TRUE
cbaacdbdcadaba	TRUE
cbaadaaadacadc	TRUE
cbcdddabdaaadc	TRUE
cbcdddcadddcaa	TRUE
ccbadadadaccdb	TRUE
ccbadadddddcab	TRUE
ccddbaacbaadaa	TRUE
ccddbaacdcddbc	TRUE
cdcbdaacccacba	TRUE
cdcbdadcbccbda	TRUE
daaddaadadccab	TRUE
daaddcaccabaad	TRUE
dadbddcbdddada	TRUE
dadbddcddbdccd	TRUE
dbccaaccaddcbd	TRUE
dbccabaadcbadd	TRUE
dcabdaadddddca	TRUE
dcabdaccbcbcba	TRUE
dccddcddbdaccc	TRUE
dccdddacaacabd	TRUE
ddbccbaaacbdad	TRUE
ddbccbdddcbcdb	TRUE
aaaaaaacacdbbd	FALSE
aaaaabddbacbda	FALSE
aacbdacddacabb	FALSE
aacbdadacacdbb	FALSE
abadbabdbadddb	FALSE
abadbadabaacbc	FALSE
abdbacabaccacc	FALSE
abdbacbabdcbbb	FALSE
accaaaacdbdbca	FALSE
accaaadabdccbb	FALSE
adabdbcbbccbdc	FALSE
adabdbdccaddbb	FALSE
adcdcdcdadaabb	FALSE
adcddacaddabba	FALSE
babbbacddadbda	FALSE
babbbdbacbccdd	FALSE
badddadadabbdb	FALSE
badddbbdbcbacb	FALSE
bbcdbacbaddcba	FALSE
bbcdbbdbabccbc	FALSE
bcbcdacadcccbb	FALSE
bcbcdcbbdaacaa	FALSE
bdacabdacccabb	FALSE
bdacacbacbdcbb	FALSE
bddababdbbdbab	FALSE
bddabaddadccac	FALSE
cabbddaccccadc	FALSE
cabcabadadacbb	FALSE
caddcbbcbaaada	FALSE
cadddabbabddaa	FALSE
cbcbdacddbcbbb	FALSE
cbcbdbbaccdadb	FALSE
ccbbabcccacdca	FALSE
ccbbacabadacdb	FALSE
ccdbbdccdaaabc	FALSE
ccdbbdddcbadac	FALSE
cdbdcdbdccddbb	FALSE
cdbddaadbdbdaa	FALSE
daabcdbabcbcbd	FALSE
daabcdbddacdbb	FALSE
dadacbbddbacdc	FALSE
dadacbcdbbdaaa	FALSE
dbbcacddadddcb	FALSE
dbbcbcbaacabca	FALSE
dcaadacbadcbab	FALSE
dcaadaddbaadab	FALSE
dccdaadbcdbaab	FALSE
dccdabbdabcbac	FALSE
ddbbbbbcbbddca	FALSE
ddbbbcaaabcacb	FALSE
aaaaaaacacdbcdd	TRUE
aaaaabdcacbdacc	TRUE
aacbadadccaadbc	TRUE
aacbaddaccdbccc	TRUE
abaccddaaaabcdc	TRUE
abacdaaaaddacda	TRUE
abdccabacaabada	TRUE
abdccacdcbadacd	TRUE
acbdcbdaccddaac	TRUE
acbdcbdcdbdddcb	TRUE
adacaabcaadacac	TRUE
adacaacacbacacd	TRUE
adcddadaddcabdc	TRUE
adcddcbdddccbad	TRUE
baaddcaccdabaad	TRUE
baaddcbddcaacbc	TRUE
badadcdaccacdba	TRUE
badadcdbdddadcc	TRUE
bcbacadadcadabd	TRUE
bcbacbaadaaaddd	TRUE
bcdacccdccabcba	TRUE
bcdacdabaacdcdb	TRUE
bdaddadcaddaacd	TRUE
bdaddcaacaabaac	TRUE
bddcbcabdddcaad	TRUE
bddcbcadcdcbacd	TRUE
cabcdbcbaaacbcc	TRUE
cabcdbcdabaadaa	TRUE
caddbaccdbdaccc	TRUE
caddbcbdadaadaa	TRUE
cbcdacbdaaadcdb	TRUE
cbcdacbdacbcabd	TRUE
ccacddcadbdddaa	TRUE
ccacddcccddcacd	TRUE
ccdaacbacaaddaa	TRUE
ccdaadadbcdbaad	TRUE
cdbcddccdddbcdb	TRUE
cdbcddcdaddabcb	TRUE
daabddddcddcddc	TRUE
daacaaaaddcacdc	TRUE
dadacdcbdaacbcd	TRUE
dadacdccbaacdbd	TRUE
dbcadccabccdcdc	TRUE
dbcaddbaadcdcdb	TRUE
dcabcaccddbadca	TRUE
dcabcacdcddbccd	TRUE
dcdaacaabadaada	TRUE
dcdaacabdaaacca	TRUE
ddbccacbaaaaacc	TRUE
ddbccadbacaabad	TRUE
aaaaaabbdbcdadb	FALSE
aaaaabbdddbbdda	FALSE
aacbbdabdbccdda	FALSE
aacbcadaccbdcbb	FALSE
abbbbccdcaccbcd	FALSE
abbbcacaacdbcca	FALSE
acabacbdbdccaad	FALSE
acabaccccabbbdc	FALSE
accddaabccaddbb	FALSE
accddbbadabcbcc	FALSE
adbcbacbbccddcc	FALSE
adbcbacbddaddba	FALSE
adddaccbccdbaab	FALSE
adddadadbcacabb	FALSE
bacbaadabcbadda	FALSE
bacbaadcabdcdbb	FALSE
bbacbdacacddbab	FALSE
bbacbdcadcabadc	FALSE
bbcdccbbaddaacd	FALSE
bbcdccdbaccdbab	FALSE
bcbadcbcdadbdab	FALSE
bcbbaaaaaaadacb	FALSE
bcdcbaacccbddab	FALSE
bcdcbacdbcbbabd	FALSE
bdcabbdbbcbcbba	FALSE
bdcacaaacaabaab	FALSE
caadccbbdbcccad	FALSE
caadcddadadcbdb	FALSE
cadcbdbcabacabd	FALSE
cadcbddcaccddbb	FALSE
cbcaaadbaccbaab	FALSE
cbcaabdacadddbb	FALSE
ccabcbdaadcdabb	FALSE
ccabcbdcabaaaab	FALSE
ccdabbaaddcbaba	FALSE
ccdacbbacdbcadd	FALSE
cdbcdccbdadabcb	FALSE
cdbcddcdcccbcbb	FALSE
daabbdbdbbdadbb	FALSE
daabcacbcdbadba	FALSE
dadadacbadabbcc	FALSE
dadadbacadddcbb	FALSE
dbcabbabbbcbbcb	FALSE
dbcabcaacaaccbb	FALSE
dcabcccdcadbdbb	FALSE
dcabdaacabdacbb	FALSE
dccdacdabaaaaab	FALSE
dccdbaacbadcabb	FALSE
ddbadbbbadbdaac	FALSE
ddbadbdadccbdcc	FALSE
aaaaaabcdbcdadbd	TRUE
aaaaabdddacddada	TRUE
aacbcbcbaddcabac	TRUE
aacbcccabacbadcc	TRUE
abaddaaddcabdcca	TRUE
abaddadadddddcdd	TRUE
acabaacacccbcbad	TRUE
acabacbdddcaabcb	TRUE
accddaabaaddaadd	TRUE
accddabcccbccdba	TRUE
adbcbaddccdaaaba	TRUE
adbcbcaacdaaabdd	TRUE
adddccdbccbaaddd	TRUE
adddccdcccacbadc	TRUE
bacaccddaaabdcdb	TRUE
bacacddbacdacadd	TRUE
badcccbddadddcad	TRUE
badccccbaddaaada	TRUE
bcbadddaaaaacdac	TRUE
bcbcaabadcdabcdd	TRUE
bcdadbacdbcdabcd	TRUE
bcdadbadcabddddc	TRUE
bdacddcbaaaacdab	TRUE
bdadaaaadadaddad	TRUE
bddaadaddaaccdcd	TRUE
bddaadcbaaadcbca	TRUE
caadcdcbaaaddcad	TRUE
caaddacdccbcccdd	TRUE
cadcadbddacabcab	TRUE
cadcbaaacaadadbd	TRUE
cbcbdddddcdabcbd	TRUE
cbccaaabccacbacc	TRUE
ccabcbcaabcadadb	TRUE
ccabccbcbcbdadac	TRUE
cccdccddcdbadaad	TRUE
cccdccdddbcbacad	TRUE
cdbcbddacaddacbc	TRUE
cdbccaadcdcbadad	TRUE
daabaadcdacdbadd	TRUE
daabadadaaccacdb	TRUE
dadacbadcbcbadcc	TRUE
dadacbcbccdaacad	TRUE
dbcbcbccdabacddc	TRUE
dbcbcbdadcacaada	TRUE
dcabacdacbaccaba	TRUE
dcabacddaabcdadc	TRUE
dccdbaaadaccdbaa	TRUE
dccdbadadaddacdb	TRUE
ddbcbdddcabadaca	TRUE
ddbccbcccccbddaa	TRUE
aaaaaadccadcaabb	FALSE
aaaaacbdaccaddbb	FALSE
aacbadbcabbcdcbb	FALSE
aacbadbdadbccdba	FALSE
abbbbadbddaaadcd	FALSE
abbbbbdbaababacd	FALSE
acaaddcbdcbcbadb	FALSE
acaaddcddcacdbdb	FALSE
accbddbdbaabbbbc	FALSE
acccaaadabaaaaab	FALSE
adbacbcdddaadcbb	FALSE
adbacbddbbdbdabb	FALSE
addccdbcaccdbcbb	FALSE
addccdcbcbadcabb	FALSE
bacaacdccdbddaab	FALSE
bacaadacccdcbadb	FALSE
bbacccbbcdcabdcc	FALSE
bbaccddcdadcdcbc	FALSE
bbdababddabddcbd	FALSE
bbdabbacadbdcbaa	FALSE
bcbdabdcabdaadba	FALSE
bcbdacdadacbccbb	FALSE
bdaadcbabcccdbdc	FALSE
bdababbbcaddcbdc	FALSE
bddabadccbabccab	FALSE
bddabcbbccadcada	FALSE
cabbbaddbbcbcacd	FALSE
cabbbbbbaccadbbc	FALSE
cadddaadbbbabdda	FALSE
cadddaccabbaabba	FALSE
cbcbcbcdaccdacbb	FALSE
cbcbcccbdbbadcbc	FALSE
ccadcbadccbdaadb	FALSE
ccadcbbbdccdaccb	FALSE
ccdcaadcbdccbcbb	FALSE
ccdcabcababddadc	FALSE
cdbdccbaddbdcbbb	FALSE
cdbdccdadabddcbb	FALSE
daabbbccdbabbcca	FALSE
daabbbcdbadbcada	FALSE
dadaadcbbaddbdcb	FALSE
dadaadcdabcadbdb	FALSE
dbbdabcdabdaadba	FALSE
dbbdabdbdacdcabc	FALSE
dcabbbbddacaaabd	FALSE
dcabbbbdddddcaca	FALSE
dccddbbadacdabab	FALSE
dccddcaaccdcbbcc	FALSE
ddbcbaaccbadcabb	FALSE
ddbcbadccbdccabb	FALSE
aaaaaadccadcaaacc	TRUE
aaaaacaaccaddbacd	TRUE
aacbaacdaaaddadab	TRUE
aacbacacabddaaaaa	TRUE
abadcdaabacabaacd	TRUE
abadcdbaaaddcbcda	TRUE
acaadbccdacccacca	TRUE
acaadcadacaddcdcc	TRUE
accccddaaccadabaa	TRUE
accccddbdcaabcaba	TRUE
adbadaddddccadaac	TRUE
adbadcdbcdabccaad	TRUE
addcbaaacbcbacaaa	TRUE
addcbaaacbcddadcc	TRUE
bacbaddcbdcabacac	TRUE
bacbadddadadacbdc	TRUE
baddacacbcadcbcbc	TRUE
baddacadbacabdcad	TRUE
bcbadaaccdcdcdaaa	TRUE
bcbadacdddacdbaaa	TRUE
bcdabdacbdadddcba	TRUE
bcdabdcbdcdcddbdc	TRUE
bdadddaaacaadabcc	TRUE
bdadddaadccbcdadd	TRUE
bddadddddacdbcdca	TRUE
bddadddddcdbcbcba	TRUE
cabcdadcacbccbdca	TRUE
cabcdccabcabcccca	TRUE
cbaacdcbcbcabcacc	TRUE
cbaacdddccaaadbaa	TRUE
cbdaadcdacdddabdd	TRUE
cbdacacaaaccdbaad	TRUE
ccbadcbdadcbaadac	TRUE
ccbadccdcdcdaddbc	TRUE
ccdcccadddadbddac	TRUE
ccdcccdbaaacacaac	TRUE
cdcadaadcbaaacddc	TRUE
cdcadacadaddcdddb	TRUE
daabddadcdcadccda	TRUE
daabddaddaacbaacd	TRUE
dadbcbcddccdbdcba	TRUE
dadbccadbccccdbcd	TRUE
dbcbadacadbcdaabd	TRUE
dbcbadcaaabaaddcb	TRUE
dcabdddacbacdddcc	TRUE
dcabdddccabdcacbd	TRUE
dccddcaccaaabcdcc	TRUE
dccdddabaadccdccb	TRUE
ddbccdacabdddacbd	TRUE
ddbccdcaacabdddad	TRUE
aaaaaaccdadbcdbbd	FALSE
aaaaaadbcddababad	FALSE
aacbabdbadadcdadb	FALSE
aacbbababdbbbdcbc	FALSE
abacdcdaacbcbbcdc	FALSE
abacddcbcccdcbddb	FALSE
abdacacacaabddbdb	FALSE
abdacbabaccdcdbca	FALSE
acbdbcbadcbddcadd	FALSE
acbdbcbbacbdcdacd	FALSE
adabdcdacbaccddbb	FALSE
adabdcdcccadbcdbb	FALSE
addacbcdcbcadcbba	FALSE
addacccdccdcadcbb	FALSE
babcdbadcbbcbddbc	FALSE
babcdbbacbabbdbda	FALSE
bbabaabbdbabbdbcc	FALSE
bbabbaaccaacbdacc	FALSE
bbdaabbaacddcbbdd	FALSE
bbdaabbacdaabdabd	FALSE
bcbcdcbdcadabdcbb	FALSE
bcbcdccabdcabacbb	FALSE
bdaadccbcbabcdddb	FALSE
bdaaddbbccbadccad	FALSE
bdcddbbbdaaabaabc	FALSE
bdcddccccdddbabcd	FALSE
cabccbbdccdccbcaa	FALSE
cabcccbbccdabdbcb	FALSE
cbaabcdbddadaddba	FALSE
cbaabdabcadaadbbd	FALSE
cbcbdcabacbcdcdbb	FALSE
cbcbddbdbdcbbbaaa	FALSE
ccbacbbdcdcaddaab	FALSE
ccbaccacddabdcdbb	FALSE
ccdbddacadddadabb	FALSE
ccdbddbbcadbbcaba	FALSE
cdcababcacdaacdcb	FALSE
cdcabcbbdacdbbddd	FALSE
daaccacabcbaccabb	FALSE
daaccadddaadcdabb	FALSE
dadbbdabcbdbacdcc	FALSE
dadbbddbcddaccdad	FALSE
dbbddbbccdcabacdb	FALSE
dbbdddaaddaccdaac	FALSE
dcadaaadddcacdbab	FALSE
dcadaacbbddbcdccd	FALSE
dcdacbbaaababbadd	FALSE
dcdaccaddddcdadbb	FALSE
ddbcaadabaabdbdcd	FALSE
ddbcacbadddabadac	FALSE
aaaaabcccaadbdccad	TRUE
aaaaadbddaddddcabc	TRUE
aaccaddbdadacabaaa	TRUE
aaccbaaaadadccaadb	TRUE
abadccaadaacbcbdca	TRUE
abadccacbcbdaccbdc	TRUE
abddcddddddaabaccd	TRUE
abdddacabadadaacdd	TRUE
acccacaadacbddcbca	TRUE
acccacbdaaaacdcabd	TRUE
adbaccbccadaaddbcc	TRUE
adbaccbccbcbccdcdd	TRUE
addccbcacbddaaaadc	TRUE
addccdacaadcabcbad	TRUE
bacadccdbacbdddcba	TRUE
bacadddddbddccdbad	TRUE
badcdadaadcbcdabcd	TRUE
badcdbdcaccacbccca	TRUE
bcbccadadadbaaadcb	TRUE
bcbccaddabaacbadac	TRUE
bcdbcdacbaadccccaa	TRUE
bcdbcddacbcdadadcc	TRUE
bdadddaccbaadacbdd	TRUE
bdadddacdcbdddcbac	TRUE
bddadcbadaacddddab	TRUE
bddadcbdcabcbcaada	TRUE
cabcbddaaddacadbcd	TRUE
cabccbcdcabcddbcca	TRUE
cadcdccaaadabdaadd	TRUE
cadcdcdadbaddacccb	TRUE
cbcdcadcdbccdbcdab	TRUE
cbcdcbdddaacadccaa	TRUE
ccbaddcdcbdccbccda	TRUE
ccbadddddddcbdadca	TRUE
cdaaadaccdcacddacb	TRUE
cdaabaacadccdbaccd	TRUE
cdcbcdaacdbadcadaa	TRUE
cdcbcdabcddcbdcbcb	TRUE
daaddbcdcadcbcbaaa	TRUE
daaddcbddcdaddbddc	TRUE
dadbdaaacacdbccdba	TRUE
dadbdaaccabdadcadb	TRUE
dbcbcdcbaacbdcbddc	TRUE
dbcbcdddccddbdaacc	TRUE
dcaacdbdcbaacbdcdb	TRUE
dcaadabadccccdcbac	TRUE
dccdcadbaadcabaacc	TRUE
dccdcbdcbcdbcaadda	TRUE
ddbcaccdacdccbadad	TRUE
ddbcbacabaddaacccd	TRUE
aaaaaaaccaabaadcbb	FALSE
aaaaaabcbcaaadaabb	FALSE
aacbbcabbcbbdbaacd	FALSE
aacbbcbacddaacdacb	FALSE
abadabbacccdddbbdb	FALSE
abadabccddbaccbcdd	FALSE
abdcdddccccbaabddb	FALSE
abddaabbcabbbaadda	FALSE
acbdcdddcdbcacbbac	FALSE
acbddbacbabbbabacb	FALSE
adadaaadccadabcabb	FALSE
adadaabadacbacdcbb	FALSE
addbabbbabcdcbaacd	FALSE
addbabddabcbdabdab	FALSE
babcbacdbccbcddcdd	FALSE
babcbbbacccdbbabaa	FALSE
baddddccbadbabcaad	FALSE
badddddbcdadcadbaa	FALSE
bbccabadaddadbddaa	FALSE
bbccabcaacbcbdadda	FALSE
bcbbabdbacabcbaabc	FALSE
bcbbacadcbbdadbbcb	FALSE
bdaabcbdbccccdcaca	FALSE
bdaabcdbdbdcabdbdd	FALSE
bdccbccdbaabbdbbbc	FALSE
bdccbddaaabccdadbc	FALSE
cabaddacbcddaddcbb	FALSE
cabbaacabbadbcdbca	FALSE
caddcdadddcbcbbacd	FALSE
caddcdccdccdccbbab	FALSE
cbccbdacdabcaaccbb	FALSE
cbccbdcbdcdacdbaba	FALSE
ccbabcccaddcdcbbab	FALSE
ccbabccccbacabaada	FALSE
ccdbddadacdbbbbddb	FALSE
ccdbddbadaabccbdac	FALSE
cdbddbccdddcaaaddc	FALSE
cdbddcdcccbcbbdcdd	FALSE
daacacadbcbcdbcbbd	FALSE
daacadbaaddbdbdbac	FALSE
dadaabccaadcabbddc	FALSE
dadaacbbacdbabbccc	FALSE
dbbcddaacdbdaadcbb	FALSE
dbbcddcacdadcbbcbc	FALSE
dcabacadccbdbbacdc	FALSE
dcabacdbcdadcdcdbb	FALSE
dcdabaaadbadcdaaad	FALSE
dcdabaaadccbcddcbb	FALSE
ddbbadcdbbdccdbcba	FALSE
ddbbadddcbcbddbcad	FALSE
aaaaaaaccaabaadcdbd	TRUE
aaaaaabccaaadaaaddd	TRUE
aacbdcbcbcbdcaacccd	TRUE
aacbdcccdcdabdccdab	TRUE
abadcbadccbdacabcdb	TRUE
abadcbcacaabddccbca	TRUE
abddadcbdacbddaccba	TRUE
abddaddacaccbaccdab	TRUE
accbcbdcabacdccbddd	TRUE
accbcbdcdbadccbaaac	TRUE
adacdcaabddcbaadcbd	TRUE
adacdcdcaadadbccacc	TRUE
addadacccadbddcccbc	TRUE
addadbaacaabcaacbdc	TRUE
baadddcbdddacaadacb	TRUE
baadddcbddddacbacaa	TRUE
badacdbdcaccccacbca	TRUE
badacdcaadaadbdacbd	TRUE
bcadabddcccdcaacdaa	TRUE
bcadacdbccccdaabadc	TRUE
bccdcbcdccbccacddaa	TRUE
bccdccbadddaaadcbdd	TRUE
bdacdccbadaaacbadaa	TRUE
bdacddaaacdccbccbdc	TRUE
bddacdcabadaddcdbad	TRUE
bddacdcacdbaaaadada	TRUE
cabcbdcaaacbadccdad	TRUE
cabcbddccccbcadbdcc	TRUE
caddbcabcbcddcaccdb	TRUE
caddbcdabcbdaadadca	TRUE
cbcccadacbaddacdbaa	TRUE
cbcccbacaabddcdcdaa	TRUE
ccacdaaadadcabaacbd	TRUE
ccacdadabacaaccacba	TRUE
ccdbcdcdcbcccabcccb	TRUE
ccdbcddcccdaccccacb	TRUE
cdbdcaccabccadbaddd	TRUE
cdbdcbdcdcccadcbddd	TRUE
daacbdaadaadcddacba	TRUE
daacbdddcaaadbaadda	TRUE
dadbcbaccdccccccacb	TRUE
dadbcbdcdbdadacbcbc	TRUE
dbccabcdbcdbdccbdcc	TRUE
dbccacaaddccaaddbad	TRUE
dcacbacadbacaaabdcc	TRUE
dcacbacccbaaaccbddd	TRUE
dccddbdccbccdacacac	TRUE
dccddcaaccccabdddcd	TRUE
ddbccddadabdccbcdad	TRUE
ddbcdaaadbacbdadcba	TRUE
aaaaaaabbabbdbbbdbb	FALSE
aaaaaacbcbccbccadbb	FALSE
aacbcdaaddcbaacadbb	FALSE
aacbcdaccdddccaadbb	FALSE
abbaacbcbcaacdadadb	FALSE
abbaadaacdadbacaddd	FALSE
abdbbcccbbadbbcabcc	FALSE
abdbbddbabbabcbcdac	FALSE
acbdacacdcbaacabadb	FALSE
acbdbaabdcacbdabdad	FALSE
adabdbabacaaacacdbd	FALSE
adabdbbcddccadcacbc	FALSE
addabdcabbbcdadaada	FALSE
addacaacdbcdcccaabb	FALSE
babcbcbbacaddcbacdb	FALSE
babcbccbaabbcbcaacd	FALSE
bbaabdcbdbccdaddaba	FALSE
bbaacadacacaabacaca	FALSE
bbccdddcdbcaabcdaad	FALSE
bbcdabcdcbbdaddbdad	FALSE
bcbadddbbcbdabacbda	FALSE
bcbbaabcbbdbdcbdccd	FALSE
bcdcbbcdaaccbbdbbaa	FALSE
bcdcbbdcbccddbcabba	FALSE
bdcabccaabdaadbcbca	FALSE
bdcabccddcadbbcaddc	FALSE
caabcdaaacadcbdcdbb	FALSE
caabcdacbdaadbadaaa	FALSE
cadaabddcacbaccddbb	FALSE
cadaacbaabcacacadcd	FALSE
cbbbcdcddaddacddabb	FALSE
cbbbcddbbbdcddadbca	FALSE
ccabcbbadadaddcdada	FALSE
ccabcbbcdcbaabcacca	FALSE
cccdcacddcdcbcbdbcc	FALSE
cccdcbaabadbbaccadd	FALSE
cdbcccacacdadbbcaca	FALSE
cdbccccdbdacccbdbdd	FALSE
daabcdaaaacbdbbcacb	FALSE
daabcddccabaaddbabc	FALSE
dadbabaaccdcdbccddb	FALSE
dadbacabaaabdcbcadc	FALSE
dbbdadbcaadbdbbbbad	FALSE
dbbdbbbdcbbbdbddcbb	FALSE
dcacabcbcbbacdcacac	FALSE
dcacaccdccccbadabdc	FALSE
dcdadabaacbbbbaddab	FALSE
dcdadabdabccaddbcad	FALSE
ddbccdcbaacadcbbddd	FALSE
ddbcdaacabcbdcadbab	FALSE
