aaaaaaacca	TRUE
aaaaaacadc	TRUE
aacccccada	TRUE
aacccccadd	TRUE
aaddacacdc	TRUE
aaddacaddc	TRUE
abcacaaaca	TRUE
abcacaacac	TRUE
abdccdddcc	TRUE
abdcdacadd	TRUE
accaadaccc	TRUE
accaadaccc	TRUE
acdcadcaac	TRUE
acdcaddacb	TRUE
adadadaccc	TRUE
adadadadcb	TRUE
addaadcadb	TRUE
addacaaacb	TRUE
caacacaddc	TRUE
caacaccacd	TRUE
caccdaddcd	TRUE
caccdadddd	TRUE
cadcdddacb	TRUE
cadcdddcac	TRUE
ccadadadcc	TRUE
ccadadccda	TRUE
cccdcdadab	TRUE
cccdcddadc	TRUE
cdaacaaccb	TRUE
cdaacaacda	TRUE
cdcadcadda	TRUE
cdcadcaddb	TRUE
cddcacadab	TRUE
cddcacadac	TRUE
daaccacaab	TRUE
daaccaccda	TRUE
daccccaaab	TRUE
daccccaaac	TRUE
dadccdacdd	TRUE
dadccdcdad	TRUE
dcacddacdb	TRUE
dcacddadcd	TRUE
dccdadaaca	TRUE
dccdadacac	TRUE
dcddccccdb	TRUE
dcddccccdd	TRUE
ddaddadaab	TRUE
ddaddadacb	TRUE
ddcdddaddc	TRUE
ddcdddcada	TRUE
aaaaaacdba	FALSE
aaaaabdbaa	FALSE
aaccdcbddc	FALSE
aaccdccdbb	FALSE
abbaabcabb	FALSE
abbaacbcdc	FALSE
abdbcdabcd	FALSE
abdbcdbaca	FALSE
acbcdbacdb	FALSE
acbcdbdcba	FALSE
adababbdcb	FALSE
adababdbdc	FALSE
adccdadaba	FALSE
adccdbcbba	FALSE
babbdddbab	FALSE
babbdddcbd	FALSE
baddcdcbcd	FALSE
badddaaaac	FALSE
bbccbaabcc	FALSE
bbccbacbaa	FALSE
bcbbdaacdc	FALSE
bcbbdabbdc	FALSE
bcdcbadddc	FALSE
bcdcbccbcc	FALSE
bdcadaaaad	FALSE
bdcadabbab	FALSE
caaddbdcda	FALSE
caaddcabca	FALSE
caddbccacb	FALSE
caddbccadb	FALSE
cbcbccccdd	FALSE
cbcbcdabaa	FALSE
ccbadabbcc	FALSE
ccbadadacb	FALSE
ccdcdddabd	FALSE
ccddabdacb	FALSE
cdbddcadcc	FALSE
cdbdddaaab	FALSE
daaddbcadd	FALSE
daaddcddbc	FALSE
dadbccccca	FALSE
dadbcdbaab	FALSE
dbbdaaccbd	FALSE
dbbdadbdba	FALSE
dcabbdacda	FALSE
dcabbdadbd	FALSE
dcccbcaddd	FALSE
dcccbcddac	FALSE
ddbbadcacb	FALSE
ddbbbbdbba	FALSE
aaaaaaaccac	TRUE
aaaaaacdcca	TRUE
aacccaaadda	TRUE
aacccaccddc	TRUE
aaddadadccb	TRUE
aaddadccccd	TRUE
abcacdcdcda	TRUE
abcacddacdc	TRUE
abdcdcaacaa	TRUE
abdcdcacaac	TRUE
accaaadcccd	TRUE
accaaaddaaa	TRUE
acdcaddadda	TRUE
acdcaddaddc	TRUE
adadadacccc	TRUE
adadadacdac	TRUE
addaacadaab	TRUE
addaaccdcad	TRUE
caacadacaac	TRUE
caacadadacd	TRUE
caccdccaaaa	TRUE
caccdccdaad	TRUE
cadcdddacab	TRUE
cadcdddacac	TRUE
ccadcddaadb	TRUE
ccadcddaadc	TRUE
ccdaaaacdac	TRUE
ccdaaacadcc	TRUE
cdaacdcddab	TRUE
cdaadaaacda	TRUE
cdccaaaaaab	TRUE
cdccaaaccac	TRUE
cddcadaccdb	TRUE
cddcadaddda	TRUE
daaccaddadb	TRUE
daacccacccc	TRUE
dacccddcccc	TRUE
dacccdddcdc	TRUE
dadcdacacab	TRUE
dadcdacaccb	TRUE
dcacdcdaccc	TRUE
dcacdcdaddd	TRUE
dccdaadcddc	TRUE
dccdacaccaa	TRUE
dcddaacaaca	TRUE
dcddaaccdda	TRUE
ddadaccaadc	TRUE
ddadacccdab	TRUE
ddcdccadddb	TRUE
ddcdcccaaca	TRUE
aaaaaaabaac	FALSE
aaaaaadcdbc	FALSE
aaccbdddccd	FALSE
aacccabbbab	FALSE
abbaacadbcc	FALSE
abbaacdbccc	FALSE
abdcdbaabab	FALSE
abddaababca	FALSE
accacccacba	FALSE
accacdbddcb	FALSE
adaccbccabd	FALSE
adaccdabbbd	FALSE
addaadbddac	FALSE
addaadcbbcd	FALSE
babcccacadd	FALSE
babcccdbcab	FALSE
bbaacccbbca	FALSE
bbaaccdcaac	FALSE
bbcdcbaaabd	FALSE
bbcdcbababa	FALSE
bcbcccabacb	FALSE
bcbcccadaaa	FALSE
bcddbcddcdb	FALSE
bcddbdbcbaa	FALSE
bdccbacbada	FALSE
bdccbcddacd	FALSE
cabbbccdcca	FALSE
cabbbcddccd	FALSE
cbaaccabbad	FALSE
cbaacdabccd	FALSE
cbccddabcad	FALSE
cbccddbbdac	FALSE
ccbbbcaabdd	FALSE
ccbbbcdcbcb	FALSE
ccddbcacaaa	FALSE
ccddbdccdca	FALSE
cdccbdcaadc	FALSE
cdcccabdcdd	FALSE
dababcabaad	FALSE
dababcccdca	FALSE
dadbadbcadd	FALSE
dadbadcbccb	FALSE
dbbdcbbbbaa	FALSE
dbbdcbdacdb	FALSE
dcacbdaabac	FALSE
dcacbdcdbac	FALSE
dcdabdabcdd	FALSE
dcdacaaacbd	FALSE
ddbcdacbcda	FALSE
ddbcdbddcbb	FALSE
aaaaaaadcaca	TRUE
aaaaaaccaccc	TRUE
aaccccdddadc	TRUE
aacccdacddac	TRUE
aadddcacdaaa	TRUE
aadddcacdccb	TRUE
abccaaacaaca	TRUE
abccaaadcadd	TRUE
acaaaaaaccab	TRUE
acaaaacacccd	TRUE
acccacccaadc	TRUE
acccacccdddc	TRUE
acddaaddddcd	TRUE
acddaccaaccd	TRUE
adcaaaaacdaa	TRUE
adcaaaaadddb	TRUE
addccaddddcc	TRUE
addcccaadaab	TRUE
caaddadcddac	TRUE
caaddaddacaa	TRUE
cadaaacaddaa	TRUE
cadaaacdaaca	TRUE
ccaaadaccdab	TRUE
ccaaadaddcaa	TRUE
cccaccadaaaa	TRUE
cccaccaddaad	TRUE
ccdaccacdcdd	TRUE
ccdaccccccca	TRUE
cdacaaacadac	TRUE
cdacaaadaddb	TRUE
cdccaaccadad	TRUE
cdccaadaccdb	TRUE
cddcadadaaac	TRUE
cddcadadaadd	TRUE
daacaadadcda	TRUE
daacaadddaad	TRUE
dacadddccccd	TRUE
dacaddddaddd	TRUE
dadccdaddacb	TRUE
dadccddacaab	TRUE
dcacdcdddaaa	TRUE
dcacddacccda	TRUE
dccdaaaacccd	TRUE
dccdaaaaddaa	TRUE
dcddcacdacab	TRUE
dcddcadaacdd	TRUE
ddadacddadad	TRUE
ddadadaaddad	TRUE
ddcddacacccc	TRUE
ddcddaccaccc	TRUE
aaaaaaabaacd	FALSE
aaaaaaddccbc	FALSE
aaccacabadac	FALSE
aaccacccbaaa	FALSE
abaddcdcdccb	FALSE
abbaabcdbaab	FALSE
abddaccbadba	FALSE
abddacdcdcab	FALSE
accaddabdbac	FALSE
accaddcabdba	FALSE
adacbbddddcd	FALSE
adacbcacaaab	FALSE
addaccaacabb	FALSE
addaccbdaabb	FALSE
babcdcbdbaac	FALSE
babdaabcadab	FALSE
bbacacbacacd	FALSE
bbacaccbaacb	FALSE
bbdaabadbddc	FALSE
bbdaabbadbbc	FALSE
bcbcbdbcbdda	FALSE
bcbcbdcbbcba	FALSE
bdabadccbbac	FALSE
bdabbaccacac	FALSE
bdccdadcdada	FALSE
bdccdbacdabd	FALSE
cabbbccadaca	FALSE
cabbbcdabdad	FALSE
cbaaaacbddcc	FALSE
cbaaabcabbda	FALSE
cbcbbbbaadbc	FALSE
cbcbbcaaabbb	FALSE
ccaddcbaacba	FALSE
ccaddcddaabc	FALSE
ccddcbcabdad	FALSE
ccddcbdccabc	FALSE
cdcbdabacbab	FALSE
cdcbdacbcdcb	FALSE
dabacbadaadc	FALSE
dabacbbbdbba	FALSE
dadbdcadbadc	FALSE
dadbdcccdcca	FALSE
dbcaccbcaadb	FALSE
dbcaccbcdccc	FALSE
dcadaddbdaab	FALSE
dcadadddbbcb	FALSE
dcdbdccdddda	FALSE
dcdbddccadac	FALSE
ddbcacadccab	FALSE
ddbcaccdcada	FALSE
aaaaaaacaaacb	TRUE
aaaaaadccdcaa	TRUE
aaccaddadcdda	TRUE
aaccaddcacacd	TRUE
aaddccdccadaa	TRUE
aaddcdadddcca	TRUE
abcadadddcacc	TRUE
abcaddcddadcd	TRUE
abdcdcadddaaa	TRUE
abdcdcccddcdc	TRUE
accaccaaaddcc	TRUE
accaccaacdcdb	TRUE
acddaadaacaad	TRUE
acddaadadadab	TRUE
adcadaacaaaaa	TRUE
adcadaacacdac	TRUE
adddcacdcccca	TRUE
adddcadddaaab	TRUE
caaddadccaacd	TRUE
caaddcaddcacc	TRUE
cadaadadacdad	TRUE
cadaadaddddca	TRUE
ccaacacdacccd	TRUE
ccaacadadcdcb	TRUE
cccadccacddaa	TRUE
cccadcddaaddd	TRUE
ccdcacdcddddc	TRUE
ccdcadaccddca	TRUE
cdacacadadadb	TRUE
cdacacadcdacb	TRUE
cdccaddcaccad	TRUE
cdccaddccccda	TRUE
cddcdccdaccab	TRUE
cddcdccdadcab	TRUE
daadacdccaccb	TRUE
daadacddcadab	TRUE
dacdadacacacd	TRUE
dacdadadacadd	TRUE
daddccccaaaab	TRUE
daddccccaadca	TRUE
dcadcddaddccd	TRUE
dcadcddcaacda	TRUE
dccdccadddddd	TRUE
dccdcccadcada	TRUE
dcddccddaacad	TRUE
dcddccddadcac	TRUE
ddaddcccaaccd	TRUE
ddaddccddddad	TRUE
dddaaaddddaca	TRUE
dddaacaacacdc	TRUE
aaaaaaddbbdac	FALSE
aaaaabbcdcdab	FALSE
aacbccccbadab	FALSE
aacbcdbccaaab	FALSE
abadbddcdaccd	FALSE
abadcadcadddb	FALSE
abdcabcbcacdb	FALSE
abdcacdbcadbd	FALSE
accbbbdcdcbdb	FALSE
accbbcacddadb	FALSE
adadcbccabbcd	FALSE
adadcbdbcbcdd	FALSE
addcdcabacddc	FALSE
addcdcdddacba	FALSE
bacaddaabbbac	FALSE
bacaddbcaddbb	FALSE
bbadccbdbcabc	FALSE
bbadccdcacaba	FALSE
bbdbccdaacbac	FALSE
bbdbdacbacaab	FALSE
bccaccaaabdad	FALSE
bccaccdddabbc	FALSE
bdaddacdccacc	FALSE
bdadddabbbbda	FALSE
bddbcdababddc	FALSE
bddbcdadacdbd	FALSE
cacabddbacdbb	FALSE
cacacabddcbca	FALSE
cbacbacbccaaa	FALSE
cbacbdcaddbad	FALSE
cbdadccdababd	FALSE
cbdaddaccddcb	FALSE
ccbdcadcaacdd	FALSE
ccbdcbbccdadb	FALSE
cdabbdcabbdcb	FALSE
cdabbddcddcda	FALSE
cdcdaabdcbcbb	FALSE
cdcdacccacabd	FALSE
dabbdbdabccba	FALSE
dabbdbdccdbda	FALSE
dadcdcbbaaada	FALSE
dadcddbcbcbdd	FALSE
dbcbcadabadbb	FALSE
dbcbcbaddbddb	FALSE
dcacdbdbabacc	FALSE
dcadbacacdcbd	FALSE
dcdbababcbbcd	FALSE
dcdbacdabdabd	FALSE
ddbcbabbbcdab	FALSE
ddbcbabcabdab	FALSE
aaaaaaacdacada	TRUE
aaaaaacaaadadc	TRUE
aacccaaaaddada	TRUE
aacccaccccdada	TRUE
aaddcaaddaacad	TRUE
aaddcaddcaaccd	TRUE
abcadcaadaccda	TRUE
abcadcadddaaca	TRUE
abddaaddacccda	TRUE
abddacaaaaadca	TRUE
accadaadcacacd	TRUE
accadacaaadaaa	TRUE
acdcccddaadccd	TRUE
acdcccddcacada	TRUE
adadddcadcdaaa	TRUE
adadddccccaadd	TRUE
addcccadcdadcd	TRUE
addcccdaaccada	TRUE
caadadcdcdaacd	TRUE
caadaddadacacd	TRUE
cacdddacdacaac	TRUE
cacdddadccdacb	TRUE
cadddcadddccdd	TRUE
cadddcccdcacda	TRUE
ccaddadcacdadc	TRUE
ccaddaddaaacdc	TRUE
cccdddadddacab	TRUE
cccdddcaddcdcb	TRUE
ccddddaadddccb	TRUE
ccddddadddccda	TRUE
cdcaaadccaddcb	TRUE
cdcaaaddacaddb	TRUE
cddacadaadacad	TRUE
cddacadadadcca	TRUE
daaaddccaacdab	TRUE
daaaddcccaadcd	TRUE
daccaccadcaddb	TRUE
daccaccccaacac	TRUE
dadcdadcdacaaa	TRUE
dadcdadcdacadc	TRUE
dcacdcacaaacaa	TRUE
dcacdcccaddcdb	TRUE
dccccddcddcdcc	TRUE
dcccdaacdcdacd	TRUE
dcdccdccadaccc	TRUE
dcdccddadacaad	TRUE
ddacddaddadcda	TRUE
ddacddaddddcdd	TRUE
ddcdadcddadcca	TRUE
ddcdaddaddadab	TRUE
aaaaaacaccdbaa	FALSE
aaaaaacdddddba	FALSE
aacbcddbddbbaa	FALSE
aacbcddddddcdb	FALSE
abadbbbadbcbba	FALSE
abadbcabbaccbd	FALSE
abdaadcbcbaaab	FALSE
abdabbabdbbacb	FALSE
acbcadcdbdbbdd	FALSE
acbcbbcdaadaba	FALSE
adaacbbdcadacb	FALSE
adaacbcbbbcddc	FALSE
adcdccabaddddc	FALSE
adcdcccddcbdaa	FALSE
babbdcddacddbb	FALSE
babbddaddccacc	FALSE
badcdcccacdbcc	FALSE
badcdccdbdcdcc	FALSE
bbccaacbbbadbb	FALSE
bbccaadbdacccc	FALSE
bcbadacbabadba	FALSE
bcbadcabdbcbbb	FALSE
bcddddbbcacdcb	FALSE
bcddddcddbbbca	FALSE
bdccacbbaacaca	FALSE
bdccacdabacbbd	FALSE
caaddcddcdbadb	FALSE
cabaacbcababcb	FALSE
cbaacaccdadadb	FALSE
cbaacadabdbabb	FALSE
cbcbdacbaabbba	FALSE
cbcbdacdabcccc	FALSE
ccacccacbaddca	FALSE
ccaccccacdccbd	FALSE
ccdadcddacccbb	FALSE
ccdaddacadddbc	FALSE
cdbcdaaabbccab	FALSE
cdbcddbadcccba	FALSE
daacaabaddcbaa	FALSE
daacaabcdcabba	FALSE
dadadcccddbadc	FALSE
dadaddcabaccba	FALSE
dbbcdddcadbdbc	FALSE
dbbdaaacaadcac	FALSE
dcaadccbacccac	FALSE
dcaadccccabccb	FALSE
dccdabbacbdbbd	FALSE
dccdadaddaccbb	FALSE
ddbcacabddbacb	FALSE
ddbcacbadabdbc	FALSE
aaaaaaacdacadad	TRUE
aaaaaacaaadadcb	TRUE
aaccacaccccaacb	TRUE
aaccacccdcdacaa	TRUE
aaddccadcaaadcc	TRUE
aaddccccdddadcc	TRUE
abcacdcddacccda	TRUE
abcacddcccacdaa	TRUE
abdcdddcacdcdac	TRUE
abdcdddcdcdcaac	TRUE
accaaccdcaddcaa	TRUE
accaacdaaccdacd	TRUE
acdccadadcccaac	TRUE
acdccadadccdddd	TRUE
adcaaaccddacddb	TRUE
adcaaadccddcdad	TRUE
addccdaccacccac	TRUE
addccdaddacadaa	TRUE
caadadccaaccddd	TRUE
caadadcdadcdcca	TRUE
cacddcdcaaaaaac	TRUE
cacddcddacadddc	TRUE
caddcdccddcdddd	TRUE
caddcddaacaaccd	TRUE
ccaddcadcacdadc	TRUE
ccaddccdcdccadc	TRUE
ccdaaaddaadaaad	TRUE
ccdaaadddcddacb	TRUE
cdaacacdaccacca	TRUE
cdaacacdadcaaad	TRUE
cdcadacacddccdd	TRUE
cdcadacadaaadab	TRUE
cddcaadadccaada	TRUE
cddcaadcddcaadb	TRUE
daacaddccaddcdb	TRUE
daacadddccccdca	TRUE
daccaacdcdaadcc	TRUE
daccaadaacdccad	TRUE
dadcaaddaaacdab	TRUE
dadcaccadaadccc	TRUE
dcacdcacdaddada	TRUE
dcacdccaadcaaac	TRUE
dcccdcdcdaaaadc	TRUE
dcccddaadcdcacc	TRUE
dcddaaccdddcacd	TRUE
dcddaadcacdcddd	TRUE
ddadcaacadacdda	TRUE
ddadcaacaddaaaa	TRUE
ddcdccacdcdcacc	TRUE
ddcdccadcccacdc	TRUE
aaaaaabbddadada	FALSE
aaaaaacdbcabcbd	FALSE
aaccdcdbbdbacbb	FALSE
aaccdddddadbbba	FALSE
abbbababbcdcbca	FALSE
abbbacbacabaccc	FALSE
abddcccddddbbdc	FALSE
abddcdabaccdbbb	FALSE
accbccddadacbad	FALSE
accbcdbabcdcabd	FALSE
adadcbdbabdaaca	FALSE
adadcdcbccccadd	FALSE
addbccdccdacccb	FALSE
addbdabcdcbabad	FALSE
bacacbabbdaddcd	FALSE
bacacbadcccdbcd	FALSE
bbbababacadbcaa	FALSE
bbbabcbcaacdabb	FALSE
bbdbdadcdbacdbd	FALSE
bbdbdbcadacdaac	FALSE
bcbccdadcaacdac	FALSE
bcbccdddababdaa	FALSE
bdabbabddccdbdd	FALSE
bdabbbbbaadabbb	FALSE
bddaacacbdcdacd	FALSE
bddaadbdbcbcdda	FALSE
cabcbcacadcdadb	FALSE
cabccabbccacdbc	FALSE
cbabdbdbcbcbcdb	FALSE
cbabdcbcdbdbcbc	FALSE
cbcdbcddaaccbcc	FALSE
cbcdbdabcbddada	FALSE
ccbbbcbcbdadbda	FALSE
ccbbbccbbcacdad	FALSE
ccdcdadabdcbaba	FALSE
ccdcdbacddcdada	FALSE
cdcabdccdddabdb	FALSE
cdcabdcddbacbcd	FALSE
daadabbbddaaccc	FALSE
daadabdccdccadb	FALSE
dadccbcabbadbbd	FALSE
dadccbcbacbacac	FALSE
dbbdbdacdacddbd	FALSE
dbbdbdbccbcadbb	FALSE
dcabcbbddadadcd	FALSE
dcabcbdadcaabdb	FALSE
dccdcadabccbacd	FALSE
dccdcbdabcbabbc	FALSE
ddbcacabbadcabd	FALSE
ddbcacbdbaaabcc	FALSE
aaaaaaaacacdaaac	TRUE
aaaaaaaadccaacdd	TRUE
aacdaadadaacdccc	TRUE
aacdaadcdadddcad	TRUE
abaaaccaddcaacdc	TRUE
abaaacccaacdccac	TRUE
abccdccadaaaaaaa	TRUE
abccdccdadcdaadc	TRUE
acaaacadddacaddc	TRUE
acaaaccacaccacdd	TRUE
accccaccdcdddcaa	TRUE
accccadacdccddca	TRUE
acddddcaaacdacdb	TRUE
acddddcadaaddaaa	TRUE
adccaddcacddacdc	TRUE
adcccaacacaddadb	TRUE
caaaaccadddadadb	TRUE
caaaacdddccddaac	TRUE
caaddcaddddadcda	TRUE
caaddcccaccdaaca	TRUE
cadaaacdadccccca	TRUE
cadaaadaadacdacb	TRUE
ccaacaadacacdccb	TRUE
ccaacacaacccdadb	TRUE
cccaccdcdaaccccc	TRUE
cccaccdcdcdddacc	TRUE
ccdacadcdadcdccd	TRUE
ccdaccdaaddccddc	TRUE
cdaacddcdcaddcdd	TRUE
cdaadaadacdcdddd	TRUE
cdcacdccaaddadcb	TRUE
cdcacdcccaccddcb	TRUE
cddacdadccccddcc	TRUE
cddacdaddaaaccdb	TRUE
daaadadccdaaadaa	TRUE
daaadaddcaaadaad	TRUE
dacadadcaaadcdda	TRUE
dacadadcacddacdc	TRUE
dadccadcdaadacaa	TRUE
dadccaddcccadcda	TRUE
dcacdccdaccdadcd	TRUE
dcacdcdcdacaadcc	TRUE
dccdcadccdddddcc	TRUE
dccdcaddcaacdccd	TRUE
dcddcacdcddacccd	TRUE
dcddcadacdcacccc	TRUE
ddadadaacccaacda	TRUE
ddadadaacccdcddd	TRUE
ddcdcddccccdaacd	TRUE
ddcdcddcdcccccdd	TRUE
aaaaaacdcbdbccbd	FALSE
aaaaaadabcadadab	FALSE
aacdaabccdbcabac	FALSE
aacdacbbacbdbada	FALSE
abbbdddbcccbbddd	FALSE
abbcaaaccbdaaadb	FALSE
acaaddccadcdbbda	FALSE
acabaaacabbcabdb	FALSE
accdadcabaccbcba	FALSE
accdadcaccdbbbbc	FALSE
adbbaaccacdcbbda	FALSE
adbbaadabaaadcca	FALSE
addcdabbddbbbaba	FALSE
addcdbadadbcbddb	FALSE
bacbaccaacaabdab	FALSE
bacbacdbcbabacbc	FALSE
bbacabbbdbcdcbbd	FALSE
bbacabbdcbcdcacb	FALSE
bbdacaddaaacaaca	FALSE
bbdaccaadadcbbcd	FALSE
bcbccccbdddcabda	FALSE
bcbccccccadcbbba	FALSE
bdaabdbaadbdaadd	FALSE
bdaabdbbbcbcbdac	FALSE
bdccbbacacbaccda	FALSE
bdccbbaddadcacab	FALSE
cabbbacadabcbadd	FALSE
cabbbbcdabaadadc	FALSE
cadddbcacccdcada	FALSE
cadddbcdcacbaaaa	FALSE
cbcccdbbdaccbabb	FALSE
cbccdaccacddbccb	FALSE
ccadcdbbaacbdaca	FALSE
ccadcdcabbdcabbd	FALSE
ccdbdccbbabbccad	FALSE
ccdbddacdacbdbbc	FALSE
cdcabdaacccdbaca	FALSE
cdcabdbddbadcabb	FALSE
daadacbbdbccabdd	FALSE
daadacbcbdacbddb	FALSE
dadcbaccadadbbcc	FALSE
dadcbacddcbcabab	FALSE
dbcadcdcacabdacd	FALSE
dbcaddbadadacbdc	FALSE
dcadacdaccbdaadd	FALSE
dcadacdbacdacbac	FALSE
dcdaddbdbccbadac	FALSE
dcdadddcccadccba	FALSE
ddbcabddaaaddbbd	FALSE
ddbcabddddabdbbc	FALSE
aaaaaaaaccacaacac	TRUE
aaaaaaadaacccdadc	TRUE
aaccadcdacadacdcd	TRUE
aaccadcdadccdddcd	TRUE
aadddcaaacacccccc	TRUE
aadddcaaddcdcdaab	TRUE
abcccacdcacccddcc	TRUE
abccccacdcacdccdc	TRUE
abddddcadacdaddcd	TRUE
abddddccccdadadda	TRUE
acccacdcdcdacdaaa	TRUE
acccadcadcaadddcd	TRUE
acddcdaddddaaacdc	TRUE
acddcdcaacdaacaac	TRUE
adccacdadddadaaac	TRUE
adccadaadaccdacac	TRUE
addddaacaaadacadb	TRUE
addddaacdddaaaadc	TRUE
caaddccaccdccddad	TRUE
caaddccaccddacccd	TRUE
cacdddacdaadddcac	TRUE
cacdddccccddadcdd	TRUE
caddddcdaacccaddd	TRUE
cadddddcdddaddccc	TRUE
cccaaacddddddccad	TRUE
cccaaadaacaccadad	TRUE
ccdaaacccaadddcad	TRUE
ccdaaadaddddacddb	TRUE
ccddddaacdadaaada	TRUE
ccddddacaccdadcca	TRUE
cdcaadcaddcdcdcda	TRUE
cdcaadccaacdcaadc	TRUE
cddacacaacaadaadc	TRUE
cddacacaaddcdccac	TRUE
daaaccaaddcadccac	TRUE
daaacccacaaaadcaa	TRUE
dacadcdcdaddddddd	TRUE
dacadcddaccadadcc	TRUE
dadccaaacaccdadcc	TRUE
dadccaaadcdaccdcb	TRUE
dcadaacadddacadad	TRUE
dcadaadacadccdcad	TRUE
dccdacccaddccdaad	TRUE
dccdaccccaddccacc	TRUE
dcddaaadaddcdaccc	TRUE
dcddaacddcdcdaadb	TRUE
ddadcacdacaadcddc	TRUE
ddadcadacacdcadab	TRUE
ddcddaacdcacaddcd	TRUE
ddcddaadadacacccc	TRUE
aaaaaaaddabbaaadb	FALSE
aaaaaacbadaacdbca	FALSE
aaccabaaaaaddcbbd	FALSE
aaccabbcdaddacdda	FALSE
abbbabbcbcadbdabb	FALSE
abbbabdacddadacab	FALSE
acaabaaadbdcdcbdc	FALSE
acaababcdabbcddca	FALSE
accbcdbdbbccadbbb	FALSE
accbcddacbabdcbdc	FALSE
adadbccdacccaadcc	FALSE
adadbdaddcbcabcac	FALSE
addcbdaadbcbacbbc	FALSE
addccaabdbdabdbab	FALSE
bacbaccdbbccbdcdc	FALSE
bacbacddabbcdddcc	FALSE
bbbababcaaabaddbc	FALSE
bbbabacbddbcbccca	FALSE
bbdbcddbdcbcacdcc	FALSE
bbdbdaaaabdabaaba	FALSE
bccadaaadcbdbbabc	FALSE
bccadabddcadadddd	FALSE
bdadbcadbcbbaccab	FALSE
bdadcadddcbadbacb	FALSE
bddadcdadcacddbca	FALSE
bddaddcdcbbbdabad	FALSE
cabdaccdbdadabdba	FALSE
cabdbaaaabbddcbca	FALSE
cbabcbdbadcddbabc	FALSE
cbabccbadcbacccac	FALSE
cbcccdbdddbccaaba	FALSE
cbccdbdadbbdcadcc	FALSE
ccbabaabacadbcdaa	FALSE
ccbababbbcbdccbcc	FALSE
ccdcbdaabadddbdaa	FALSE
ccdcbdcadaccacdad	FALSE
cdcabbbcccdbcbcac	FALSE
cdcabbdbdbbcbbcbd	FALSE
daacaaadaaadbbadb	FALSE
daacaaddabbdcbdbc	FALSE
dadadbbadcadddaba	FALSE
dadadcaaccacbcdaa	FALSE
dbbdddacdccabddcd	FALSE
dbbdddcaacbcccbcc	FALSE
dcabcbcaacacdccaa	FALSE
dcabccaccaaacbcda	FALSE
dcdabdadaadcbdcbd	FALSE
dcdabdbdacadccdba	FALSE
ddbccabdaacaaccbc	FALSE
ddbccacacdbdabcda	FALSE
aaaaaaacacccdcddcb	TRUE
aaaaaaadaccdacccca	TRUE
aaccacdadaaddcdaab	TRUE
aaccacdccddccccdcd	TRUE
aaddcddcaadaacacac	TRUE
aadddaaaddcdcaddcd	TRUE
abcaddaacaaadaaaaa	TRUE
abcaddcadcadddccdd	TRUE
abdcddcdaccdaacacd	TRUE
abdcdddddcddcadaca	TRUE
accaaccdacdacdaddd	TRUE
accaaccdcdacccdada	TRUE
acdccaacdddcacaaca	TRUE
acdccaadcddcdcdacd	TRUE
adaddadadcdddddada	TRUE
adaddadaddccdadacc	TRUE
addcaddcaaccacacda	TRUE
addcaddcdadddccdad	TRUE
caacdaaaaddcacaaad	TRUE
caacdaadacdaadacdd	TRUE
caccdacddacaaccccc	TRUE
caccdadaccddcdcadd	TRUE
cadcccaacdaaddaaca	TRUE
cadccccdadacccddcd	TRUE
ccaccdddddaacadcda	TRUE
ccaccdddddcdadaccb	TRUE
ccccdddaaccddddacd	TRUE
ccccddddaddaaccdcd	TRUE
ccddcdcacdddadadcc	TRUE
ccdddacacdcdddaccc	TRUE
cdcaadccaddccdcdcc	TRUE
cdcaadcdadadddacdb	TRUE
cddaccaddccaacaccb	TRUE
cddaccccaaadaadddc	TRUE
daaaddaaadddcaadca	TRUE
daaaddaacaaddaddab	TRUE
dacccaacacdaadccad	TRUE
dacccaaccccaaacccd	TRUE
dadccaaaccadcccadb	TRUE
dadccaaadcddaccccd	TRUE
dcaccaadacccdacacb	TRUE
dcaccaccdadddcdcca	TRUE
dccccdacccdddadcdc	TRUE
dccccdadaacdaaadaa	TRUE
dcddadccddcadaaaad	TRUE
dcddaddaacacdddcab	TRUE
ddadcaccaddddaacdc	TRUE
ddadcacdcddaacaadb	TRUE
ddcddcccdaaddacdab	TRUE
ddcddcdaaacaccdccb	TRUE
aaaaabadccddcadbbd	FALSE
aaaaabdbbbccdabada	FALSE
aacbdbbaaddccdabca	FALSE
aacbdcbddbbcbaccdc	FALSE
abadbddaadbbabcadd	FALSE
abadcacccccaacabbc	FALSE
abdbcbabccddacccda	FALSE
abdbcccaadcbdbadba	FALSE
acbdbbacbcaaabdbaa	FALSE
acbdbbdddddbcdbaaa	FALSE
adabadbdadabbddbca	FALSE
adabbaacccdabccddc	FALSE
adcdaabdabaccdabcb	FALSE
adcdabbadcaddcddac	FALSE
babcabdbbbaaaaaccc	FALSE
babcacacdabdabbccd	FALSE
bbaacddcddcabbcada	FALSE
bbaadbadcabaddcaaa	FALSE
bbcdabcadabcddbbca	FALSE
bbcdacaabdcbbadada	FALSE
bcbbbcbdbccccbdbab	FALSE
bcbbcaabdbdcdbaabb	FALSE
bcdcdaacddcacdbdbc	FALSE
bcdcdbabcbbdcacbcb	FALSE
bdcbcaabddcdacdadc	FALSE
bdcbcabbcaccdbcbab	FALSE
caaddccbcddbaacdaa	FALSE
caaddddcabbdbcbcda	FALSE
cadcabcacaabcadcbd	FALSE
cadcabddaacccdbdbd	FALSE
cbcabcdccdccbbdbbd	FALSE
cbcabdcbbcaacadadb	FALSE
ccacaadaddcddbcbbd	FALSE
ccacabacadddcbbaba	FALSE
ccdaacdcbbadbbbaca	FALSE
ccdaadbabbdbbdaccb	FALSE
cdbdadadddcdaccddb	FALSE
cdbdbadadbdbcaadba	FALSE
daacbbbdcbdbcddadc	FALSE
daacbdbcbcccacbbca	FALSE
dadbbbbaccdccabbcb	FALSE
dadbbbbbacdcacbddb	FALSE
dbbdbcccbdaaabadcc	FALSE
dbbdbdcbdacdccadda	FALSE
dcaaddacbaaacbdbba	FALSE
dcaaddbbadcdaacbab	FALSE
dcdaadaccbabdbcbbb	FALSE
dcdaaddacddaddbbdd	FALSE
ddbcddaaccdaacdcbd	FALSE
ddbcddaacdaadbadaa	FALSE
aaaaaaccaadddcdadca	TRUE
aaaaaacccccdddaadcb	TRUE
aacccaddcccdcadcdac	TRUE
aacccaddddccaadaacb	TRUE
abaaacadaddcacaacca	TRUE
abaaacccaddadaccaac	TRUE
abccdaacdadcadddaac	TRUE
abccdaddadcdccdaaac	TRUE
acaaacdaaccdddadaad	TRUE
acaaacdaadcddcacaaa	TRUE
acccadddccccdcccdaa	TRUE
accccaaaccaacadadcd	TRUE
acddadacddaddcdcadb	TRUE
acddaddacdcccccccab	TRUE
adcaacdcaacaaccacad	TRUE
adcaacdcdadcaaccdaa	TRUE
addccccddccacaadaaa	TRUE
addcccdddacddccadac	TRUE
caadcaaccdddaacdcdd	TRUE
caadcaadccacaccdadd	TRUE
cacdacdacccaddcaaab	TRUE
cacdacdcacaacaddaab	TRUE
caddcddcacdcdaaadac	TRUE
cadddaadccccccdaaad	TRUE
ccaddaacddaadcadacc	TRUE
ccaddaccaaadaaaadac	TRUE
cccddcdacccacdaaccb	TRUE
cccddcdacdcdccccdcc	TRUE
ccdddddddaacaaacddc	TRUE
cdaaaaadcddaaaccacb	TRUE
cdcaaacccadacdcddca	TRUE
cdcaaadcacccdcacccd	TRUE
cddacdcddccdacdcadb	TRUE
cddacddadadaccaacdb	TRUE
daaadacdccdaadddcdb	TRUE
daaadacddadadddcdad	TRUE
dacadadacadcacdcdab	TRUE
dacadadccdcdcccaadd	TRUE
dadcaadaddcaadadacd	TRUE
dadcaadcddcacaddcdc	TRUE
dcaccaaaccdaddadcca	TRUE
dcaccaaadccacacccda	TRUE
dccccdcaaaaaccddada	TRUE
dccccdcaacddaadcdcb	TRUE
dcdcdddaaaadacacdaa	TRUE
dcdcdddadddaaaaacdb	TRUE
ddadacccdddaccdaccc	TRUE
ddadaccdccdcdaddccc	TRUE
dddaaacacccaddacddb	TRUE
dddaaacadcdacadddaa	TRUE
aaaaabbcabdbcbabdcc	FALSE
aaaaabbdcdadacddbdb	FALSE
aaccaaacbdaaabdccbb	FALSE
aaccaaadbbaddbddaab	FALSE
abadcadbdbadaacccac	FALSE
abadcaddbcbdddabcad	FALSE
abdbcbaaaddacdddabc	FALSE
abdbcbadcbbbdabdacb	FALSE
acbccccbbdcaabccccc	FALSE
acbcccdcbccbdaddcdc	FALSE
acddbcbddbbccadadaa	FALSE
acddbdbbccbdbdabcdb	FALSE
adcbadccdaabddcaaab	FALSE
adcbbaaabbddaabbaaa	FALSE
baadcbacbbcaabccabc	FALSE
baadcbdaababbccccdc	FALSE
badbdabcbcbaccbdcba	FALSE
badbdbbdaddbbacdacd	FALSE
bbbdcbddcdcbcaabcdc	FALSE
bbbdccccbaabbddcbbb	FALSE
bcabdaddcccddcbbbca	FALSE
bcabddaaadadbcaaada	FALSE
bcdadddbbabccbbdacd	FALSE
bcdbaacbabaacddaaac	FALSE
bdcaabddbababdbaddd	FALSE
bdcabbbdbbbbbadaadc	FALSE
caadccabbdadacdbdaa	FALSE
caadcccbbadbcbcddcc	FALSE
cadbcdaccbdacbdbdca	FALSE
cadbcdbaacbdbbbaddc	FALSE
cbbdabaadcadadbcdba	FALSE
cbbdadddbcacddbcddd	FALSE
ccabcbaadbbdbdcbadc	FALSE
ccacabcbddccdbdbbca	FALSE
ccdacdbdcabbbbbbaca	FALSE
ccdadbcadaabdacbdac	FALSE
cdbccacbacbddadcbad	FALSE
cdbccaccbbccbdabddd	FALSE
daabccdbcbcdbbabbdc	FALSE
daabcdccabadcdadcda	FALSE
dadbbbacdcdbcaddabd	FALSE
dadbbbaddacdbbbccba	FALSE
dbbdcadcdbabaccaccd	FALSE
dbbdcdcadbadbaaddab	FALSE
dcabbbabaababccbdbc	FALSE
dcabbbdcadcabcdddab	FALSE
dcdabaddbabaabdabda	FALSE
dcdabbabdddcaddcabb	FALSE
ddbcbabaddcddbcadcc	FALSE
ddbcbbadacbdddbdcbd	FALSE
