aaaaaabadb	TRUE
aaaaaadcab	TRUE
aacbcbcadb	TRUE
aacbdabdcb	TRUE
abbadabcbb	TRUE
abbadbccdb	TRUE
abdcaccaab	TRUE
abdcbdabab	TRUE
acbdddbdab	TRUE
acbdddcabb	TRUE
adabadaacb	TRUE
adabaddbdb	TRUE
adcdabcbdb	TRUE
adcdacdaab	TRUE
babadddbaa	TRUE
babaddddba	TRUE
badbddbacd	TRUE
badbddddbc	TRUE
bbcbaacbcd	TRUE
bbcbabaacd	TRUE
bcadbabada	TRUE
bcadbacdad	TRUE
bcddaaacbd	TRUE
bcddabacbc	TRUE
bdcbaaabbc	TRUE
bdcbaacdad	TRUE
caadbcccda	TRUE
caadcabdcd	TRUE
cadcbcadaa	TRUE
cadcbcbaaa	TRUE
cbcabacaba	TRUE
cbcabbcdcd	TRUE
ccacaaabdc	TRUE
ccacaadadc	TRUE
ccdbbdbdca	TRUE
ccdbcaaacc	TRUE
cdbdbcbaca	TRUE
cdbdbdbbbc	TRUE
daabcabbdd	TRUE
daabcbdbbd	TRUE
dadadaaadd	TRUE
dadadabcbc	TRUE
dbbdabcdcc	TRUE
dbbdadbdac	TRUE
dcabadbdbd	TRUE
dcabaddacc	TRUE
dccccbbdad	TRUE
dccccbcaac	TRUE
ddbbddbbaa	TRUE
ddbcabcdca	TRUE
aaaaaabadc	FALSE
aaaaaadcac	FALSE
aacbcbcadc	FALSE
aacbdabdcd	FALSE
abbadabcbd	FALSE
abbadbccda	FALSE
abdcaccaad	FALSE
abdcbdabad	FALSE
acbdddbdac	FALSE
acbdddcabc	FALSE
adabadaaca	FALSE
adabaddbdc	FALSE
adcdabcbda	FALSE
adcdacdaac	FALSE
babadddbab	FALSE
babaddddbb	FALSE
badbddbacb	FALSE
badbddddbb	FALSE
bbcbaacbcb	FALSE
bbcbabaacb	FALSE
bcadbabadb	FALSE
bcadbacdab	FALSE
bcddaaacbb	FALSE
bcddabacbb	FALSE
bdcbaaabbb	FALSE
bdcbaacdab	FALSE
caadbcccdb	FALSE
caadcabdcb	FALSE
cadcbcadab	FALSE
cadcbcbaab	FALSE
cbcabacabb	FALSE
cbcabbcdcb	FALSE
ccacaaabdb	FALSE
ccacaadadb	FALSE
ccdbbdbdcb	FALSE
ccdbcaaacb	FALSE
cdbdbcbacb	FALSE
cdbdbdbbbb	FALSE
daabcabbdb	FALSE
daabcbdbbb	FALSE
dadadaaadb	FALSE
dadadabcbb	FALSE
dbbdabcdcb	FALSE
dbbdadbdab	FALSE
dcabadbdbb	FALSE
dcabaddacb	FALSE
dccccbbdab	FALSE
dccccbcaab	FALSE
ddbbddbbab	FALSE
ddbcabcdcb	FALSE
aaaaaabadcb	TRUE
aaaaaadabab	TRUE
aacbdaabbdb	TRUE
aacbdacdbdb	TRUE
abadddbcacb	TRUE
abadddbcdab	TRUE
abdcdabdbbb	TRUE
abdcdabdddb	TRUE
acbddccbabb	TRUE
acbdddcdcbb	TRUE
adabacbaccb	TRUE
adabacdbdcb	TRUE
adccdbaacbb	TRUE
adccdbabccb	TRUE
babadaccadc	TRUE
babadadabdc	TRUE
baddbcbcdba	TRUE
baddbccbdac	TRUE
bbccadcacac	TRUE
bbccbbddadd	TRUE
bcbacdacbcc	TRUE
bcbadabcbad	TRUE
bcddbcdbcbc	TRUE
bcddbdabcaa	TRUE
bdcacabbcca	TRUE
bdcacbcabdd	TRUE
caadcabacbc	TRUE
caadcbbadbd	TRUE
caddaacdddc	TRUE
caddaccdaca	TRUE
cbcabdbdabc	TRUE
cbcacabddcd	TRUE
ccaccbaaadc	TRUE
ccaccbbddbd	TRUE
ccdbacacacd	TRUE
ccdbadcadba	TRUE
cdbdaabddac	TRUE
cdbdacaacaa	TRUE
daabacabdaa	TRUE
daabadbabba	TRUE
dacdacddada	TRUE
dacdadaccbd	TRUE
dbbcadcabdc	TRUE
dbbcbaaabba	TRUE
dcaacbdcbaa	TRUE
dcaaccbadac	TRUE
dccdcbdcdcc	TRUE
dccdccbdddc	TRUE
ddbbcaddbcc	TRUE
ddbbcdbacba	TRUE
aaaaaaaaadd	FALSE
aaaaabbcbcd	FALSE
aacdaabaaca	FALSE
aacdababaad	FALSE
abbbbbacdba	FALSE
abbbbbcbcdc	FALSE
acaabbadabc	FALSE
acaabbbbddc	FALSE
acccbdaacba	FALSE
acccbdcdccc	FALSE
adbacbccccc	FALSE
adbacdaccda	FALSE
adddacddadc	FALSE
adddbaacabd	FALSE
babddacdbbb	FALSE
babddbcdddb	FALSE
bbacbbbbadb	FALSE
bbacbbdabcb	FALSE
bbdabaacbdb	FALSE
bbdabacbabb	FALSE
bcbccbddbdb	FALSE
bcbccbddcbb	FALSE
bdabaaadabb	FALSE
bdabaabbdbb	FALSE
bdccbcbbddb	FALSE
bdccbcdcbab	FALSE
cabaabbdbdb	FALSE
cabaabcccdb	FALSE
caddbccdaab	FALSE
caddbdbaabb	FALSE
cbccccddacb	FALSE
cbcccdaacbb	FALSE
ccbacabcadb	FALSE
ccbacbbdcdb	FALSE
ccdcccbbbcb	FALSE
ccdcdbcadbb	FALSE
cdcbdaacbdb	FALSE
cdcbddccbdb	FALSE
dabaabcbadb	FALSE
dabaacaaccb	FALSE
dadbdcddddb	FALSE
dadbddaccdb	FALSE
dbbdaaacbbb	FALSE
dbbdaaaccbb	FALSE
dcabbacabdb	FALSE
dcabbbbdaab	FALSE
dccdddcdbcb	FALSE
dcdaaaaddab	FALSE
ddbbdadbbcb	FALSE
ddbbdbbadcb	FALSE
aaaaaaaaaddb	TRUE
aaaaabcbccdb	TRUE
aacdaccbcbab	TRUE
aacdacdbdbdb	TRUE
abbacddcdabb	TRUE
abbadacbaabb	TRUE
acaabcabccab	TRUE
acaabcbadaab	TRUE
acccaaadacab	TRUE
acccaaadbbdb	TRUE
adbaaababddb	TRUE
adbababacbcb	TRUE
adddbaadbdab	TRUE
adddbbbddbcb	TRUE
bacacdacdaac	TRUE
bacacdbccdac	TRUE
bbabcaabdddd	TRUE
bbabcaaddadc	TRUE
bbdaaaddacdc	TRUE
bbdaaccddbcd	TRUE
bcbdcbadcddd	TRUE
bcbdcbcddccc	TRUE
bdaacaabdacc	TRUE
bdaacbdabaad	TRUE
bdccbbddbacc	TRUE
bdccbcbbcdac	TRUE
cabaccdcdadc	TRUE
cabadacbbcba	TRUE
caddcdccdbca	TRUE
caddcddcbacd	TRUE
cbcbdacdaadd	TRUE
cbcbdbabdcba	TRUE
ccbadbcdaacc	TRUE
ccbadbdbcccc	TRUE
ccdcccccaabc	TRUE
ccdcccddcada	TRUE
cdcbacbaaabd	TRUE
cdcbacbbaacc	TRUE
dabadbabcddc	TRUE
dabadbbacabc	TRUE
daddacbdadda	TRUE
daddbaccbacd	TRUE
dbcadcdccddd	TRUE
dbcaddababca	TRUE
dcabdccdabaa	TRUE
dcabddabacaa	TRUE
dccdacbbabaa	TRUE
dccdadbdacbc	TRUE
ddbcaadccccd	TRUE
ddbcabdbdbca	TRUE
aaaaaaaaadda	FALSE
aaaaabcbccdc	FALSE
aacdaccbcbaa	FALSE
aacdacdbdbdc	FALSE
abbacddcdaba	FALSE
abbadacbaabc	FALSE
acaabcabccad	FALSE
acaabcbadaac	FALSE
acccaaadacaa	FALSE
acccaaadbbdd	FALSE
adbaaababddd	FALSE
adbababacbcc	FALSE
adddbaadbdaa	FALSE
adddbbbddbcd	FALSE
bacacdacdaab	FALSE
bacacdbccdab	FALSE
bbabcaabdddb	FALSE
bbabcaaddadb	FALSE
bbdaaaddacdb	FALSE
bbdaaccddbcb	FALSE
bcbdcbadcddb	FALSE
bcbdcbcddccb	FALSE
bdaacaabdacb	FALSE
bdaacbdabaab	FALSE
bdccbbddbacb	FALSE
bdccbcbbcdab	FALSE
cabaccdcdadb	FALSE
cabadacbbcbb	FALSE
caddcdccdbcb	FALSE
caddcddcbacb	FALSE
cbcbdacdaadb	FALSE
cbcbdbabdcbb	FALSE
ccbadbcdaacb	FALSE
ccbadbdbcccb	FALSE
ccdcccccaabb	FALSE
ccdcccddcadb	FALSE
cdcbacbaaabb	FALSE
cdcbacbbaacb	FALSE
dabadbabcddb	FALSE
dabadbbacabb	FALSE
daddacbdaddb	FALSE
daddbaccbacb	FALSE
dbcadcdccddb	FALSE
dbcaddababcb	FALSE
dcabdccdabab	FALSE
dcabddabacab	FALSE
dccdacbbabab	FALSE
dccdadbdacbb	FALSE
ddbcaadccccb	FALSE
ddbcabdbdbcb	FALSE
aaaaabcaccadb	TRUE
aaaabbcddbcab	TRUE
aaccbcdaaddbb	TRUE
aacccbdcaaddb	TRUE
abbababaacddb	TRUE
abbabbdaadcab	TRUE
abdcbbbaaabdb	TRUE
abdcbbccdbddb	TRUE
accabccacdbcb	TRUE
accabdcbdcdcb	TRUE
adacdaadccaab	TRUE
adacdacabcdcb	TRUE
addbbddbbdddb	TRUE
addbcbcabaabb	TRUE
bacaacabcdcbd	TRUE
bacabadadddbd	TRUE
bbbabcabdbccc	TRUE
bbbabcacddaba	TRUE
bbdbdacbbadaa	TRUE
bbdbdadacdcda	TRUE
bcbddbcdcaabc	TRUE
bcbddbdaaacaa	TRUE
bdabcbbcddbac	TRUE
bdabcbcbadacc	TRUE
bdccddabdddad	TRUE
bdccdddabadbd	TRUE
cabadbdbdbdac	TRUE
cabadccaaaccc	TRUE
cbaaabdbbcbba	TRUE
cbaaabdcddadc	TRUE
cbcbbbcabcbba	TRUE
cbcbbbcacadbd	TRUE
ccadcacbdccbd	TRUE
ccadccaccbbca	TRUE
ccdadddaccabc	TRUE
ccdbaacadadac	TRUE
cdbddbbabcccc	TRUE
cdbddccaddbbc	TRUE
daabdacadadcc	TRUE
daacaaaadcaac	TRUE
dadadaaadccad	TRUE
dadaddaaadddd	TRUE
dbbdadacdcbaa	TRUE
dbbdadbadcbac	TRUE
dcaadaccbacdc	TRUE
dcaadacddcbcc	TRUE
dccdccbcccbaa	TRUE
dccddbccbbacc	TRUE
ddbbccdcbaadd	TRUE
ddbbdbacacaca	TRUE
aaaaabcaccadc	FALSE
aaaabbcddbcaa	FALSE
aaccbcdaaddbd	FALSE
aacccbdcaaddd	FALSE
abbababaacdda	FALSE
abbabbdaadcac	FALSE
abdcbbbaaabdc	FALSE
abdcbbccdbddd	FALSE
accabccacdbcc	FALSE
accabdcbdcdcd	FALSE
adacdaadccaac	FALSE
adacdacabcdcd	FALSE
addbbddbbdddc	FALSE
addbcbcabaabd	FALSE
bacaacabcdcbb	FALSE
bacabadadddbb	FALSE
bbbabcabdbccb	FALSE
bbbabcacddabb	FALSE
bbdbdacbbadab	FALSE
bbdbdadacdcdb	FALSE
bcbddbcdcaabb	FALSE
bcbddbdaaacab	FALSE
bdabcbbcddbab	FALSE
bdabcbcbadacb	FALSE
bdccddabdddab	FALSE
bdccdddabadbb	FALSE
cabadbdbdbdab	FALSE
cabadccaaaccb	FALSE
cbaaabdbbcbbb	FALSE
cbaaabdcddadb	FALSE
cbcbbbcabcbbb	FALSE
cbcbbbcacadbb	FALSE
ccadcacbdccbb	FALSE
ccadccaccbbcb	FALSE
ccdadddaccabb	FALSE
ccdbaacadadab	FALSE
cdbddbbabcccb	FALSE
cdbddccaddbbb	FALSE
daabdacadadcb	FALSE
daacaaaadcaab	FALSE
dadadaaadccab	FALSE
dadaddaaadddb	FALSE
dbbdadacdcbab	FALSE
dbbdadbadcbab	FALSE
dcaadaccbacdb	FALSE
dcaadacddcbcb	FALSE
dccdccbcccbab	FALSE
dccddbccbbacb	FALSE
ddbbccdcbaadb	FALSE
ddbbdbacacacb	FALSE
aaaaabcaccadbb	TRUE
aaaabaddbcaaab	TRUE
aaccadcaadacab	TRUE
aaccbaddbbbccb	TRUE
abbadabdaddcab	TRUE
abbadbbbcabadb	TRUE
abdcccaaadddbb	TRUE
abdcccccdaabbb	TRUE
accabcbdcbddab	TRUE
accabccaddadab	TRUE
adadccaabcccab	TRUE
adadccabcbbdbb	TRUE
addcbcbacaabbb	TRUE
addcbcbdbdbbdb	TRUE
bacaadcadbcaac	TRUE
bacabaaabcbcac	TRUE
bbadaaacccbaaa	TRUE
bbadabbadaacbc	TRUE
bbdabcadbbbacc	TRUE
bbdabcbadddbbd	TRUE
bcbcbdbcdbdcaa	TRUE
bcbccadcdabcbd	TRUE
bdaaaccdcabacd	TRUE
bdaaadbbacccba	TRUE
bdcccbabbbbddc	TRUE
bdcccbacacccba	TRUE
cabbbdddccdbca	TRUE
cabbcabddaaddc	TRUE
caddbcdddbcadc	TRUE
caddcabacaabdc	TRUE
cbcbacdadcbabc	TRUE
cbcbadbbdccdcc	TRUE
ccacdcbbadbcca	TRUE
ccacddbacddbad	TRUE
ccdadcdaacdccd	TRUE
ccdbaacdcdccdd	TRUE
cdbcacbbcccaad	TRUE
cdbcadacddbbba	TRUE
daabbaaabdcdac	TRUE
daabbacdcadbac	TRUE
dacdcddcadaaad	TRUE
dacddabbcadabd	TRUE
dbbbbdabddccba	TRUE
dbbbbddddacbaa	TRUE
dbddbdabdbcddc	TRUE
dbddbddadccbad	TRUE
dccbdbcbcbcdda	TRUE
dccbdcacacacca	TRUE
ddbbcdcabbdacd	TRUE
ddbbdbadabcbda	TRUE
aaaaaaaccdabcc	FALSE
aaaaaadcdbdada	FALSE
aacbdbbdcaaada	FALSE
aacbdbcbcaabdd	FALSE
abbaccccadbdaa	FALSE
abbaccdaddaadd	FALSE
abddacbacaabca	FALSE
abddaccbbaabca	FALSE
acccbaaddcdbcc	FALSE
acccbacbbdbdad	FALSE
adbbaabaaadccd	FALSE
adbbaabcadbbbc	FALSE
adddaaddcaddaa	FALSE
adddabbaadadac	FALSE
bacadbacbabbdb	FALSE
bacadbbbcbdcab	FALSE
bbadadcbdcacbb	FALSE
bbadbadccbdaab	FALSE
bbdbdccbcddbcb	FALSE
bbdbdcccadadcb	FALSE
bccaddbcbacacb	FALSE
bccbabcdbcabdb	FALSE
bdacdccabaacab	FALSE
bdadaaabbacdab	FALSE
bdcdddbbddadcb	FALSE
bdcdddddcbbbdb	FALSE
cababaadaacacb	FALSE
cabababbddbcdb	FALSE
cadbbdddacbcab	FALSE
cadbcdddbadaab	FALSE
cbbcccdbcbdaab	FALSE
cbbccdacbdccab	FALSE
ccabadaacadcab	FALSE
ccabaddbadbabb	FALSE
cccdcdcaaccdbb	FALSE
cccddacaadcdcb	FALSE
cdbdcadbcbbcdb	FALSE
cdbdcbbdbbbaab	FALSE
daacabaadddccb	FALSE
daacaddbbddcbb	FALSE
dadbaccbbddccb	FALSE
dadbacdbdcbadb	FALSE
dbbdacdadbbadb	FALSE
dbbdadbccddbbb	FALSE
dcababadaccdcb	FALSE
dcabacbdcaadab	FALSE
dccddccccbdadb	FALSE
dccdddbbdcdcdb	FALSE
ddbbcdbacabdcb	FALSE
ddbbdadaacacdb	FALSE
aaaaaaaccdabcbb	TRUE
aaaaaadcddddadb	TRUE
aaccacaaaccdbcb	TRUE
aaccacabcadaacb	TRUE
abbadbacacadbbb	TRUE
abbadbcbaaacbcb	TRUE
abddabbdaadaacb	TRUE
abddabdbcddbddb	TRUE
accccdcdccbabdb	TRUE
acccdabdbabdbdb	TRUE
adbadbaaccaddab	TRUE
adbadddccbaacbb	TRUE
addcdabbbcadadb	TRUE
addcdbabdaddccb	TRUE
bacbadacddbddac	TRUE
bacbadbbcadbcdc	TRUE
bbacdcadddcdcbc	TRUE
bbacddacadcbaaa	TRUE
bbdadaadbdcbadd	TRUE
bbdadabdcaabcca	TRUE
bcbcddccbdcbddc	TRUE
bcbcddcdbdbcabc	TRUE
bdaaaacbbaadbdd	TRUE
bdaaacdacdabacd	TRUE
bdccaaccabcdbdc	TRUE
bdccadbdbbdbcbd	TRUE
cabbaddbaddbbcc	TRUE
cabbbaabadcaccc	TRUE
cbaaacacdddbbcd	TRUE
cbaabaadcbbdbca	TRUE
cbcbbbdcddbabdc	TRUE
cbcbbcdbaddbaba	TRUE
ccacddcbbdcbadd	TRUE
ccadaabbccaacbd	TRUE
ccdcbbcabcadbcd	TRUE
ccdcbbccabbadaa	TRUE
cdbdcccdbdaaabd	TRUE
cdbdcdacdcccdcd	TRUE
daacbacddbdddaa	TRUE
daacbcadbaaaacc	TRUE
dadbcdcbbdabadc	TRUE
dadbcdccdaaccad	TRUE
dbbdcbcdcccadcc	TRUE
dbbdcbdadcacdda	TRUE
dcabdddcdabdcbd	TRUE
dcacaacbdbbaadd	TRUE
dccdcbdbadcbacd	TRUE
dccdcbdbdacaaad	TRUE
ddbaddabcdcbaba	TRUE
ddbaddcadcccddc	TRUE
aaaaabadaaaaaca	FALSE
aaaaabcbadadbbd	FALSE
aacbddddccbaddc	FALSE
aaccaaaaddcacac	FALSE
abbaabacdcbaabc	FALSE
abbaacadbdadbac	FALSE
abdbddcbadccddd	FALSE
abdbddcccdacbbd	FALSE
acbdccdcbaccbaa	FALSE
acbddacbdbbdbad	FALSE
adabbbaabbabaca	FALSE
adabbdbdcadacbd	FALSE
adcddcaabadabbc	FALSE
adcddcccddbdadd	FALSE
babbabcabdaabbb	FALSE
babbacccbdcabdb	FALSE
baddddaabadcbab	FALSE
baddddacaadcacb	FALSE
bbcacdbdabbdbab	FALSE
bbcadcacdaadacb	FALSE
bcacbbdbdccbddb	FALSE
bcacbcccdcbdbab	FALSE
bcdabddabbdccbb	FALSE
bcdacccabcabcab	FALSE
bdbccaccadcadcb	FALSE
bdbccbbcdbbacdb	FALSE
caabbbdcbcdcabb	FALSE
caabcadccbdbbbb	FALSE
cadaacdabdabccb	FALSE
cadaadccbdbcdbb	FALSE
cbbbadbbddcdacb	FALSE
cbbbadddabacadb	FALSE
ccabbdcbaccaddb	FALSE
ccabcacbabaccbb	FALSE
ccdbaaaababbcbb	FALSE
ccdbabaacccbccb	FALSE
cdcaaacbacdacdb	FALSE
cdcaabadcbbdddb	FALSE
daaccbcbaaaabab	FALSE
daaccdadabacbab	FALSE
dadacdcadadcbdb	FALSE
dadadbbdbcbbbdb	FALSE
dbbdabdbccddddb	FALSE
dbbdacabdbdbacb	FALSE
dcaabdaccaccbab	FALSE
dcaacaaddccdaab	FALSE
dcccabdbdccdadb	FALSE
dcccadbdaddbcab	FALSE
ddbbddbaababdcb	FALSE
ddbbddcdcbddbcb	FALSE
aaaaabadaaaaacab	TRUE
aaaaabcadadbbcdb	TRUE
aaccaddbbbbdccab	TRUE
aaccbacddaabadcb	TRUE
abaddbdbccadadab	TRUE
abadddcbbbbdbcab	TRUE
abdbdbaddcbababb	TRUE
abdbdbcbaabacacb	TRUE
acbdacdddcaddcbb	TRUE
acbdadadbabbaddb	TRUE
adaadcddcbbddabb	TRUE
adaaddcdbccccbcb	TRUE
adcdabddacbcacab	TRUE
adcdaccdbbbabadb	TRUE
babbabbabcdbadcd	TRUE
babbacbddcbbabbd	TRUE
badcbadbabcddaaa	TRUE
badcbadbacbcbaaa	TRUE
bbbdcccdaccdaccd	TRUE
bbbdcdbaabbcbdba	TRUE
bcabdddadddabcbd	TRUE
bcacaaaddbbddccc	TRUE
bcdadbadddccccac	TRUE
bcdadbbadaaaadca	TRUE
bdbccddcbabcccdd	TRUE
bdbcdabcdbcbccac	TRUE
caabcbacbccdcdcc	TRUE
caabccbbaacacadd	TRUE
cadadbcccacbaacd	TRUE
cadadbdbabbddbca	TRUE
cbbdbadcabdbccdc	TRUE
cbbdbccadadadbba	TRUE
ccacadabaacbcdbd	TRUE
ccacbaadbaaabbdd	TRUE
ccdbacddaddbbbdd	TRUE
ccdbadccdbcaadbc	TRUE
cdbdaccdaacccada	TRUE
cdbdacdacacdadad	TRUE
daacbbadabcbaabc	TRUE
daacbbbbbacdacda	TRUE
dadaccddbadbccdd	TRUE
dadadaabcbbdddbd	TRUE
dbbdadbcacbabcba	TRUE
dbbdadbdbddcbbcd	TRUE
dcabbdbacacabbad	TRUE
dcabbddaadbdadbd	TRUE
dcdadbaabbccccba	TRUE
dcdadbdbdaababcc	TRUE
ddbdaddcacbbcaaa	TRUE
ddbdbabbdbabbdac	TRUE
aaaaabbcdcabdbcd	FALSE
aaaaabbdaadbbaca	FALSE
aacbcabbcbddbaad	FALSE
aacbcbaacbabacaa	FALSE
abadadddbaabcadc	FALSE
abadbabacdcdacda	FALSE
abdaddbdbccbbbcd	FALSE
abdbaaccddddadda	FALSE
acbcdacddcaccdda	FALSE
acbcdbbdbdcdcadc	FALSE
adaadbcddddddbba	FALSE
adaadcbddbcabcba	FALSE
adcdcdccbababadd	FALSE
adcddacbaccccdbd	FALSE
babbbbbdacbadabb	FALSE
babbbcbbbcbbacab	FALSE
badcbdbccdbcccbb	FALSE
badcbdcbaaaaddab	FALSE
bbcaccbcabccbdbb	FALSE
bbcacdadbcccbdbb	FALSE
bcaddccabdacbdbb	FALSE
bcbaaabbacadddcb	FALSE
bcdccaccbacbddcb	FALSE
bcdccdbcbaddcabb	FALSE
bdcaccbabcdcbaab	FALSE
bdcacdbabaccdcdb	FALSE
caabdbdbdcdaaccb	FALSE
caabdbdddbdbadcb	FALSE
cadacaddacccbbdb	FALSE
cadacbcaababdbcb	FALSE
cbbcbacbddbdcddb	FALSE
cbbcbacdddabdaab	FALSE
ccaadcbabdbaadab	FALSE
ccabaaabcdaccccb	FALSE
cccdcbdaacdcbbbb	FALSE
cccdccadcdccddcb	FALSE
cdbbbcbdcaccabdb	FALSE
cdbbbccbbccbcdab	FALSE
daaaabdaabdccadb	FALSE
daaaacaacbddaacb	FALSE
daccbcdcaaadadbb	FALSE
daccbcdddbcaddbb	FALSE
dbbbabddbbabcdcb	FALSE
dbbbacaddcddabab	FALSE
dcaacddddbbbabab	FALSE
dcaadaadadaadacb	FALSE
dcccbdbacaabbaab	FALSE
dccccbabaaacbacb	FALSE
ddbbaadadacbbccb	FALSE
ddbbabaaacbacbab	FALSE
aaaaabbcdcabdbccb	TRUE
aaaaabbdadbbacadb	TRUE
aacbbccadbaaadbab	TRUE
aacbbdbcaababcddb	TRUE
abadadacaacddcacb	TRUE
abadbaaabcabacbbb	TRUE
abdacdccbcdbbcacb	TRUE
abdacddcbdaaacdcb	TRUE
acbcbababaadccdbb	TRUE
acbcbbbddccaadcab	TRUE
adabadccdabddbbab	TRUE
adabadddbdbadddbb	TRUE
adcdcabbddacbdcdb	TRUE
adcdcbdcbcbaddcbb	TRUE
babbdcbcbcdcbcaca	TRUE
babbdcbccbcbdcbaa	TRUE
bbaabcbbdbaacbacd	TRUE
bbaabdabccbbbaaad	TRUE
bbcddbbbbbbccbbdd	TRUE
bbcddbbccacdbbdaa	TRUE
bcbabadabbcabdacc	TRUE
bcbabadddbcdaddad	TRUE
bcdbdbabcaddcbbdd	TRUE
bcdcaacbaccdcccad	TRUE
bdbdaaabbadbdcbac	TRUE
bdbdaaccccdacdadd	TRUE
caacadcbacadaaaba	TRUE
caacadcccbbabacdc	TRUE
cadaddadccccaaada	TRUE
cadaddbccabccccbd	TRUE
cbbcbabdabcaadbcd	TRUE
cbbcbbbbabdbabaaa	TRUE
ccababcbaadcbccbc	TRUE
ccabadababdddadbd	TRUE
cccccbbdadcbaabaa	TRUE
ccccccbdabaaadcba	TRUE
cdbbadcdddcdadbcc	TRUE
cdbbbbcaccdaccccd	TRUE
daaabbacccbabdaaa	TRUE
daaabbadbddbaacbc	TRUE
daccddacdbcddcaad	TRUE
daccddbbccdddcdbd	TRUE
dbbbcabbaacacbacd	TRUE
dbbbcacccccdaadcc	TRUE
dcaababdabcdddbdd	TRUE
dcaabadadbdbdbcac	TRUE
dcccddddcddabaacd	TRUE
dccdabdcaaaaacadc	TRUE
ddbadadbacbabacbd	TRUE
ddbadccddddabddac	TRUE
aaaaaadcaccdabcad	FALSE
aaaaabddcbddbabad	FALSE
aaccccdbbbacdadbc	FALSE
aaccdacdbcbbbdbda	FALSE
abaddcddacccbaabd	FALSE
abadddababbbcdcca	FALSE
abddabdaddbdcdabd	FALSE
abddacdababcdcddc	FALSE
accabdacdcccddbbd	FALSE
accacaacdbdcdcadc	FALSE
adadcacddcaaaccbc	FALSE
adadcadacbadcabca	FALSE
addbaaadbcacaadca	FALSE
addbaabccaadccbdd	FALSE
babdccbbdddbcacbb	FALSE
babdcccccbddddbdb	FALSE
bbacababcbddadddb	FALSE
bbacabbccbdaaaabb	FALSE
bbdaadcacaccdacbb	FALSE
bbdabaabbcbcddbcb	FALSE
bcbbbbbbadddaaddb	FALSE
bcbbbbcdbcdaabbab	FALSE
bcddcadcaccdcdcab	FALSE
bcddcbdabcbbbcdab	FALSE
bdccbbabadbadbacb	FALSE
bdccbbabbcabbbdcb	FALSE
caadddabcbcccabdb	FALSE
caaddddddcaccaccb	FALSE
cadcacdddbbacdcbb	FALSE
cadcadaabadcdbbdb	FALSE
cbbdddddbaccbdbdb	FALSE
cbcaaadbdacdddcdb	FALSE
ccabdcccadbcccccb	FALSE
ccacaadacbdbacccb	FALSE
ccdabdabaadcaadcb	FALSE
ccdabddcdbcabacdb	FALSE
cdbdcbaacbababddb	FALSE
cdbdcbabdcbdcbbdb	FALSE
daabdbcdbbdbbaddb	FALSE
daacaaaacccddabab	FALSE
dacdaacdbccccaccb	FALSE
dacdbaaccbaddacbb	FALSE
dbbbbcdbacaabdbdb	FALSE
dbbbbdaacddcccbcb	FALSE
dbddcdccbcacbdcdb	FALSE
dbdddacaddbadbddb	FALSE
dcccbbaacbbdddadb	FALSE
dcccbbcaacbcbaccb	FALSE
ddbbbcbacdddcaabb	FALSE
ddbbbcdbdbadcbddb	FALSE
aaaaaadcaccdabcadb	TRUE
aaaaabdcbddbabadab	TRUE
aaccdcaaaabcbbddbb	TRUE
aaccdcdbbdbcadccbb	TRUE
abbbbdabdbacabddcb	TRUE
abbbcaadcccccbbbab	TRUE
abddbdbdcdbdbdcbdb	TRUE
abddbddacadbdbcbcb	TRUE
accbbbdcddbdbbbbdb	TRUE
accbbbddbacdbaccdb	TRUE
adadbbcbdadbcdddbb	TRUE
adadbcacbcbbbbdabb	TRUE
addadbaabcbbbacbcb	TRUE
addadbabcdbddadcdb	TRUE
babdbbdbdbcdabaadc	TRUE
babdbcaaabbcadabcd	TRUE
bbaabaccabbdaabcba	TRUE
bbaabbababcabccabd	TRUE
bbcdbdcbbbbcccccca	TRUE
bbcdcaaaabadbcaaad	TRUE
bcbadcdcaaaaaccddd	TRUE
bcbadcdccbbddabcbc	TRUE
bcddccdcbdbccacbdc	TRUE
bcddcdacccbaccbddc	TRUE
bdcbadbdcdccbadcbc	TRUE
bdcbadcbaaacddddbd	TRUE
caadcdcccbabbdaaac	TRUE
caaddaaadabbbcddda	TRUE
cadcdcbaaabdbcadda	TRUE
cadcdccbdaacdcaabd	TRUE
cbcbbcacacdcdbcabd	TRUE
cbcbbddcdbadcbcaad	TRUE
ccbbabcdacdbddbbda	TRUE
ccbbabdbdaadcddbdd	TRUE
ccdcbcbbcaadaaacdd	TRUE
ccdcbcdbddbccbcccc	TRUE
cdbddcdcaddadadaba	TRUE
cdcaacaaccddcbadda	TRUE
daabcdaccbabccbcdd	TRUE
daabcdbcbbbcbacddd	TRUE
dacccdbcaabaadbbdd	TRUE
daccdacdddbacacadc	TRUE
dbbacddddaccccdcbd	TRUE
dbbadaadbcdabadaac	TRUE
dbddddcadcacccddca	TRUE
dcaaaabbcaacccbbac	TRUE
dccdbbbbbcdabadbda	TRUE
dccdbbcdbcdabadbcc	TRUE
ddbbdbbaddcdaddaad	TRUE
ddbbdcdabcabaccbbc	TRUE
aaaaabadadcaabaaba	FALSE
aaaaabbdbdbcaabacd	FALSE
aaccdaaddaacdcbbba	FALSE
aaccdadccacbabccdd	FALSE
abbacdbcdddbbddada	FALSE
abbacdcabbdbbbddaa	FALSE
acaabcadbbcbdacddd	FALSE
acaabcbbdabadacacc	FALSE
acccbdadaccccbabcc	FALSE
acccccbbbdacbdaccd	FALSE
adbbcadcdcdbbdccdc	FALSE
adbbdabccbcddbadcd	FALSE
addcccbadadddcbbdc	FALSE
addccdbbcdbdccbbdc	FALSE
bacaacacbdcbacabbb	FALSE
bacabbbababdcddaab	FALSE
bbacadaddbdbbbccdb	FALSE
bbacbaabccdabbdcab	FALSE
bbcddcadbccbdbcabb	FALSE
bbcddcdadaccbdcddb	FALSE
bcbbabdccdadbdcbbb	FALSE
bcbbacacdcddddaadb	FALSE
bdaadadbabcbabbdab	FALSE
bdaadbbaddbbcbdaab	FALSE
bdcdacdbbbcdbcccbb	FALSE
bdcdbaabcacabcbadb	FALSE
cabcacddaccdadbbab	FALSE
cabcadcabbdcbbcdbb	FALSE
cbaadcbccbcccabbab	FALSE
cbaadccdaccaadaadb	FALSE
cbccccaddbbddcbabb	FALSE
cbcccdacdbbcaddcbb	FALSE
ccbbadcdcdbbaddbab	FALSE
ccbbaddcaccdbbdaab	FALSE
ccddcaaaabcdcbbadb	FALSE
ccddcacbbbcbaabdcb	FALSE
cdcbcdbccdbcacaacb	FALSE
cdcbcddabcdabcdbcb	FALSE
dabacadcdcdccdbddb	FALSE
dabacbdcacbccacbdb	FALSE
dadcdbccabcabdcbdb	FALSE
dadcdbccacadbcddbb	FALSE
dbcadcbdcccddbaddb	FALSE
dbcbabbcbbdacacbcb	FALSE
dcabdbbdccbbaabdab	FALSE
dcabdbdacabbabdbbb	FALSE
dccdbbaaadddcbbadb	FALSE
dccdbbdddbbdacddab	FALSE
ddbbcaaaaabacabbcb	FALSE
ddbbcaaacdacbadabb	FALSE
aaaaaabadbdbacaabbb	TRUE
aaaaaabdaadccadddcb	TRUE
aaccabdcbbbabdcabdb	TRUE
aaccacddadaacbcccab	TRUE
abbacddaccaddcadbdb	TRUE
abbadaabbbbdbcbbddb	TRUE
abdddaadadccbddbccb	TRUE
abdddadbacacccbbdab	TRUE
accbdcabdabadcbabbb	TRUE
accbdcacaaacbbbacdb	TRUE
adbabcdabcbbbdbbacb	TRUE
adbabdccadbddcbddbb	TRUE
addccbacddcdbacdcbb	TRUE
addccbbbbcddcbdcddb	TRUE
babddccdbccddbcbaad	TRUE
babddccdccdbddbccad	TRUE
bbabdddccdacbcacdba	TRUE
bbacaaccdbadabbaadd	TRUE
bbdabadaaaddcdaacbd	TRUE
bbdacbdacdacbdbabbd	TRUE
bcbbcbdccccadcbcccc	TRUE
bcbbccddcbcbdabbddc	TRUE
bdaaabbcbcbdcccbcac	TRUE
bdaaabbdcacbddbaaaa	TRUE
bdcbabacdccacacdacc	TRUE
bdcbabdcbbdbccaacbc	TRUE
caaddadbadacabdcadd	TRUE
caaddcacacaddbcdabc	TRUE
cadbddbdcababdcbcdc	TRUE
cadcaddaddbaacdcdcc	TRUE
cbcadacbcaaabccabad	TRUE
cbcadbadbdccadcbccd	TRUE
ccacacdaadcaabacddc	TRUE
ccacacdcaddbbacaccc	TRUE
ccdabccddadbacbbddd	TRUE
ccdabdcbabbcbbdbbac	TRUE
cdbccabcaabaaccdabd	TRUE
cdbccbabdabacbcbbac	TRUE
daaaccdaaccbcccbcca	TRUE
daaacdcdcabbaaadbda	TRUE
dacdcabbccbbcbbadaa	TRUE
dacdcadabdcdcddabbc	TRUE
dbbbcccbccccccbcbaa	TRUE
dbbbdadbddbcbcdbaac	TRUE
dbddddaddaabccbbbdc	TRUE
dbddddbdcbacadcaaca	TRUE
dcccaaacbbbdbbbbada	TRUE
dcccababbbdbabdadac	TRUE
ddbbbbddbdcdbdcdcbd	TRUE
ddbbbcbcabaaaadaaaa	TRUE
aaaaaabadbdbacaabbd	FALSE
aaaaaabdaadccadddca	FALSE
aaccabdcbbbabdcabdd	FALSE
aaccacddadaacbcccac	FALSE
abbacddaccaddcadbdc	FALSE
abbadaabbbbdbcbbddc	FALSE
abdddaadadccbddbccc	FALSE
abdddadbacacccbbdac	FALSE
accbdcabdabadcbabbd	FALSE
accbdcacaaacbbbacda	FALSE
adbabcdabcbbbdbbacc	FALSE
adbabdccadbddcbddbd	FALSE
addccbacddcdbacdcba	FALSE
addccbbbbcddcbdcddc	FALSE
babddccdbccddbcbaab	FALSE
babddccdccdbddbccab	FALSE
bbabdddccdacbcacdbb	FALSE
bbacaaccdbadabbaadb	FALSE
bbdabadaaaddcdaacbb	FALSE
bbdacbdacdacbdbabbb	FALSE
bcbbcbdccccadcbcccb	FALSE
bcbbccddcbcbdabbddb	FALSE
bdaaabbcbcbdcccbcab	FALSE
bdaaabbdcacbddbaaab	FALSE
bdcbabacdccacacdacb	FALSE
bdcbabdcbbdbccaacbb	FALSE
caaddadbadacabdcadb	FALSE
caaddcacacaddbcdabb	FALSE
cadbddbdcababdcbcdb	FALSE
cadcaddaddbaacdcdcb	FALSE
cbcadacbcaaabccabab	FALSE
cbcadbadbdccadcbccb	FALSE
ccacacdaadcaabacddb	FALSE
ccacacdcaddbbacaccb	FALSE
ccdabccddadbacbbddb	FALSE
ccdabdcbabbcbbdbbab	FALSE
cdbccabcaabaaccdabb	FALSE
cdbccbabdabacbcbbab	FALSE
daaaccdaaccbcccbccb	FALSE
daaacdcdcabbaaadbdb	FALSE
dacdcabbccbbcbbadab	FALSE
dacdcadabdcdcddabbb	FALSE
dbbbcccbccccccbcbab	FALSE
dbbbdadbddbcbcdbaab	FALSE
dbddddaddaabccbbbdb	FALSE
dbddddbdcbacadcaacb	FALSE
dcccaaacbbbdbbbbadb	FALSE
dcccababbbdbabdadab	FALSE
ddbbbbddbdcdbdcdcbb	FALSE
ddbbbcbcabaaaadaaab	FALSE
