abababdada	TRUE
ababacbabb	TRUE
abbddcdbdc	TRUE
abbdddbcac	TRUE
abdcdbbcdc	TRUE
abdcdbcacd	TRUE
acbbdaccab	TRUE
acbbdadbcc	TRUE
acdaccbddd	TRUE
acdaccdcad	TRUE
adbababacc	TRUE
adbabaddba	TRUE
addabcbbbb	TRUE
addabdbbbc	TRUE
babdcdcbad	TRUE
babdcdcdac	TRUE
baddbacbbd	TRUE
baddbacdcd	TRUE
bbccbadacb	TRUE
bbccbadadc	TRUE
bcadcbdabd	TRUE
bcadccaccd	TRUE
bcdcaccccc	TRUE
bcdcadcccb	TRUE
bdbdcbdabb	TRUE
bdbdccabdb	TRUE
cabbbddcda	TRUE
cabbcadadd	TRUE
cadbdcccdb	TRUE
cadcabbbad	TRUE
cbbdddcadc	TRUE
cbbdddccbd	TRUE
ccaccccada	TRUE
ccaccdacab	TRUE
ccdbbdbaca	TRUE
ccdbbdddcc	TRUE
cdcaccabba	TRUE
cdcaccabdc	TRUE
dabbbdadac	TRUE
dabbcabadc	TRUE
dadabdbbbb	TRUE
dadacbbdad	TRUE
dbbbacdbba	TRUE
dbbbadbabc	TRUE
dbddcabbbb	TRUE
dbddcbdcdd	TRUE
dccbddabcd	TRUE
dccbddadad	TRUE
ddbacbcdbc	TRUE
ddbaccacdc	TRUE
aaaaabadab	FALSE
aaaaacabbb	FALSE
aacbcdcbbb	FALSE
aacbdaaddc	FALSE
abacdcbcaa	FALSE
abacddaadc	FALSE
abdbbdaacc	FALSE
abdbbddbaa	FALSE
acbccabbaa	FALSE
acbccacaab	FALSE
adaabaabac	FALSE
adaabcbbdb	FALSE
adcdbdbaac	FALSE
adcdcaccaa	FALSE
babacdbdaa	FALSE
babacddaab	FALSE
badcdbbbaa	FALSE
badcdbcbaa	FALSE
bbccbadaad	FALSE
bbccbadaad	FALSE
bcadbbdaad	FALSE
bcadbcacaa	FALSE
bcdcacccaa	FALSE
bcdcacdcaa	FALSE
bdbdcbdaab	FALSE
bdbdccaadb	FALSE
caabdcbcdc	FALSE
caabddddbd	FALSE
cadbadaada	FALSE
cadbbaacba	FALSE
cbbdddcaac	FALSE
cbbdddccaa	FALSE
ccacbcabaa	FALSE
ccacbcadaa	FALSE
ccdbbdbaaa	FALSE
ccdbbdddaa	FALSE
cdcabccaab	FALSE
cdcabccaad	FALSE
daabdbddad	FALSE
daabddbcaa	FALSE
dacccdbaad	FALSE
dacccdcbaa	FALSE
dbbbabbbaa	FALSE
dbbbacabaa	FALSE
dbddcaabbb	FALSE
dbddcbdcaa	FALSE
dccbddaacd	FALSE
dccbddadaa	FALSE
ddbabdadaa	FALSE
ddbabdbbaa	FALSE
abababaccdb	TRUE
ababaccbdbb	TRUE
abcabccccdb	TRUE
abcabdbadba	TRUE
abddcabddcd	TRUE
abddcadcdab	TRUE
acbdcacdbcb	TRUE
acbdcbabbad	TRUE
acddcacdcbb	TRUE
acddcadddac	TRUE
adbcdcbbbdb	TRUE
adbcdccdbda	TRUE
addcaddcbda	TRUE
addcbacbddb	TRUE
bacbcbcdcda	TRUE
bacbcbdadba	TRUE
bbabddcdabc	TRUE
bbacabcabcb	TRUE
bbcdaccbacb	TRUE
bbcdacdbdcb	TRUE
bcbadbdaccc	TRUE
bcbaddabaca	TRUE
bcddbbcdadd	TRUE
bcddbddcdab	TRUE
bdcbcbdddda	TRUE
bdcbccbcbbb	TRUE
cabbcacbdab	TRUE
cabbcadaddd	TRUE
cadbdcaddba	TRUE
cadbdcbacda	TRUE
cbbdabdadcb	TRUE
cbbdabdbcdd	TRUE
ccaccacbbab	TRUE
ccaccbdabca	TRUE
cccdbadbdca	TRUE
cccdbbadada	TRUE
cdbbddccbdb	TRUE
cdbbddcddbc	TRUE
dabacdcbdbb	TRUE
dabadacbdbd	TRUE
dadabcbbbdb	TRUE
dadabcbccac	TRUE
dbbcdababdd	TRUE
dbbcdacbbda	TRUE
dcabcbccbdb	TRUE
dcabccbbddc	TRUE
dccdcbcbbab	TRUE
dccdccdadba	TRUE
ddbbdccacba	TRUE
ddbbdcddaba	TRUE
aaaaaabcabd	FALSE
aaaaacbadcb	FALSE
aaccaacccda	FALSE
aaccabbcddc	FALSE
abbabcdbcaa	FALSE
abbacabdaab	FALSE
abddbbcdbaa	FALSE
abddbbddaac	FALSE
accbacadcaa	FALSE
accbadcdaad	FALSE
adacdcabdaa	FALSE
adacdcdadaa	FALSE
addbabdbaac	FALSE
addbacbddaa	FALSE
babdaadbdbd	FALSE
babdabbdcaa	FALSE
bbabbbbbaaa	FALSE
bbabbbbcaab	FALSE
bbcdaccbaab	FALSE
bbcdacdbdaa	FALSE
bcbaccbbbaa	FALSE
bcbadababaa	FALSE
bcddbbcdaad	FALSE
bcddbddcdaa	FALSE
bdcbcbdddaa	FALSE
bdcbccbcbaa	FALSE
caabdabdacc	FALSE
caabdacabdc	FALSE
cadbacaccaa	FALSE
cadbadbadaa	FALSE
cbbdabccaab	FALSE
cbbdabccbaa	FALSE
ccabddabbaa	FALSE
ccabddbacaa	FALSE
cccdbadbdaa	FALSE
cccdbbadaaa	FALSE
cdbbddccbaa	FALSE
cdbbddcddaa	FALSE
daababaddcb	FALSE
daababbbcbc	FALSE
dadaaacbdbc	FALSE
dadaabacbac	FALSE
dbbcdaaaadd	FALSE
dbbcdabbbaa	FALSE
dcaadddbdca	FALSE
dcabaadbccb	FALSE
dccdcbcbbaa	FALSE
dccdccdacaa	FALSE
ddbbdccacaa	FALSE
ddbbdcddaaa	FALSE
abababaccdbb	TRUE
ababaccbdbbb	TRUE
abcabdabccad	TRUE
abcabdccaccb	TRUE
abddcababadc	TRUE
abddcaccabbc	TRUE
acbcdacaccad	TRUE
acbcdacdadbb	TRUE
acddbdacbcbb	TRUE
acddbdadbadb	TRUE
adbcccdabcbd	TRUE
adbccdabbcbc	TRUE
addcccbcdadd	TRUE
addccccbdccb	TRUE
bacbbacbbabc	TRUE
bacbbadadadd	TRUE
bbacbdbabbcc	TRUE
bbacbdbcacdd	TRUE
bbcdbcdabdcb	TRUE
bbcdcabbabac	TRUE
bcbaccabbbdb	TRUE
bcbaccaccada	TRUE
bcdccbdbadbb	TRUE
bcdcdbabbbba	TRUE
bdbddcdcddac	TRUE
bdbdddadadca	TRUE
cabcacbbbdbc	TRUE
cabcadbadada	TRUE
cadcbdbdddba	TRUE
cadccacbbaba	TRUE
cbbddacbbabc	TRUE
cbbddadacddb	TRUE
ccacbbccdddb	TRUE
ccacbbddcacb	TRUE
ccdbacacbadd	TRUE
ccdbadabdacb	TRUE
cdbdbadabbda	TRUE
cdbdbbabcbad	TRUE
dababdbcccca	TRUE
dababdbddbab	TRUE
dadababdccbb	TRUE
dadabbbabdca	TRUE
dbbbacacadbc	TRUE
dbbbacbbdddc	TRUE
dcabcabbddbc	TRUE
dcabcbbdaddc	TRUE
dccddababadc	TRUE
dccddabcabca	TRUE
ddbbdbccbdab	TRUE
ddbbdcbacdba	TRUE
aaaaaaadccda	FALSE
aaaaabcdacdb	FALSE
aacbbaddacbb	FALSE
aacbbbcbcaaa	FALSE
abaccaccbdaa	FALSE
abaccadaaddc	FALSE
abdbdabadbaa	FALSE
abdbdacbddaa	FALSE
acbdcabdbdaa	FALSE
acbdcadccaac	FALSE
adabcacccaaa	FALSE
adabcbbddcaa	FALSE
adcdcbdbcdaa	FALSE
adcdccccddaa	FALSE
babcbacadbaa	FALSE
babcbbaabbcc	FALSE
baddcabdcaad	FALSE
baddcaddbaac	FALSE
bbccaabcbacd	FALSE
bbccaadbadcb	FALSE
bcaddccccbaa	FALSE
bcaddcddcdaa	FALSE
bcdadbbccaad	FALSE
bcdadcbcbcaa	FALSE
bdbccdabbdaa	FALSE
bdbccdbcbaad	FALSE
caabddbaadaa	FALSE
caabddbcadab	FALSE
cacdccadddaa	FALSE
cacdcdbacbaa	FALSE
cbbcbabcbbaa	FALSE
cbbcbabcdcaa	FALSE
ccababddabaa	FALSE
ccabadbcddaa	FALSE
cccddcadacaa	FALSE
cccdddccbbaa	FALSE
cdbbcdccccaa	FALSE
cdbbdaacbaaa	FALSE
daaaacdcdccc	FALSE
daaabbbbbcbb	FALSE
dadaacdacdbc	FALSE
dadabaacdbbb	FALSE
dbbcbaaccadd	FALSE
dbbcbaccccaa	FALSE
dcabadabcaab	FALSE
dcabadbdccaa	FALSE
dccdccdabaaa	FALSE
dccddaacaaab	FALSE
ddbbddaaadaa	FALSE
ddbcaababbbc	FALSE
abababadababa	TRUE
abababbabdaca	TRUE
abbcdcddbdabb	TRUE
abbcdddadddcd	TRUE
abdcaccbccccc	TRUE
abdcadddbacac	TRUE
acbbaccdcbada	TRUE
acbbacdabbbcc	TRUE
acdbcacdaddbb	TRUE
acdbcacdbbada	TRUE
adbadbbcbcddb	TRUE
adbadbdcbbcba	TRUE
addbbcdbddbdc	TRUE
addbbcddddddd	TRUE
bacabdacdaccc	TRUE
bacabdadbacda	TRUE
bbabacccbcbbb	TRUE
bbabadbbbbdac	TRUE
bbcbabdbddcbb	TRUE
bbcbadacccdab	TRUE
bcaddacddcdcd	TRUE
bcaddaddcdccd	TRUE
bcdcbccdccdcd	TRUE
bcdccabcbcaca	TRUE
bdcabbcdcabbc	TRUE
bdcabbddcadad	TRUE
cabbbdabbdddd	TRUE
cabbbdcbbdbbd	TRUE
cadcbdabbdaba	TRUE
cadcbdbbdbcbd	TRUE
cbbdcbacddbda	TRUE
cbbdccdcbbcda	TRUE
ccaccbbcadbdb	TRUE
ccaccbcccddba	TRUE
ccdacabcacdcb	TRUE
ccdacadaccadc	TRUE
cdbccddcbacca	TRUE
cdbcdbaccabbd	TRUE
dababdaddbdda	TRUE
dababdcbadacc	TRUE
dadacaccdbaba	TRUE
dadacacdcdcba	TRUE
dbbcbdbacccac	TRUE
dbbccabbdadbd	TRUE
dcabbcacdaddc	TRUE
dcabbcacdcdba	TRUE
dcccbdacbdabc	TRUE
dcccbdbcbdadc	TRUE
ddbcacbdbcbdc	TRUE
ddbcbabbaccdd	TRUE
aaaaaaadccdac	FALSE
aaaaabdacdbbb	FALSE
aacbbccdadbba	FALSE
aacbbdccbdbac	FALSE
abadcabbdcbaa	FALSE
abadcbcacadaa	FALSE
abdacdbccabaa	FALSE
abdadacbbcbaa	FALSE
accabdcdccaaa	FALSE
accabddaabcbb	FALSE
adacaccbdabaa	FALSE
adacbbdccadaa	FALSE
adcddbbcdcaac	FALSE
adcdddbbbbbaa	FALSE
babbddbbaaaab	FALSE
babcaabadbddb	FALSE
bbaaaddababcb	FALSE
bbaaadddcbddc	FALSE
bbcbaadbddcbb	FALSE
bbcbadacccdaa	FALSE
bcadcdcadddaa	FALSE
bcaddbadcdcaa	FALSE
bcdcbccdccdaa	FALSE
bcdccaacbcaba	FALSE
bdcaabcdcaabc	FALSE
bdcaabddcadad	FALSE
caacaabbdbdad	FALSE
caacaaddbbdcd	FALSE
cadbbdcccccaa	FALSE
cadbcabcbdaac	FALSE
cbbdcbacddbaa	FALSE
cbbdccdcbbcaa	FALSE
ccabcbbbdabaa	FALSE
ccabcdadbaabd	FALSE
ccdabdbbadaab	FALSE
ccdabdcaacacc	FALSE
cdbccddcbabaa	FALSE
cdbcdbaccaabd	FALSE
daaacaaccadcb	FALSE
daaacadcacdbc	FALSE
dacdaabccabcc	FALSE
dacdaacaddcac	FALSE
dbbcbdbacccaa	FALSE
dbbccaacbdacb	FALSE
dcaabdddcbcdc	FALSE
dcaacaaacdabd	FALSE
dcccbdacbdaac	FALSE
dcccbdbcbdaac	FALSE
ddbcacddbcbaa	FALSE
ddbcbaabaccdd	FALSE
ababababdbdbad	TRUE
abababadabcabb	TRUE
abbdbdbbddcbdb	TRUE
abbdbdcbbbdadd	TRUE
abdccdbbccabab	TRUE
abdccdcbccddcb	TRUE
acbbdadabacdad	TRUE
acbbdbacdadbba	TRUE
acdbbcbcbdddbd	TRUE
acdbbdccccdada	TRUE
adbcacabbdbbda	TRUE
adbcacbcbcdcad	TRUE
addcbddbbabadd	TRUE
addccbbababdda	TRUE
baccbddbadacca	TRUE
bacccadacabdca	TRUE
bbadacadcbbbab	TRUE
bbadaccabdbbab	TRUE
bbdacdbcccdbbd	TRUE
bbdadbabaddbbc	TRUE
bccaccabddbbcb	TRUE
bccacdccbdadad	TRUE
bdadaccbccadda	TRUE
bdadaddabddacc	TRUE
bddbaccddcbbdc	TRUE
bddbacdcadcbca	TRUE
cacadabbbbdadd	TRUE
cacadabbdabdcc	TRUE
cbababcdbdcccc	TRUE
cbabacbbdaddda	TRUE
cbccbacdacacab	TRUE
cbccbcacadbabb	TRUE
ccbbbdcaddacdb	TRUE
ccbbcacacbcbcb	TRUE
cdababacccbcdc	TRUE
cdababbaddcadd	TRUE
cdcbcbcdadcaca	TRUE
cdcbcdadabddbc	TRUE
dabdccabbbcdab	TRUE
dabdccbbbddbcd	TRUE
dadcccacbbcbbb	TRUE
dadcccccdcbada	TRUE
dbcabdccacaddd	TRUE
dbcacabbcccdbb	TRUE
dcacaddacabdac	TRUE
dcacaddcddbaba	TRUE
dccddacdcbbadc	TRUE
dccddaddbcbacd	TRUE
ddbbdbbaccdddd	TRUE
ddbbdcbacdccdd	TRUE
aaaaaabaccdcab	FALSE
aaaaabaabdacbb	FALSE
aacccdabdbdccc	FALSE
aaccdaabbcddcb	FALSE
abbacdbcaaccad	FALSE
abbadaaabbaada	FALSE
abddadbbadabaa	FALSE
abddadcacbaadc	FALSE
accbdcbdacccaa	FALSE
accbdddbcbdcaa	FALSE
adbaadccdddcdd	FALSE
adbababcbddcaa	FALSE
addcccdadbabaa	FALSE
addccdcccbdcaa	FALSE
bacabaaacaccca	FALSE
bacabaabbabdac	FALSE
bbacaabbdddabb	FALSE
bbacabbdbdcdaa	FALSE
bbcdcdaddbdbaa	FALSE
bbcdcdcaabdbac	FALSE
bcbbcbbcdbbdaa	FALSE
bcbbccaccbbbaa	FALSE
bcdcdcdaaaccca	FALSE
bcdcdcdbdcbbaa	FALSE
bdcabcaabdcada	FALSE
bdcabcadacbbaa	FALSE
caabbdcbcccdad	FALSE
caabbdddcdbbab	FALSE
cacddcdcacabaa	FALSE
cadaabaabdbccc	FALSE
cbbbddbaaccbad	FALSE
cbbcaaadadaacd	FALSE
ccaadabccaccbb	FALSE
ccaadacdccccdb	FALSE
cccdbaabbbcaad	FALSE
cccdcacbaadcab	FALSE
cdbccbcaaababa	FALSE
cdbccbdbbdabaa	FALSE
daabaccadcccaa	FALSE
daabbabaadcccb	FALSE
dacdcdabaadcbd	FALSE
dacdcdacdddcaa	FALSE
dbbbbcdccbcdaa	FALSE
dbbbcaccabaadc	FALSE
dcababbbdcdcaa	FALSE
dcabaccbbddaab	FALSE
dccdbbdcbdadaa	FALSE
dccdbccadbcdaa	FALSE
ddbcbabbabbaad	FALSE
ddbcbabcbbddaa	FALSE
abababbddbdacac	TRUE
ababacadddacadd	TRUE
abcabadcacaddcb	TRUE
abcabbbccbdbacc	TRUE
acabacdaddcadcc	TRUE
acabadabadcdabc	TRUE
accacbadbccbbca	TRUE
accaccbcbbcbdac	TRUE
acdddbdcbbbbcba	TRUE
acdddcabdbcbdad	TRUE
adcababacbdcccc	TRUE
adcababcbdccdcc	TRUE
addcdcaddbacabb	TRUE
addcdcbabcabcad	TRUE
bacccacdbbadbbd	TRUE
bacccbcdcdbabdd	TRUE
bbadadabdbabbac	TRUE
bbadadadbacbdda	TRUE
bbcdddccbadcadc	TRUE
bbdabacdbbaddbc	TRUE
bcbbacdcbdbadac	TRUE
bcbbbbddbccdcdd	TRUE
bcdbcbaccababac	TRUE
bcdbcccbdabbacb	TRUE
bdbddabcdcbadcb	TRUE
bdbddcababadcdb	TRUE
cabaddadcaddbab	TRUE
cabaddbdddbbdcc	TRUE
cadbabdcaddcaca	TRUE
cadbabdccbcbbbd	TRUE
cbcabadcbcbbbda	TRUE
cbcabbcbacacaba	TRUE
ccacbacdbadaccb	TRUE
ccacbbdacadcdda	TRUE
cccdcdcdbdabadc	TRUE
cccddadcddabcab	TRUE
cdbbdbadacadacd	TRUE
cdbbdbcddccaddd	TRUE
dabadadbaddcdac	TRUE
dabadbabbaccdda	TRUE
dadaccbdacdccda	TRUE
dadaccdbdaccdca	TRUE
dbbbdacadbdadac	TRUE
dbbbdadabdcbbab	TRUE
dcabadccddbbbba	TRUE
dcabbbddbcaddad	TRUE
dccdadabacaddac	TRUE
dccdadcabacdbba	TRUE
ddbcbbabbbabcda	TRUE
ddbcbbcbdbdbada	TRUE
aaaaaacbdadbaca	FALSE
aaaaababbccbadc	FALSE
aacccaaddbbdaaa	FALSE
aacccccadcabadd	FALSE
abbaaccdaccbcac	FALSE
abbaacddaabbadc	FALSE
abdccdbcddacdaa	FALSE
abdccdddbbabcaa	FALSE
accbbabcdcbdbaa	FALSE
accbbbddabaaddb	FALSE
adbabdbcccbbdaa	FALSE
adbabdcadccacaa	FALSE
baaaacabbdabcca	FALSE
baaaacdcccdadbb	FALSE
bacbbbdddababaa	FALSE
bacbbcbadacdcaa	FALSE
bbbaacaabcbdacc	FALSE
bbbaadcbabbddcb	FALSE
bbdddbcbabbadaa	FALSE
bbdddbcdacaddaa	FALSE
bccbddbabacbdaa	FALSE
bccbddcbdbcdaac	FALSE
bdbaddbcbbdcaab	FALSE
bdbaddbccabbcaa	FALSE
bddcddaccbbbaad	FALSE
bdddaaddcdcdbad	FALSE
cacbaddddddadaa	FALSE
cacbbabbdbddcaa	FALSE
cbaddabbbbbadaa	FALSE
cbaddadddaabadd	FALSE
cbdbaabdadadcdd	FALSE
cbdbabdaaaacbda	FALSE
ccbcbdadacddaac	FALSE
ccbccbabaabddbd	FALSE
cdaaccddccdaadd	FALSE
cdaacdcacbacddc	FALSE
cddaccacbcdccaa	FALSE
cddaccdccdacaab	FALSE
dabccaddbaadbdb	FALSE
dabccbbaabcadad	FALSE
dbaadcbcbcabcba	FALSE
dbaadccaaccacac	FALSE
dbccabdbaddcaab	FALSE
dbccacacdadddaa	FALSE
dcacbbadaccddaa	FALSE
dcacbbbbdbbcdaa	FALSE
dcdadbdcddbbbaa	FALSE
dcdaddbbbacbaad	FALSE
ddbcdcacccbcbaa	FALSE
ddbcdcbbcacdaaa	FALSE
ababababacdbbbbd	TRUE
ababacabadacbbcc	TRUE
abcaccbccccccaba	TRUE
abcacdabccadacbd	TRUE
abddcdbcdbcbcada	TRUE
abddcdcaccbcbbcc	TRUE
acbdbcbdbdabacca	TRUE
acbdbddaccbcbbba	TRUE
acddabdbabccdaba	TRUE
acddacbcdbbdbdcd	TRUE
adbcdccbcddcbabb	TRUE
adbdacccdcdbbbab	TRUE
bababaddcdcadbdb	TRUE
bababcaddbbdacac	TRUE
badabbccdadccdab	TRUE
badabbddcbbdacdb	TRUE
bbbbccdbdacbccdb	TRUE
bbbbdabacbdbaccb	TRUE
bcabababbababada	TRUE
bcababacabdadabc	TRUE
bcccbadabcabacab	TRUE
bcccbbbddcdbacba	TRUE
bdbacdccdabacbab	TRUE
bdbadbdbbbccaddb	TRUE
bdddacbcacddadac	TRUE
bdddaccbcdcbacab	TRUE
cacdacadcabbaccc	TRUE
cacdacbdbcddacba	TRUE
cbbadbabcababbbb	TRUE
cbbadbdcbcdbbbac	TRUE
cbdcddbbbbbccdbb	TRUE
cbdcddcadcabbcdb	TRUE
cccababdcbadcddb	TRUE
cccabacccccdcdcb	TRUE
cdadbcbabcabcaba	TRUE
cdadbddbacadddcb	TRUE
cddbcbbdbaddcbba	TRUE
cddbcdbbdcacacac	TRUE
dacbabcdcdcbbaca	TRUE
dacbadcbbdbabccd	TRUE
dbacbadcdccababd	TRUE
dbacbbcdabcdabcb	TRUE
dbccbdadbbcccbdb	TRUE
dbcccabdbababdda	TRUE
dcacddbcbbddbbdb	TRUE
dcacddbdccbabcdd	TRUE
dccddcacabccdacd	TRUE
dccdddbdabcbcdab	TRUE
ddbbadcdadacbdcd	TRUE
ddbbbabbcbabcdcd	TRUE
aaaaaaccddbcdabd	FALSE
aaaaaacddbbccbcb	FALSE
aacbcdbadadcadab	FALSE
aacbdbadabaaccda	FALSE
abadadaaccabdbdb	FALSE
abadadcacdaacdcb	FALSE
abdccbbccbbbaaaa	FALSE
abdcccbaadadacdc	FALSE
accaabaacbdcddca	FALSE
accaabdadcbbaccd	FALSE
adabdcbaadbdcabc	FALSE
adabdccadadddaac	FALSE
addaaabadaaccaac	FALSE
addaaadaaabdcbda	FALSE
babcbacabdabcaab	FALSE
babcbaccbabcdbaa	FALSE
bbabaabcbbcbdddc	FALSE
bbababcccdbcacaa	FALSE
bbdaaccacdaccaaa	FALSE
bbdaadaacdccddab	FALSE
bcbbbcabcdcccaab	FALSE
bcbbbddcabdabaab	FALSE
bdaaccbadcdcddad	FALSE
bdaacccbccbbbdba	FALSE
bdccabdbadabbcaa	FALSE
bdccadaaabbcdcca	FALSE
caaddacbccabdddb	FALSE
caaddbadccbbaacb	FALSE
cadcbbbacdcbdbaa	FALSE
cadcbcadabdbcaaa	FALSE
cbcabcadacaaacbb	FALSE
cbcabccdbbcacaad	FALSE
ccadbbacaddbdbaa	FALSE
ccadbbadbcbadcaa	FALSE
ccdcddaddabcaadb	FALSE
ccdcdddaccaacadd	FALSE
cdcaccadbdcabcaa	FALSE
cdcaccdbadddabaa	FALSE
daadbbacbdabcbca	FALSE
daadbbadcbdaacad	FALSE
dadbbacabcadbaab	FALSE
dadbbadadabdbbaa	FALSE
dbbcccbbddcaccaa	FALSE
dbbccdcadbcbddaa	FALSE
dcabdcbbadabadaa	FALSE
dcabdcdcaababada	FALSE
dccdcccaaacbbdca	FALSE
dccdcccabcadbaad	FALSE
ddbcbabdddcaabcc	FALSE
ddbcbacbbabdcdaa	FALSE
abababacdaddaddad	TRUE
abababacdddbbbdbd	TRUE
abbccbacbabbddbcb	TRUE
abbccbbacadacbddc	TRUE
abdcbdacdcaddabab	TRUE
abdcbdbbcccbddccc	TRUE
acbbbababcdddacad	TRUE
acbbbacbdcabcdabb	TRUE
acdbcadbdbbcdbdcc	TRUE
acdbcadcbddcadadd	TRUE
adbadadbbcbabdbbd	TRUE
adbadaddbdccaccda	TRUE
addbadcadccdbabbb	TRUE
addbbabbcdabcaddb	TRUE
bacaddabbabcbbdcd	TRUE
bacaddbcdabadcbcc	TRUE
bbaccbbbbdcdccddd	TRUE
bbacccabacbbbbdbc	TRUE
bbcdbcabdddcacbad	TRUE
bbcdbccddbdadcadb	TRUE
bcbbbcbdbaddcbbba	TRUE
bcbbbccbbbbabcdbd	TRUE
bdabcddabacacbdbd	TRUE
bdabcddcadbcacbba	TRUE
bdccdacdabdccbbdd	TRUE
bdccdbbabdcbbcaca	TRUE
cacabddbddadcadab	TRUE
cacacabbbaccdadda	TRUE
cbabcaccacacbadda	TRUE
cbabcadabbdbacdca	TRUE
cbcdcabcdbddcdcbd	TRUE
cbcdcaddacacccccb	TRUE
ccbbccdccacadbbca	TRUE
ccbbcdacbccadbabb	TRUE
ccdcdbddcbccdacab	TRUE
ccdcdccdcabcddcca	TRUE
cdcbadbcdbabdbcdd	TRUE
cdcbadbdbdcaddddc	TRUE
dabdbbccdbcdbadca	TRUE
dabdbcddabadbacba	TRUE
dadcdbcdababbcbdb	TRUE
daddabadcadcbbbab	TRUE
dbcacbbcacbdaccbb	TRUE
dbcacbcdcabbbbadb	TRUE
dcaccbaddbdbbdcca	TRUE
dcacccdabbcbdcabd	TRUE
dccdcbadadbbacccb	TRUE
dccdcbcbcbccabcad	TRUE
ddbcadacabbddbdac	TRUE
ddbcadaccbccabbda	TRUE
aaaaaaabbdaaaacdd	FALSE
aaaaaabcbaddcddbd	FALSE
aacbacdbbdbadbcbb	FALSE
aacbbabacbbdcdcad	FALSE
abaddbccaacbadabb	FALSE
abbaaaabcbbbbddbd	FALSE
abdbcbdcdabcabaad	FALSE
abdbccadbcdaccdaa	FALSE
accabdbdabdcdaaad	FALSE
accabdcbbbaccccaa	FALSE
adacaaddbcdcaabcc	FALSE
adacabacacaaacbbd	FALSE
adcdcabacbdcccaab	FALSE
adcdccaabacbbdbda	FALSE
babccccddcddbdcaa	FALSE
babcccdbbaaddcdda	FALSE
bbacaadcdddacdcdb	FALSE
bbacabbbdbccbccaa	FALSE
bbcdbcaadddcabbad	FALSE
bbcdbccddbdaccaab	FALSE
bcbbbcbdbacdcbbaa	FALSE
bcbbbccbbbbaacdbd	FALSE
bdabaabddddabcbdd	FALSE
bdabababcdddbdcaa	FALSE
bdccdacdabdccbbaa	FALSE
bdccdbbaadcbbcaba	FALSE
cabbabcabddbcdcaa	FALSE
cabbcaccdcbcabbaa	FALSE
cbaaddcdaddcdbada	FALSE
cbabaaadcdcdaacbd	FALSE
cbcdcaacdbddcdcbd	FALSE
cbcdcaddacabcccaa	FALSE
ccbbccdccabadbbaa	FALSE
ccbbcdacbccadbaab	FALSE
ccdcdbddcbccdacaa	FALSE
ccdcdccdcaacddcca	FALSE
cdcbaccbdcbcdbaad	FALSE
cdcbacdcdcabdcaad	FALSE
dabaabdccbbccbadd	FALSE
dabaadacbbdbdbdbc	FALSE
dadccccabcbdbcaab	FALSE
dadcdaaadbdccbbda	FALSE
dbcacaddccabbdaac	FALSE
dbcacbdbdcaabbbad	FALSE
dcacabccacddcadaa	FALSE
dcacabdadccacccaa	FALSE
dccdcbadacbbabcaa	FALSE
dccdcbcbcbccaacac	FALSE
ddbcaccaabaaabddb	FALSE
ddbcacccccbbccaab	FALSE
abababadadbcdcbcad	TRUE
abababddcdabdbccab	TRUE
abbdadccbcccbddbab	TRUE
abbdaddbadcaddbccc	TRUE
abdccdaccbbacbcdab	TRUE
abdccdbcdadbbccbab	TRUE
acbccacbbabacbddca	TRUE
acbccbbcdabcacddcd	TRUE
acdcadbcbcddbdbbba	TRUE
acdcbabaddbccbbcad	TRUE
adbbabacddcbdcabbb	TRUE
adbbabddcbcbcbddbc	TRUE
addbbddbbcbdaccaba	TRUE
addbcadadcbdbdbbcb	TRUE
baccaddcadbddbadda	TRUE
baccbadcdcadbadbdc	TRUE
bbadabdcdbdaccadcc	TRUE
bbadacbacabdadacad	TRUE
bbdbddacbccdadbcca	TRUE
bbdcacbbbadacabddd	TRUE
bcbddcdcdcadcbdbcc	TRUE
bcbdddbabbabcadabc	TRUE
bdacadacbabcdbcdba	TRUE
bdacadaccccdbccbcc	TRUE
bdcdcadbdbbcabdbad	TRUE
bdcdcadcababddcbdb	TRUE
cabdcaddabaddcbabd	TRUE
cabdcbacdbacabbcab	TRUE
caddabacdccacdddca	TRUE
caddacadbbbbcacdab	TRUE
cbcbbdddabdbdccdcb	TRUE
cbcbcbbcccadddaccc	TRUE
ccbaccdcbddaccacca	TRUE
ccbacdccddcdddacad	TRUE
ccdccdddccbccacbbb	TRUE
ccdcdacadccbbadcca	TRUE
cdcabcbbbcbacdbcad	TRUE
cdcabdacddbcdddbbb	TRUE
dabbaccbcbdadcaddc	TRUE
dabbaccddcdcadcdca	TRUE
dadbacdcbddacbbdad	TRUE
dadbadbbaccbacdcdd	TRUE
dbbcdadccdabddddba	TRUE
dbbcddadddbacbbaca	TRUE
dcabacdabdabddaddb	TRUE
dcabacdbadcbcacdbc	TRUE
dccdbbbccbcbbacddd	TRUE
dccdbccdbbbbccdbbd	TRUE
ddbcbdadbadacabbac	TRUE
ddbccbbcabcbcdadbd	TRUE
aaaaaaadadbcdddadd	FALSE
aaaaaaadbcbabbdbab	FALSE
aaccadcdbadcbbddba	FALSE
aaccbaaadacbdbcabd	FALSE
abbbabdddbdbddbdaa	FALSE
abbbadcaaacaccadab	FALSE
abddadcdcaddacbdaa	FALSE
abddaddccadcbdaaac	FALSE
acccadcaaabdbadbca	FALSE
acccaddacbdabddaac	FALSE
adbacaabcabcabaadb	FALSE
adbacbdccbabcdaada	FALSE
addbbabddbcbadadaa	FALSE
addbbbaacbabdcaacb	FALSE
babcbcbbabdbabddaa	FALSE
babcbddabbbddacbaa	FALSE
bbabadddbcaadaacdd	FALSE
bbabcaddcddbbcdcaa	FALSE
bbccddcddaadbbabda	FALSE
bbccdddbdbbcdadaaa	FALSE
bcbbaabcdaaabaacac	FALSE
bcbbaabdaabcccdbdd	FALSE
bcdccdaaadcbdadaad	FALSE
bcdcdccdccbccbadaa	FALSE
bdcbadaababcbcbdab	FALSE
bdcbadbbcadadcadaa	FALSE
caacccccbbacbadcbd	FALSE
caacccdaaadccddbcb	FALSE
cadbadccbcdbcbdcaa	FALSE
cadbbabdcbcacdacaa	FALSE
cbcaacaacdabcdacdb	FALSE
cbcaaccbbcddcbdccb	FALSE
ccacbcbcbaddcbdcaa	FALSE
ccacbdccaaaabdabdd	FALSE
cccdbabdcbabdbbdaa	FALSE
cccdbaddcaacadddcc	FALSE
cdbdcdbabacdaccbaa	FALSE
cdbddbbcaacccccdaa	FALSE
daabdbdcbabcadbbba	FALSE
daabdcacbaddbaadda	FALSE
dadabcabdcbbdccdaa	FALSE
dadabcacdbadcaacda	FALSE
dbbdaabdcdabcbadba	FALSE
dbbdaaccbddbbdbbdc	FALSE
dcacaadcacaacbccbd	FALSE
dcacaadcbbabbdccdd	FALSE
dccdddcabbcbddddaa	FALSE
dcdaaaaacddbabadda	FALSE
ddbcbbaadccaddcdbc	FALSE
ddbcbbbcddbbcbbbaa	FALSE
abababacabadacbdaca	TRUE
abababacadacbccadab	TRUE
abbdbdabbbacacbbbab	TRUE
abbdbdcadbddacabcbc	TRUE
abddbbdbcbdcbabbcbc	TRUE
abddbcbdbadbabbadac	TRUE
acbcabbcabadadbbccb	TRUE
acbcabdcacddbbbbbba	TRUE
acdcbbcdabbacdbbadd	TRUE
acdcbcccbcdacbbbbdd	TRUE
adbbccbacdacacadddc	TRUE
adbbdbbacbbdadacddd	TRUE
addbcbccdadaccddbbb	TRUE
addbcccbbbadcbbccbd	TRUE
bacbbaccbcbcdddadbb	TRUE
bacbbacdbacbdabbaca	TRUE
bbacabdadadbaccbdbb	TRUE
bbacaccdbbddacdbcad	TRUE
bbcdcabacacbddadaba	TRUE
bbcdcabadbdcbccdabb	TRUE
bcbccdbccbccddbcbdb	TRUE
bcbcdbbcaddacadadcb	TRUE
bcddbbddcddcacacadc	TRUE
bcddbbdddacccbadddb	TRUE
bdbddbcacabbbacacbc	TRUE
bdbddbdbccdbdbccadc	TRUE
cabbcadadaddabccaca	TRUE
cabbcadccccadcadacb	TRUE
cadbcdcdabcdcbbcdcd	TRUE
cadbcdcdbcbdbcdcddc	TRUE
cbbdadcbacadcdbbddc	TRUE
cbbdadddbbabaddcdab	TRUE
ccabacbbabcabcbddac	TRUE
ccabaccdccbccbdbbba	TRUE
ccccbabccacacbacaca	TRUE
ccccbbdcdabddcadabd	TRUE
cdbababbdcbacaddbdd	TRUE
cdbabbaddbcabdcacbc	TRUE
cddcacbbcacddbccbad	TRUE
cddcadabdbabbbbabba	TRUE
dacbdbdccdadbdbbada	TRUE
dacbddacdabcbcbbddc	TRUE
dbadacacbbaccabacba	TRUE
dbadadababbacacbadc	TRUE
dbdbdcddccabbdddbad	TRUE
dbdbddbbccbccccdcdc	TRUE
dccadadacbbbdadbabc	TRUE
dccadbccbdbadadbaba	TRUE
ddadcbcbccbcbadabcd	TRUE
ddadccadcacacdcbcba	TRUE
aaaaaacadadaadcdcad	FALSE
aaaaabaabbbcbcdcaad	FALSE
aaccacbbcadcacdbcdd	FALSE
aaccacbdcbcdbaababb	FALSE
abbbabbbadcbaadbccc	FALSE
abbbacdbbcddbbccbaa	FALSE
abdccddabbddddcadaa	FALSE
abdcdaaaddacdadcbba	FALSE
accababbddbacdbacaa	FALSE
accabaccbbdacdbbdaa	FALSE
adaccdaadbadbbbbaab	FALSE
adaccdbdabbbaadccba	FALSE
addabdacddbbbddadaa	FALSE
addabdbcbbccbddddaa	FALSE
babdcdadabacbdbddaa	FALSE
babddabacaadbcdbadb	FALSE
bbabbcdacaddbbacaab	FALSE
bbabbdaaaddbdacbabc	FALSE
bbcdcaaacacbddadaaa	FALSE
bbcdcaaadbdcbccdaab	FALSE
bcbccdbccbccddbcbaa	FALSE
bcbcdbbcaddabadadaa	FALSE
bcddbbddcddcacacaac	FALSE
bcddbbdddacccbaddaa	FALSE
bdbddbcabcabbacabaa	FALSE
bdbddbdbccdbdbccaac	FALSE
caabdbcdcdccdcbcabd	FALSE
caabdccdccaabccccca	FALSE
cadaadbaddbbcdcbbcd	FALSE
cadacacdcddccdccdaa	FALSE
cbbdadcbabaccdbbdaa	FALSE
cbbdadddbbaaaddcdaa	FALSE
ccaaaddabadbbadcdaa	FALSE
ccaaaddbabbabdabadc	FALSE
ccccbaaccacabbacaca	FALSE
ccccbbdcdaaddcadaad	FALSE
cdbaaacdbcabdcbacad	FALSE
cdbaabbbccaddbcaadc	FALSE
cddcacbbcabddbccbaa	FALSE
cddcadabdbaabbbaaba	FALSE
dabdddcccadcadbcaac	FALSE
dacaadadcabbdcbbdad	FALSE
dbacdddccaccdcbdcaa	FALSE
dbadaababacbadcbcab	FALSE
dbdbdcddccaabdddbad	FALSE
dbdbddbbccbccccdcaa	FALSE
dccacacdcabbbbdadaa	FALSE
dccacbbcdcbdbadadaa	FALSE
ddadcdbcbccbcbadaac	FALSE
ddaddacbcbabdbbdbaa	FALSE
