aaaaaaaacb	TRUE
aaaaaaacad	TRUE
aacbbccbad	TRUE
aacbbcccdc	TRUE
aadcdbdbdc	TRUE
aadcdddadd	TRUE
acbcadbdca	TRUE
acbcaddaaa	TRUE
acdaddbacb	TRUE
acdaddcbbb	TRUE
adbbaddccc	TRUE
adbbbacbbb	TRUE
addbbddbbd	TRUE
addbccacca	TRUE
bacbcadbba	TRUE
bacbcbaccd	TRUE
bbaccdbcbb	TRUE
bbacdaaada	TRUE
bbdaccccdb	TRUE
bbdadacaac	TRUE
bcbdadacad	TRUE
bcbdadbcba	TRUE
bdaccdccdb	TRUE
bdaccddccc	TRUE
bdcdccdcbb	TRUE
bdcdcdbbac	TRUE
caaddbccca	TRUE
caaddcddac	TRUE
caddbaacca	TRUE
caddbacbdd	TRUE
cbcadbbadd	TRUE
cbcadcbcbc	TRUE
ccaccbaddb	TRUE
ccacccdadd	TRUE
ccdcaddbaa	TRUE
ccdcaddbcb	TRUE
cdbdcbbbac	TRUE
cdbdcbcaaa	TRUE
daacccacdb	TRUE
daacccacdd	TRUE
dadcadbaaa	TRUE
dadcadbcdc	TRUE
dbbdcbcacd	TRUE
dbbdcbcdcb	TRUE
dcaadaaadb	TRUE
dcaadacaac	TRUE
dcdaaadccb	TRUE
dcdaaadccc	TRUE
ddbbccaaad	TRUE
ddbbcdaadb	TRUE
aaaaaadbab	FALSE
aaaaabacdb	FALSE
aaccabaaaa	FALSE
aaccacdcab	FALSE
abadcdccbb	FALSE
abadcddcbc	FALSE
abdbbaccbc	FALSE
abdbbbcaac	FALSE
acbddacaab	FALSE
acbddadaab	FALSE
adacbbbcab	FALSE
adacbcbcab	FALSE
addabdddcd	FALSE
addacacdab	FALSE
babddacacc	FALSE
babddadbcc	FALSE
bbacabdaba	FALSE
bbacaccbab	FALSE
bbdacdccab	FALSE
bbdacdcdab	FALSE
bcbdadacab	FALSE
bcbdadbcab	FALSE
bdacacbcab	FALSE
bdacaddaab	FALSE
bdcdccdcab	FALSE
bdcdcdbbab	FALSE
cabbcabdad	FALSE
cabbcadcbd	FALSE
cadcbbbaab	FALSE
cadcbbddab	FALSE
cbcadaadab	FALSE
cbcadabcbc	FALSE
ccacaaabda	FALSE
ccacaadcab	FALSE
ccdcadccab	FALSE
ccdcaddaab	FALSE
cdbdcbbbab	FALSE
cdbdcbcaab	FALSE
daadbadaab	FALSE
daadbbaabb	FALSE
dadbbaadab	FALSE
dadbbacbab	FALSE
dbbdcbcaab	FALSE
dbbdcbcdab	FALSE
dcaacdccab	FALSE
dcaadaacab	FALSE
dcdaabccdb	FALSE
dcdaabdbca	FALSE
ddbbccaaab	FALSE
ddbbcdaabb	FALSE
aaaaaaaacbb	TRUE
aaaaaaacadb	TRUE
aacbbccdacb	TRUE
aacbbdaaacd	TRUE
aadcddaccbb	TRUE
aadcddccbbd	TRUE
acbcdadbccc	TRUE
acbcdbaaacc	TRUE
acdbcdbbadd	TRUE
acdbcdbbbcd	TRUE
adbbbaaacbc	TRUE
adbbbaaacca	TRUE
addbdadcbad	TRUE
addbdaddaad	TRUE
bacbbbdcada	TRUE
bacbbccaccb	TRUE
bbacbccbcba	TRUE
bbacbcdaaca	TRUE
bbdaacddcdb	TRUE
bbdaadbdacc	TRUE
bcbcdbadbbd	TRUE
bcbcdbbadbb	TRUE
bdacbaaaccc	TRUE
bdacbaacccb	TRUE
bdcdcaadbba	TRUE
bdcdcbbaaaa	TRUE
cacaaccbdaa	TRUE
cacaacccdaa	TRUE
cbaaddaacad	TRUE
cbaaddadacd	TRUE
cbcdaccbbbc	TRUE
cbcdacdaacb	TRUE
ccbbcbaadda	TRUE
ccbbccbcaca	TRUE
cdaaacacddc	TRUE
cdaaacbbdbb	TRUE
cdcbcaadbca	TRUE
cdcbcbcaada	TRUE
daadaaccaac	TRUE
daadaadcbac	TRUE
dadccaccccc	TRUE
dadccbaaccd	TRUE
dbbdbcccdbc	TRUE
dbbddacddac	TRUE
dcacbcdccac	TRUE
dcacbdaadad	TRUE
dcdaaaaacdc	TRUE
dcdaaacdddc	TRUE
ddbcacbccbd	TRUE
ddbcaccacbc	TRUE
aaaaaaacbab	FALSE
aaaaabbccdc	FALSE
aacbdadccab	FALSE
aacbdcaacab	FALSE
abadbdcddbc	FALSE
abadbddcbbd	FALSE
abdcbabaabd	FALSE
abdcbbdccdb	FALSE
accacdcbbab	FALSE
accacdcbcab	FALSE
adadcddcaab	FALSE
adaddbbcdab	FALSE
addbbccbaba	FALSE
addbcbacabc	FALSE
babdcbbcbcd	FALSE
babdcdabbbd	FALSE
bbabbdbdbba	FALSE
bbabcaadaca	FALSE
bbcccbdbaab	FALSE
bbccdacabda	FALSE
bcbccacbdab	FALSE
bcbccbdabba	FALSE
bdaabdddddb	FALSE
bdaacacdbab	FALSE
bdccddbdbab	FALSE
bdcdaabcbbb	FALSE
caadcddbaab	FALSE
caaddbacdab	FALSE
cadbcabaddd	FALSE
cadbcabdcda	FALSE
cbcaadcabbd	FALSE
cbcabaabbda	FALSE
ccacacdbcab	FALSE
ccacadcacab	FALSE
ccdabdacbcc	FALSE
ccdacaaccab	FALSE
cdbdacdddab	FALSE
cdbdadcdaab	FALSE
daabbacaccd	FALSE
daabbaccdbc	FALSE
dacdacaaaab	FALSE
dacdadbabbc	FALSE
dbbbcbccabb	FALSE
dbbbdacdcab	FALSE
dbdcccbdbab	FALSE
dbdccdabaab	FALSE
dcccaabdcbd	FALSE
dcccaadbbab	FALSE
ddbbbabbccd	FALSE
ddbbbbcdcab	FALSE
aaaaaaaaacda	TRUE
aaaaaaaadddc	TRUE
aacbdadaaaaa	TRUE
aacbdaddcdcc	TRUE
aadccddaacba	TRUE
aadcdaaacaac	TRUE
acbcbbbbacca	TRUE
acbcbcacaccc	TRUE
acdcdadddcbd	TRUE
acddaaaccdac	TRUE
adbbdadbcdcb	TRUE
adbbdadcadda	TRUE
addbdbccddcd	TRUE
addbdcbbccdd	TRUE
bacbbddacacb	TRUE
bacbbdddbddc	TRUE
bbaadddbaaca	TRUE
bbacaacaacac	TRUE
bbcdbcadaaac	TRUE
bbcdbddbbbdd	TRUE
bcbbdcdcacdb	TRUE
bcbbddacadca	TRUE
bcddcacdaadc	TRUE
bcddcacdcddc	TRUE
bdccadadbdba	TRUE
bdccbcbbddbb	TRUE
caaddcdbbbdd	TRUE
caaddcddadcb	TRUE
caddaccccada	TRUE
caddadbadbca	TRUE
cbcaacdbccdc	TRUE
cbcaadaaacdc	TRUE
ccacaadbbbda	TRUE
ccacaadccbda	TRUE
ccdaadacaaad	TRUE
ccdaadbcccdc	TRUE
cdbccadbcddb	TRUE
cdbccbdbaccc	TRUE
daacbbcaaadd	TRUE
daacbbdbdbbc	TRUE
dadcaccbbbcc	TRUE
dadcacdbddba	TRUE
dbbdbbbdaddb	TRUE
dbbdbdadbcad	TRUE
dcaacdacacac	TRUE
dcaadaacdada	TRUE
dcccaadbcaca	TRUE
dcccacacbddd	TRUE
ddbaddbaddcd	TRUE
ddbbaaccacbc	TRUE
aaaaaaacbdab	FALSE
aaaaabccdcac	FALSE
aacbcbaadaab	FALSE
aacbccbcdbab	FALSE
abadcddbbcac	FALSE
abaddacaaccd	FALSE
abdbdabccdcb	FALSE
abdbdbdcaaab	FALSE
accadcdcadab	FALSE
accadcddbaab	FALSE
adadaabaabaa	FALSE
adadacbacdab	FALSE
addbaccddbab	FALSE
addbacdbaaab	FALSE
babdaaddbcaa	FALSE
babdabbacdcc	FALSE
bbababbbbbbc	FALSE
bbababbccbaa	FALSE
bbcdbcacaaab	FALSE
bbcdbddbbbab	FALSE
bcbbdcdcacab	FALSE
bcbbddabadca	FALSE
bcddcacacaab	FALSE
bcddcacdddab	FALSE
bdccadadbdab	FALSE
bdccbcbbddab	FALSE
cabbbddadaac	FALSE
cabbbddbdcab	FALSE
cadcbaddbcab	FALSE
cadcbccdccab	FALSE
cbcaababbccd	FALSE
cbcaacbdaaab	FALSE
ccabbdcdbdac	FALSE
ccabbdddbccd	FALSE
ccdaacddcdab	FALSE
ccdabaccbbbb	FALSE
cdbccadbcdab	FALSE
cdbccbdbacab	FALSE
daabcddadbcb	FALSE
daabddddcbcb	FALSE
dadbcdbacdab	FALSE
dadbcdbbccab	FALSE
dbbdbbbdadab	FALSE
dbbdbdadbcab	FALSE
dcaadbaabaca	FALSE
dcaadbbbdabd	FALSE
dcccaacccaab	FALSE
dcccabcdabbb	FALSE
ddbaddbacdab	FALSE
ddbbaabcacbc	FALSE
aaaaaaadacdcb	TRUE
aaaaaaaddbaac	TRUE
aacbcdacdcccd	TRUE
aacbcdaddbbcb	TRUE
aadcdbadccaac	TRUE
aadcdbbadcdba	TRUE
acbbbbdaaaddb	TRUE
acbbbdaaaaadb	TRUE
acdcbaccdcacc	TRUE
acdcbacdbbbda	TRUE
adbcccdbacadd	TRUE
adbcccdcbbbdc	TRUE
addbccacbdcad	TRUE
addbccbbdadcd	TRUE
bacbaccdbcbcc	TRUE
bacbaccddadbb	TRUE
bbacbbbbaddbc	TRUE
bbacbbbdcacba	TRUE
bbcdacacdcdcb	TRUE
bbcdacdbcdbcd	TRUE
bcadcccddaadc	TRUE
bcadcdadaddac	TRUE
bcdcacdaacbdc	TRUE
bcdcadbacccbc	TRUE
bdbdaaddbadda	TRUE
bdbdacadcccbd	TRUE
caaacdddadbcd	TRUE
caaadaaccccbb	TRUE
cadadbdbbdcbc	TRUE
cadadcbadbbdc	TRUE
cbbbbcddbbbbc	TRUE
cbbbbdbccaccc	TRUE
cbddcadbaacbd	TRUE
cbddcddbbacac	TRUE
ccccaaddadbac	TRUE
ccccacbbdbdca	TRUE
cdbbbdaccadaa	TRUE
cdbbcddacddba	TRUE
daaaadaacdbaa	TRUE
daaaadaddadba	TRUE
dacddcacaddbb	TRUE
dacddcdcadddb	TRUE
dbbadcadadcbd	TRUE
dbbadcadadcdb	TRUE
dbdddccaddacd	TRUE
dbdddcdcadbaa	TRUE
dccdbdcbaacdc	TRUE
dccdcadbbbbad	TRUE
ddbbdacbddaca	TRUE
ddbbdbacaadbc	TRUE
aaaaabbdabbbc	FALSE
aaaaacdbaccab	FALSE
aaccaadcaddab	FALSE
aaccabaadcabd	FALSE
abadbacabccbb	FALSE
abadbcbdccdcd	FALSE
abdbabcaacaab	FALSE
abdbacbddaaaa	FALSE
acbcabbcbcbcc	FALSE
acbcacaaaabac	FALSE
adabdbcbdbbda	FALSE
adabdcadddcda	FALSE
addacdcbaabcb	FALSE
addacddcacbab	FALSE
babdbddabddaa	FALSE
babdcaacabdcd	FALSE
bbabcadcbcbdd	FALSE
bbabcbcaadcba	FALSE
bbcdacabdcdcb	FALSE
bbcdacdbcdbab	FALSE
bcadbddbcddab	FALSE
bcadcbbccadab	FALSE
bcdcacaacbdab	FALSE
bcdcacdbbccab	FALSE
bdbdabbbaddaa	FALSE
bdbdabddcccbd	FALSE
caabadcbdbdcd	FALSE
caabaddaabbba	FALSE
cacdcddcdccab	FALSE
cacddacccadab	FALSE
cbbbbcddbbbab	FALSE
cbbbbdbccabcc	FALSE
cbddcadbabcbd	FALSE
cbddcddbbacab	FALSE
ccccaaddadbab	FALSE
ccccacbbdbdab	FALSE
cdbbbdabcacab	FALSE
cdbbcddabddba	FALSE
daaabcdadbccd	FALSE
daaabcdbdabda	FALSE
daccacaaddbab	FALSE
daccadaabacba	FALSE
dbbadcbbaabdd	FALSE
dbbaddadbccab	FALSE
dbdddccaddabd	FALSE
dbdddcdcadbab	FALSE
dccdbdcbaacab	FALSE
dccdcadbbbbab	FALSE
ddbbdacbddaba	FALSE
ddbbdbabaadbc	FALSE
aaaaaaadacdcba	TRUE
aaaaaaaddaaccb	TRUE
aacbbdbacbacbb	TRUE
aacbbddbcdacdc	TRUE
aadccdadcdcadd	TRUE
aadccddbddbdca	TRUE
acbbccbadbcbdd	TRUE
acbbcdacbdbacc	TRUE
acdbdcccdcdcbb	TRUE
acdbdcdacadadb	TRUE
adbbcaddaccaac	TRUE
adbbccacbcaaac	TRUE
addaddbbbbbdba	TRUE
addbaaaaccdaad	TRUE
bacbbaddbaaacc	TRUE
bacbbbbacbacbd	TRUE
bbaaadadaacacb	TRUE
bbaaaddcacddba	TRUE
bbcccdadcbbdaa	TRUE
bbcccddaccbbda	TRUE
bcadcdccdcdadd	TRUE
bcaddaaddcaccd	TRUE
bcdbadacbdbdca	TRUE
bcdbadaddcccdb	TRUE
bdcaaddaadcbdb	TRUE
bdcaaddaaddddb	TRUE
caaadbbcddbcbc	TRUE
caaadcacacbcdb	TRUE
cadbaccbcadcca	TRUE
cadbacdcdcdcac	TRUE
cbbcbcccdbcccc	TRUE
cbbccaaaccbbdd	TRUE
ccaacadcdaddcb	TRUE
ccaacbbccdcdbb	TRUE
ccccdccaccacca	TRUE
cccdacbaadadcd	TRUE
cdbbdbdddaaccd	TRUE
cdbbdcaddbcbbb	TRUE
daaaacccaaacac	TRUE
daaaacddbbcacd	TRUE
dadaccbaadaccc	TRUE
dadaccccbbaddd	TRUE
dbbcbdaadcadba	TRUE
dbbcbddacdaada	TRUE
dbdddcddbcbbac	TRUE
dbddddcadbdcaa	TRUE
dcccddbaccbdba	TRUE
dcccddbbdadddb	TRUE
ddbacbacaacacc	TRUE
ddbacbbdcdacdb	TRUE
aaaaaaaccbddab	FALSE
aaaaaaadddbcab	FALSE
aacccacbcddbab	FALSE
aacccacccdabbc	FALSE
abbababccbbbdb	FALSE
abbababdacadba	FALSE
abdcdadadbcccb	FALSE
abdcdbabdcabad	FALSE
accbbcddbbbaab	FALSE
accbbdbddbddab	FALSE
adaddbbaacccab	FALSE
adaddbcacbbcab	FALSE
addcbaaddaaaab	FALSE
addcbaddbcadab	FALSE
bacadbcdabbbca	FALSE
bacaddcbbaccab	FALSE
bbaddcdbdcacab	FALSE
bbbaaaaccbdcab	FALSE
bbdbccdbbcbdab	FALSE
bbdbdaccbdccab	FALSE
bccacddcbadcab	FALSE
bccadaccdccdab	FALSE
bdacbadaccddab	FALSE
bdacbbaaaacaab	FALSE
bdcdcdaabaddbb	FALSE
bdcdcdcccdadab	FALSE
cabbbbacbdadcc	FALSE
cabbbbddcacdda	FALSE
cadcbccdcdddab	FALSE
cadcbddcbbcaba	FALSE
cbcacdbaacbdab	FALSE
cbcadaacadcaba	FALSE
ccadbcaddbbcab	FALSE
ccadbcdbcbacab	FALSE
ccdbddccbdacab	FALSE
ccdcadaadbabca	FALSE
cdbddacdabbdcd	FALSE
cdbddbbcccbcab	FALSE
daacbdcdbdaabc	FALSE
daaccaadbbbbab	FALSE
dacdddadbacabd	FALSE
dacdddadcaabda	FALSE
dbbcaabdbcdabc	FALSE
dbbcabcadbbacd	FALSE
dcabdccacdbcac	FALSE
dcabddcbdadbbc	FALSE
dccdababbbddbb	FALSE
dccdacaacbcaab	FALSE
ddbbcabcaaccbd	FALSE
ddbbcbabaccccc	FALSE
aaaaaaaaacadcaa	TRUE
aaaaaaacacddbbd	TRUE
aacbdbadbbdcbbc	TRUE
aacbdbcbbbbacbd	TRUE
aaddcbdacadbbad	TRUE
aaddcbddadbdbbc	TRUE
acbcdbbdcdccbad	TRUE
acbcdbccdadadbb	TRUE
acdcdbadaadcaad	TRUE
acdcdbbccdddbaa	TRUE
adbcbdbadcacaca	TRUE
adbcbddcdacacac	TRUE
addccdddcaaacaa	TRUE
addcdacbcbadbcc	TRUE
baccbbcacdaacca	TRUE
bacccacccdcaadd	TRUE
bbadaaaaacdadbd	TRUE
bbadaacdbadacdd	TRUE
bbdadccbcccdaac	TRUE
bbdadcdbacbadbd	TRUE
bccaaacddcbddcc	TRUE
bccaadddbdadcdd	TRUE
bdaccacccbaaaad	TRUE
bdaccdbdaadcacc	TRUE
bddacdaaacbaddd	TRUE
bddacddcdacbbbd	TRUE
cacaaddcadaadda	TRUE
cacacaacbdddddd	TRUE
caddcbcbbcbaaad	TRUE
caddcbdcaadaadd	TRUE
cbccaadbadccddd	TRUE
cbccaccccaadbdc	TRUE
ccbacdccdcdcadc	TRUE
ccbadaccaadcbcb	TRUE
ccdcdbddbbbcdac	TRUE
ccdcdcacbacadba	TRUE
cdcaaddbcbcccda	TRUE
cdcacacdbddcdbc	TRUE
daaccccdbacbada	TRUE
daaccdbdccbddbd	TRUE
dadcdbbcdaccddb	TRUE
dadcdbdadcbdbaa	TRUE
dbbdcbbcdadddda	TRUE
dbbdccdddaccddd	TRUE
dcaadbbcdacdcda	TRUE
dcaaddddbbaccbd	TRUE
dcdaaacadcacbda	TRUE
dcdaaacdcdbcbda	TRUE
ddbcadacadcadcc	TRUE
ddbcbacbbbcaaad	TRUE
aaaaacbbdaacabb	FALSE
aaaaacbcbacbaab	FALSE
aacbdacdadbaaab	FALSE
aacbdadcadcdaba	FALSE
abbadaaccdaabba	FALSE
abbadaccaddbdbd	FALSE
abdcdbbacddcbcc	FALSE
abdcdcadbadcbcc	FALSE
accadadaaddcaab	FALSE
accadbbbcadbdab	FALSE
adaddaaabcdcdcb	FALSE
adaddacbcdbbdab	FALSE
addbdddbdaddabd	FALSE
addcabaddcdcdbc	FALSE
babdbccdcaacbbd	FALSE
babdbcdabbacbbb	FALSE
bbabcccdbcdddcc	FALSE
bbabdaaaccdabca	FALSE
bbcdacdcbcabacb	FALSE
bbcdbbcbadbcbab	FALSE
bcbadacbabcdabc	FALSE
bcbadadaccacaba	FALSE
bcdcabcdbacbcaa	FALSE
bcdcabdbbcbbbba	FALSE
bdcadccbcadadab	FALSE
bdcadccdbdadabb	FALSE
cabadccabdaaddb	FALSE
cabaddcadcadaca	FALSE
caddbdbdddabbdb	FALSE
caddbddabbacbda	FALSE
cbcabcdbbbaabcb	FALSE
cbcabddaadcaadd	FALSE
ccadbcadcbdbbab	FALSE
ccadccccbdcddab	FALSE
ccdbbacabbabbca	FALSE
ccdbbcccaabaacb	FALSE
cdbbdbabdacbcbd	FALSE
cdbbdbddadcacab	FALSE
daaacbbdccaaabd	FALSE
daaacbcbabbcddb	FALSE
daccdacaacbbaab	FALSE
daccdbbcddbccab	FALSE
dbbbababccbbadd	FALSE
dbbbabadaadbaba	FALSE
dbdcdccbdbbcdab	FALSE
dbdcdccccdaddab	FALSE
dccadccaaadbcab	FALSE
dccadcdbbbdacab	FALSE
ddbaaaacabbdadc	FALSE
ddbaabdabddaabd	FALSE
aaaaaaaaccbaadca	TRUE
aaaaaaaddacaaacc	TRUE
aacbccacdddbaaaa	TRUE
aacbccadaaccbbba	TRUE
aaddbaccddddcdac	TRUE
aaddbacdcaccbcac	TRUE
acbcddbdbdbbcdca	TRUE
acbcdddcbccddbaa	TRUE
acdcbcbdcdddbcaa	TRUE
acdcbdadbacdbdcb	TRUE
adbcbbdbcbdaaadd	TRUE
adbcbcdbbacbcdaa	TRUE
addcadacbcdbbccb	TRUE
addcbaadbbbacccc	TRUE
baccaadcadcbdacb	TRUE
baccacacacbdbbaa	TRUE
bbadcaacbdacdadb	TRUE
bbadcbbadbdbaadc	TRUE
bbdadaddddbcddca	TRUE
bbdadbcccdbbcbdb	TRUE
bcbbbdacaddacddc	TRUE
bcbbbdbacccbbdbb	TRUE
bcdddaacbcdddaac	TRUE
bdaaaaacacaacccd	TRUE
bdccacadadcdbbac	TRUE
bdccadbaccbcaddc	TRUE
caadbccbaacddccb	TRUE
caadbddcadbadcdd	TRUE
cadcaadcadacdcbc	TRUE
cadcaadccaddbbca	TRUE
cbbdbadadacdccdd	TRUE
cbbdbadcdcccbbda	TRUE
ccaadbaaaaccbdad	TRUE
ccaadcaaddbaccbb	TRUE
ccdaacaadaddaaad	TRUE
ccdaaccbbaadcdbd	TRUE
cdbccacdaadaacac	TRUE
cdbccadbdcadadcc	TRUE
daaaaddaccbbbdad	TRUE
daaacaadadcbccaa	TRUE
dacdcdaacbaaddbd	TRUE
dacdcdcbdcaadacd	TRUE
dbbacaddaaaccbba	TRUE
dbbacbdaadaadbba	TRUE
dcaaacccdaadcddb	TRUE
dcaaadaccacadcbc	TRUE
dccdbaaccdcbcbbd	TRUE
dccdbbadcaddaacb	TRUE
ddbbbbccddbbacba	TRUE
ddbbbddcacdbacda	TRUE
aaaaaabaacaaabcc	FALSE
aaaaaccbbadabdca	FALSE
aacbdabbbaadbbbc	FALSE
aacbddbbcbcabdba	FALSE
abbacbddcbabbbbd	FALSE
abbaccbdacbdaabb	FALSE
abdcccdccddccbaa	FALSE
abdcdcdcacccccbd	FALSE
accbacdacadcdabd	FALSE
accbadbadcacccab	FALSE
adacddbddddbbcab	FALSE
adacddcadbdcdcab	FALSE
addbbbadbcdbccab	FALSE
addbbcbbcaccbcab	FALSE
bacabbcddcccaacb	FALSE
bacabdcbacbbddcd	FALSE
bbaacadacccacbab	FALSE
bbaacbdbdcacadab	FALSE
bbcbcabbccbbbdcd	FALSE
bbcbcacbbabbcdab	FALSE
bcacabbbcdbcdbdd	FALSE
bcacabddbddaddcd	FALSE
bcdbdcbbdcdaadab	FALSE
bcdcaadacabcabcc	FALSE
bdcacabcbcaadddd	FALSE
bdcacaccbcbdccab	FALSE
caabbcacaacccddc	FALSE
caabcbabbbdadabc	FALSE
cadacaadbbbcbbab	FALSE
cadacababbddbcac	FALSE
cbbcdbbcdddaccab	FALSE
cbbcdbccaaacddab	FALSE
ccaadcdacabcdcbd	FALSE
ccaaddcadbbcbbab	FALSE
ccdabbcddbdddccb	FALSE
ccdabccccbbacaba	FALSE
cdbcabaabdbddbca	FALSE
cdbcabbbcbbbdcab	FALSE
cddddcdccbbdddab	FALSE
cdddddbdaabbadba	FALSE
dacdaabdcccbbaad	FALSE
dacdaacacdbaabca	FALSE
dbbcaabadabbbcad	FALSE
dbbcadaadcdbacab	FALSE
dcaadabdbddccabb	FALSE
dcaadcacbdcabbcb	FALSE
dcccdddbbbcbadab	FALSE
dcccdddbcbaabcbb	FALSE
ddbbaccbadbbcabd	FALSE
ddbbadabacbcdabc	FALSE
aaaaaaddbccaacadc	TRUE
aaaaacaaddbdcddcb	TRUE
aacbcbbaaccbddcac	TRUE
aacbcbbcaaaadadac	TRUE
acaacaadaaddddcaa	TRUE
acaacacddcbcccadb	TRUE
acbddcacadbbdbada	TRUE
acbddcbdbbbaacbdc	TRUE
adaaacaadadacbddd	TRUE
adaaacaaddacbaada	TRUE
adbcddcbacbbacddd	TRUE
adbdaadbbacbccbcc	TRUE
addcdaadddcbbcbad	TRUE
addcdaaddddbbdbaa	TRUE
baccccbcaacacacaa	TRUE
baccccbcdaacdbddc	TRUE
bbaccdcaaddcacbaa	TRUE
bbacdbcadadcdbdcc	TRUE
bbdbbccbcdadcadcb	TRUE
bbdbbdaacbcaaaaad	TRUE
bcbdcdaddbcacbacc	TRUE
bcbddacbbadcacacd	TRUE
bdaccbbbddbbacdbb	TRUE
bdaccbcccaadcdadb	TRUE
bddacaddaddbadcbd	TRUE
bddacadddddccadcc	TRUE
cacaddbdbccbacacd	TRUE
cacbaadbbaacaaccd	TRUE
cbaaaddddddaacddd	TRUE
cbaacaaacccbacddb	TRUE
cbccacadcddaacdac	TRUE
cbccacdbcdcbaaaca	TRUE
ccbadadadacbacada	TRUE
ccbadbbbddcaddada	TRUE
ccdcbbacdcbbbcbbc	TRUE
ccdcbcdadadacdcdd	TRUE
cdbddbddcdbdaccbd	TRUE
cdbddccacdadaacaa	TRUE
daaccacddacaaaacc	TRUE
daaccbadadaaaaadb	TRUE
dadbcadbcbccbadda	TRUE
dadbcbbbadccbaaac	TRUE
dbbbbdbcdddddbbbb	TRUE
dbbbbdcdbcdbbdcdd	TRUE
dcaaaadcbacacddcd	TRUE
dcaaacadbdbbdbcaa	TRUE
dccdaaddcdcdbcddc	TRUE
dccdadccdcddbadad	TRUE
ddbcaacbdaaacbbad	TRUE
ddbcacbcbbdddbcdd	TRUE
aaaaaacccccbbadab	FALSE
aaaaabdbcbbdacadc	FALSE
aaccbccdcddbcbaab	FALSE
aaccbcdbdcbcbdabb	FALSE
abbbdacadcbbbbbaa	FALSE
abbbdbadbdbabcdab	FALSE
acababddddabbcaca	FALSE
acabaccacccdaacaa	FALSE
accdaddddccdcbbab	FALSE
accdbabaabababdad	FALSE
adbbccbcdbcaccaab	FALSE
adbbcccbacddaabdc	FALSE
addcdaddbdcdcdbab	FALSE
addcdbabbdbaacbdb	FALSE
bacadbccaabaccbaa	FALSE
bacadbdaccddacaab	FALSE
bbacbcbdbcbcbbcab	FALSE
bbacbccdbdccbbdab	FALSE
bbdbbccbcdaccadab	FALSE
bbdbbdabcbcaaaaad	FALSE
bcbdcdaddbcacbabc	FALSE
bcbddacbbaccacabd	FALSE
bdabcacdcaadbabbd	FALSE
bdabccbcdbacdacca	FALSE
bddabddacaddccabc	FALSE
bddabdddccbbcdbdd	FALSE
cabcbccdadccbbbcb	FALSE
cabcbccddabbabbab	FALSE
cbaaccabdaddabcdd	FALSE
cbaacccacbcacbcab	FALSE
cbccabcccaddaabda	FALSE
cbccacdbcdcbaabca	FALSE
ccbadaadabbabacad	FALSE
ccbadacbddcaddaba	FALSE
ccdcbbacdcbbbcbab	FALSE
ccdcbcdadadacdcab	FALSE
cdbddbddcdbdabcbd	FALSE
cdbddccacdadaabab	FALSE
daacdadcccdacdbab	FALSE
daacdbbdbadaaabdd	FALSE
dadabcabdbdddbcbc	FALSE
dadabdcbbddcbbacc	FALSE
dbbbbdbcdddddbbab	FALSE
dbbbbdcdbcdbbdcab	FALSE
dcaaaabdbbbbbddbb	FALSE
dcaaabaddbaabacab	FALSE
dccdabbdcdcdbcddc	FALSE
dccdadccdcddbadab	FALSE
ddbcaabbdaaacbbac	FALSE
ddbcabbdcbbdddbcd	FALSE
aaaaaadaacadbcdcca	TRUE
aaaaaadbccbdcacbaa	TRUE
aacaddbaaadbbcddcd	TRUE
aacaddbbdccdacbdcc	TRUE
aadcbbadbbdccbbddd	TRUE
aadcbbcbcdacdccacc	TRUE
acbbbcacdcbcdadbdd	TRUE
acbbbcbccdcdaaddbd	TRUE
acdbbbbcaccdbadaaa	TRUE
acdbbcacacacbbbdda	TRUE
adbbbbdcaaddbadbad	TRUE
adbbbcdaaadadbaddc	TRUE
addbcdcddbbdbddaac	TRUE
addbdaacccbdbccbac	TRUE
bacbcdbacbaaaccbcb	TRUE
bacbdbcbbdaadcbcac	TRUE
bbacaaadddbddccbca	TRUE
bbacaadadacadcbdba	TRUE
bbcdcbcddaccdaacac	TRUE
bbcdccdcddadcadcbc	TRUE
bcbcacacaadcadbbda	TRUE
bcbcacadbbbdacaddc	TRUE
bdaaaaaaddbaaaddcb	TRUE
bdaaaacadaacdacbca	TRUE
bdcdbbcaadbbdcccdc	TRUE
bdcdbbdbbbbacaddcb	TRUE
caaddcdbbbaacddcda	TRUE
caaddcdbddbacdaadd	TRUE
cbaaaadbadbbcbcada	TRUE
cbaaacccbcacdbacbc	TRUE
cbcbcdddcbccdbcbad	TRUE
cbcbdacadadbbbdadc	TRUE
ccadbadccdddaddcdb	TRUE
ccadbbaddacdbdacaa	TRUE
ccdadcbccdbbbbcdad	TRUE
ccdaddadbcdddaacbb	TRUE
cdbcacccbddadaadbd	TRUE
cdbcacdcdbbcdbbccc	TRUE
daaacaaaadbcbacbac	TRUE
daaacacacdbbaccbaa	TRUE
dacdbbbbbcdcbcbbcb	TRUE
dacdbbdbcdadaacbac	TRUE
dbbbbcdcacaadccbaa	TRUE
dbbbbdcadbacbccdcc	TRUE
dbddcdbdadadacbbbb	TRUE
dbdddacadaaaacaacb	TRUE
dcccdcaccdbdadcdad	TRUE
dccdaaaacdbdcaacba	TRUE
ddbadccdbdddbaacbd	TRUE
ddbadcdcadcadcaaad	TRUE
aaaaabddacababdabd	FALSE
aaaaacbbdababcdbdd	FALSE
aacbcddabbbbcccbad	FALSE
aacbdaacacacacaaab	FALSE
abaccbbdaccddadbdd	FALSE
abaccbdabbcbaaaadc	FALSE
abdbbacdaaaadabdad	FALSE
abdbbbdababaaaaccc	FALSE
acbdadabdbdcbacabb	FALSE
acbdadbbacbcabbcab	FALSE
adabdadddabdbcdbac	FALSE
adabdbabbadcddccbb	FALSE
addacadbddabbcaaca	FALSE
addacbacbdbccbacab	FALSE
babdccaabccddcddac	FALSE
babddababaccccabdb	FALSE
bbabbcccabaadbbcdc	FALSE
bbabbdababbdcaaabb	FALSE
bbcdcbcddabcdaacab	FALSE
bbcdccdcddaccadcab	FALSE
bcbcabbabcaadcadbb	FALSE
bcbcabcabbbbdabadd	FALSE
bdaaaaccbabdacbbcb	FALSE
bdaaacacabbcdddbda	FALSE
bdcdbbcaadbbdcccab	FALSE
bdcdbbdbbbbacaddab	FALSE
cabbccdddabcacaddc	FALSE
cabbcdabdbccaaadbc	FALSE
cbaaaddaaaddbcdbab	FALSE
cbaabbbacacdcdcbca	FALSE
cbcbcdddcbccdbcbab	FALSE
cbcbdacacadbbbdabc	FALSE
ccadacbadddacdcdab	FALSE
ccadacbdccdacdbdab	FALSE
ccdadcbccdbbbbcdab	FALSE
ccdaddadbcdddaacab	FALSE
cdbcacccbddadaadab	FALSE
cdbcacdcdbbcdbbcab	FALSE
daaacadcaadbdcbcab	FALSE
daaaccacdcacabbbcc	FALSE
dacbcbdcbdcdcaccab	FALSE
dacbdabaabadbbcacd	FALSE
dbbbbcdcababdccbab	FALSE
dbbbbdcadbabbccdcc	FALSE
dbddcdbdadadabbbbb	FALSE
dbdddacadaaaacaaab	FALSE
dcccdcaccdbdadcdab	FALSE
dccdaabaaaacdbdcab	FALSE
ddbadccddbdddbaabb	FALSE
ddbadddcadcadcaaab	FALSE
aaaaaaaacacdbcbaaac	TRUE
aaaaaaaadbacdccdbba	TRUE
aaccacbddcddaadcdbb	TRUE
aaccacdadaacbbdadcc	TRUE
aaddbcacaadddbcbbaa	TRUE
aaddbcbadaaaaccbcaa	TRUE
acbcdaadbaddccadbdb	TRUE
acbcdacacbcccaadcac	TRUE
acdcaddbacbcdcddbda	TRUE
acdcbaaacccddcbdbac	TRUE
adbbccaaccadbbaaddc	TRUE
adbbcddcadbacdcaaac	TRUE
addbbcadbdcaddbcdac	TRUE
addbbdcccbaaaccacca	TRUE
bacbcdbcbaccaacbcca	TRUE
bacbdaaaacaccccacba	TRUE
bbacbdbacaaddaacdbb	TRUE
bbacbdbcdbcadbddacc	TRUE
bbdaaacdbbdbdacdccc	TRUE
bbdaaaddcdaadbdbbdd	TRUE
bcbcdadcadcccaaacdd	TRUE
bcbcdcadcbbdbbbcbcc	TRUE
bdaaaadbbcddcbccccb	TRUE
bdaaaaddcaacdaaacdd	TRUE
bdccacdbaacddcbdbdb	TRUE
bdccadcacdbdaaddccd	TRUE
caadbcdbdbacbcacccd	TRUE
caadbcdbdbbccdcbadb	TRUE
cadcdbbdcccbcdcbada	TRUE
cadcdccdcbaadbcaadd	TRUE
cbcbcadddacadbbdccc	TRUE
cbcbcbdddbcbddbcdcd	TRUE
ccacdbadbacdbdddcda	TRUE
ccacdbccadcbdaccccb	TRUE
ccdbcaacbbcaadbaddd	TRUE
ccdbcaddcdddbcaccbd	TRUE
cdbddddacaadadcdbaa	TRUE
cdcaaaacaacccbacbbd	TRUE
daacccaadaadbcbcdbd	TRUE
daacccaadccbaaccacd	TRUE
dadbcdaadacacdbadaa	TRUE
dadbcdacacbadacaada	TRUE
dbbdaadcbaaadbbaccd	TRUE
dbbdacdaaadbacacadb	TRUE
dcaaaddaccacdbaacca	TRUE
dcaacacddcaaadcddbc	TRUE
dccccddadccbdaacacd	TRUE
dcccdaccbccbdbbbbad	TRUE
ddbbdbcadbccadcbcdd	TRUE
ddbbdbdaccbbdaaadba	TRUE
aaaaacbaadcdabacbcb	FALSE
aaaaadbcacddabdabcb	FALSE
aaccadaadadacacaaab	FALSE
aaccbcadccbbdacddab	FALSE
abadbacababdadabdaa	FALSE
abadbbbaabababddcdd	FALSE
abdcaabadbbbdbdaaad	FALSE
abdcaabbbbacbcbcdbb	FALSE
accacbdbadcdbcaabdb	FALSE
accacccddcacccbbbab	FALSE
adadcbcdaaddacbbcab	FALSE
adadcbdcdddddbdccab	FALSE
addccaacbcbcbcadcab	FALSE
addccabccadbbdaacac	FALSE
babdddbddcadbddbacb	FALSE
bacabaadcdaaabadacc	FALSE
bbabdababcdbadbcbac	FALSE
bbabdabbccbbcdbbaab	FALSE
bbdacacdbbbcbbccdab	FALSE
bbdacddbbddacbbcaab	FALSE
bcbdbabbcddabdaaadd	FALSE
bcbdbadabdbabddaaad	FALSE
bdabbabaccdddaadcaa	FALSE
bdabbacdcdccdcccccb	FALSE
bdcdbddddcbaadccdab	FALSE
bdcdcabdcdcabdccddc	FALSE
cabbacbcddaccdabddd	FALSE
cabbbacbcabdcadbcba	FALSE
cbaaaabdcbcdaadcbda	FALSE
cbaaabadabaaccbbbdb	FALSE
cbcbcbbdbbbadcbacab	FALSE
cbcbcdadcdbbadcadab	FALSE
ccbabaaacbbbacadcca	FALSE
ccbababdcdbccabcccc	FALSE
ccdcbaabbacddbdacda	FALSE
ccdcbacabccdaadcacc	FALSE
cdccabbccccdcabdbdc	FALSE
cdccabdbbadbcbdbadd	FALSE
dabaabcddacbbbcabcd	FALSE
dabaacaddddcacbdbaa	FALSE
dadbdcbabcacbcdabbd	FALSE
dadbdcdcdbdccccbaab	FALSE
dbcabdbdbcddcbddabc	FALSE
dbcacadaabadcdbbbbc	FALSE
dcacabaaddbadbabcdb	FALSE
dcacabaddadcacabdbb	FALSE
dcdabaaacbbabdbbbaa	FALSE
dcdabbbbaaadccccdad	FALSE
ddbcabbcdcdbcaccadc	FALSE
ddbcadcccdacdaaddab	FALSE
