adadadadad	TRUE
adadadadad	TRUE
adadccbcbc	TRUE
adadccbcbc	TRUE
adbcbcadca	TRUE
adbcbcadcb	TRUE
adbcdbcddc	TRUE
adbcdcadad	TRUE
adccbcadcd	TRUE
adccbcbcbc	TRUE
addaddbcbc	TRUE
addaddbcbc	TRUE
adddbcddad	TRUE
adddcadadc	TRUE
bcadcadbca	TRUE
bcadcadbcb	TRUE
bcbcadcadb	TRUE
bcbcadcadb	TRUE
bcbcdbcbcd	TRUE
bcbcdbccad	TRUE
bcccadbcad	TRUE
bcccadbcad	TRUE
bcdadccbca	TRUE
bcdadccdcd	TRUE
bcdcdcccad	TRUE
bcdcdcccda	TRUE
cadbcbcbcd	TRUE
cadbcbcbcd	TRUE
cadddccdad	TRUE
caddddcbcb	TRUE
cbcccadcbc	TRUE
cbcccaddad	TRUE
ccbcbcadcb	TRUE
ccbcbcadda	TRUE
cdadadadcb	TRUE
cdadadadcb	TRUE
cdccbccdcc	TRUE
cdccbccdcd	TRUE
dadaddddcc	TRUE
dadbcadada	TRUE
daddcadcad	TRUE
daddcbcadd	TRUE
dbccaddbcb	TRUE
dbccaddbcc	TRUE
dcadccbcbc	TRUE
dcadcccbcd	TRUE
dcdadccdbc	TRUE
dcdadcdadd	TRUE
ddbccdddbc	TRUE
ddbcdadadc	TRUE
aaaaaabdaa	FALSE
aaaaaadaad	FALSE
aacccdbcaa	FALSE
aaccdcbbcd	FALSE
abbbabcdcc	FALSE
abbbacdbdb	FALSE
acaaabdadc	FALSE
acaaaccbab	FALSE
accbdcabca	FALSE
accbdcddbb	FALSE
adbabadccc	FALSE
adbabbabac	FALSE
addcbcddba	FALSE
addcbddddc	FALSE
bacadbdbba	FALSE
bacadddabd	FALSE
bbadabccbb	FALSE
bbadacbcbb	FALSE
bbdbaabcdb	FALSE
bbdbababca	FALSE
bcbdaacdcb	FALSE
bcbdabdddb	FALSE
bdabbbacbb	FALSE
bdabbbadba	FALSE
bdcdbadbcb	FALSE
bdcdbbabab	FALSE
cabccbabac	FALSE
cabccbacbb	FALSE
caddcdbdda	FALSE
caddcdcdbd	FALSE
cbccccadac	FALSE
cbcccdadba	FALSE
ccbbadbbaa	FALSE
ccbbbabaab	FALSE
cdaaabdbdc	FALSE
cdaaaccddb	FALSE
cdccbcdbbc	FALSE
cdccbdcdcc	FALSE
daaddcddbb	FALSE
dabaabbccd	FALSE
dadccbaaac	FALSE
dadccdbaca	FALSE
dbcacbcabd	FALSE
dbcacbdcab	FALSE
dcaccaaabc	FALSE
dcaccadaac	FALSE
dcdaccdddd	FALSE
dcdacdaccb	FALSE
ddbcabcaad	FALSE
ddbcbaacad	FALSE
adadadadada	TRUE
adadadadada	TRUE
adadccadcad	TRUE
adadccadcad	TRUE
adbcadcdcca	TRUE
adbcadcddbc	TRUE
adbcdccadbc	TRUE
adbcdcccadb	TRUE
adccbcadcad	TRUE
adccbcaddad	TRUE
addaddbcdad	TRUE
addaddbcdbc	TRUE
adddcbcbcbc	TRUE
adddcbcbcca	TRUE
bcadcadbcda	TRUE
bcadcadbcdd	TRUE
bcbcaddcbcc	TRUE
bcbcaddccbc	TRUE
bcbcdadcada	TRUE
bcbcdadcadd	TRUE
bccbccbcbcd	TRUE
bccbccbccbc	TRUE
bcdadadbcdd	TRUE
bcdadadcadc	TRUE
bcdcdbccadb	TRUE
bcdcdbccbcb	TRUE
cadbccadbcd	TRUE
cadbccaddca	TRUE
cadddcbcdad	TRUE
caddddbcccd	TRUE
cbccbcdbcdd	TRUE
cbcccadadbc	TRUE
ccaddadbcbc	TRUE
ccaddbcadad	TRUE
ccdbccddcbc	TRUE
ccdbcddbcad	TRUE
cdcbcbccdad	TRUE
cdcbcbcdcad	TRUE
dadbcadadca	TRUE
dadbcadaddc	TRUE
daddcbcadbc	TRUE
daddcbccdbc	TRUE
dbcbcddadbc	TRUE
dbcbcddadbc	TRUE
dcadbcbcadc	TRUE
dcadbcbcbca	TRUE
dccdadddbcc	TRUE
dccdbcadbcc	TRUE
ddbcbcbcada	TRUE
ddbcbcbcada	TRUE
aaaaabababb	FALSE
aaaaabadcdd	FALSE
aacbaddbdbc	FALSE
aacbbacabac	FALSE
abacbcdbacc	FALSE
abaccacaabd	FALSE
abdaadcadbb	FALSE
abdababaadc	FALSE
acbbddddddb	FALSE
acbcabccaca	FALSE
adaaaabbbbb	FALSE
adaaabbbaca	FALSE
adcdadbcbab	FALSE
adcdbacbbda	FALSE
bababddcdab	FALSE
babacaaaaba	FALSE
badcbacbbbd	FALSE
badcbbacada	FALSE
bbcadababda	FALSE
bbcadbbbbbb	FALSE
bcadbcabcaa	FALSE
bcadbccaadb	FALSE
bcdcbaaadda	FALSE
bcdcbadacdd	FALSE
bdcabadbbca	FALSE
bdcabbadcbd	FALSE
cababbdabab	FALSE
cababcbadbd	FALSE
cadccbccdac	FALSE
cadccdbbddb	FALSE
cbcbccabdcb	FALSE
cbcbdabbadc	FALSE
ccadadacdbb	FALSE
ccadbacbcac	FALSE
ccdccacadad	FALSE
ccdccadabbd	FALSE
cdcabcaaaaa	FALSE
cdcabcadcbd	FALSE
daacadccacb	FALSE
daacbbccabc	FALSE
dadadbbbdac	FALSE
dadadcdaaab	FALSE
dbbccbdbdac	FALSE
dbbcccaabda	FALSE
dcabbbaaaba	FALSE
dcabbcddaba	FALSE
dccdccdaacc	FALSE
dccdccdadbd	FALSE
ddbcbbdaacb	FALSE
ddbcbdbaadc	FALSE
adadadadadad	TRUE
adadadadadad	TRUE
adadccadbcad	TRUE
adadccadbcdc	TRUE
adbcbcadbcad	TRUE
adbcbcadbcca	TRUE
adbcdddadbcb	TRUE
adbcdddbcbca	TRUE
adccbccdadca	TRUE
adccbccdccbc	TRUE
addadcbccadb	TRUE
addadcbcdadc	TRUE
addcddadbccd	TRUE
addcddbcadad	TRUE
bcadbcbcddbc	TRUE
bcadbccbcbcc	TRUE
bcadddddddbc	TRUE
bcbcadadadad	TRUE
bcbccdccadbc	TRUE
bcbccdccdbcb	TRUE
bccbcbcbcdbc	TRUE
bccbcbccbcbc	TRUE
bccddccbcddd	TRUE
bccddcdadbcb	TRUE
bcdccbccaddb	TRUE
bcdccbccbcca	TRUE
cadbcadcbcca	TRUE
cadbcadcbcdd	TRUE
caddcadcbccc	TRUE
caddcaddadcb	TRUE
cbcbcddaddad	TRUE
cbcbcddaddbc	TRUE
ccadcbcdbcda	TRUE
ccadccbcadad	TRUE
ccdbcaddbcda	TRUE
ccdbcbcbccad	TRUE
cdcadadbcccd	TRUE
cdcadadccbcd	TRUE
dadadbcdccad	TRUE
dadadbcddcad	TRUE
daddadcdadbc	TRUE
daddaddadbca	TRUE
dbcbcdadbcad	TRUE
dbcbcdadbcbc	TRUE
dcadadddbcbc	TRUE
dcadbcadadad	TRUE
dcccbcdbcbcd	TRUE
dcccbcddaddd	TRUE
ddbcaddcdbca	TRUE
ddbcbcadbcbc	TRUE
aaaaabababbb	FALSE
aaaaabadddcc	FALSE
aacbabaccaab	FALSE
aacbabcbacac	FALSE
abacbdbcabbd	FALSE
abaccaacbaac	FALSE
abdabbdbbbdb	FALSE
abdabccbccdc	FALSE
acbcaccbaacd	FALSE
acbcaccdcabc	FALSE
adaaabadacdc	FALSE
adaaadaabdca	FALSE
adccccaacbab	FALSE
adccccbbcddd	FALSE
babbccdacbca	FALSE
babbcdcdbbad	FALSE
bbaacbbaddcd	FALSE
bbaacbdbadbd	FALSE
bbccbdbbdacb	FALSE
bbccbdcabbab	FALSE
bcbabdbddbbd	FALSE
bcbabddaaabd	FALSE
bcdddcbadccc	FALSE
bcdddcbcbddc	FALSE
bdcbccdadaab	FALSE
bdcbccdbdcad	FALSE
caaddacdaddb	FALSE
caaddbabbbca	FALSE
cadbcddacadc	FALSE
cadbdbadbcdb	FALSE
cbbddbcaaadc	FALSE
cbbddbdbcdca	FALSE
ccadaaaabcdd	FALSE
ccadaabaaabd	FALSE
ccdbbabddddd	FALSE
ccdbbadbcaba	FALSE
cdcaadaddacb	FALSE
cdcaadcdddab	FALSE
daacadccabaa	FALSE
daacbaaaadbd	FALSE
dadadabbaaab	FALSE
dadadacaadad	FALSE
dbbcadbbdbdb	FALSE
dbbcaddccbac	FALSE
dcaadbdccbbb	FALSE
dcabaabcccdc	FALSE
dcccbdabdabc	FALSE
dcccbdbdacdd	FALSE
ddbbbadcbdcc	FALSE
ddbbbbccdaab	FALSE
adadadadadadd	TRUE
adadadadadadd	TRUE
adadccbcdbcda	TRUE
adadcccccadad	TRUE
adbcbcbcaddad	TRUE
adbcbcbcbcbcb	TRUE
adbcdddbcbccb	TRUE
adbcdddcadada	TRUE
adccbcddbcbcb	TRUE
adccbcddbcdca	TRUE
addadbcdbccdc	TRUE
addadbcdcbcbc	TRUE
addcdcbcadcbc	TRUE
addcdcddcadcd	TRUE
bcadbcbcbcdad	TRUE
bcadbcbcbcdbc	TRUE
bcadddbcdadbc	TRUE
bcadddbcddbcc	TRUE
bcbccbcccadca	TRUE
bcbccbccddbcb	TRUE
bccbcbcccdcda	TRUE
bccbcbccdaddd	TRUE
bccddcbcdadbc	TRUE
bccddcccadddb	TRUE
bcdcbcbcadcdd	TRUE
bcdcbcbccdddb	TRUE
cadaddaddcddb	TRUE
cadaddbcbcadb	TRUE
caddbcadddbca	TRUE
caddbcbcadada	TRUE
cbcbccbcdccca	TRUE
cbcbccbcdddca	TRUE
cbcdddbcdadad	TRUE
cbcdddccbccad	TRUE
cccdcaddadcbc	TRUE
cccdccbccadad	TRUE
cdbcccddcbccb	TRUE
cdbccdcbcadcd	TRUE
dadadbcdbcbcb	TRUE
dadadbcdbcbcc	TRUE
daddadcbccbcb	TRUE
daddadcbcdada	TRUE
dbcbccbcbcbcc	TRUE
dbcbccbccadad	TRUE
dcadbcbcbcadc	TRUE
dcadbcbcbcccb	TRUE
dccddadbccdbc	TRUE
dccddadcadcbc	TRUE
ddbcbcbccdcdb	TRUE
ddbcbcbcdadcc	TRUE
aaaaaabaadcad	FALSE
aaaaaabadaada	FALSE
aaccaabbbdaab	FALSE
aaccaabccdccd	FALSE
abbbbddabccaa	FALSE
abbbbddacbcad	FALSE
abdcdcaadbdca	FALSE
abdcddbaadaac	FALSE
accbacbcbddcb	FALSE
accbacbccdcdb	FALSE
adadaccdbccdd	FALSE
adadacdbaddcb	FALSE
addbbcddcaacb	FALSE
addbbdacdbddd	FALSE
babdaaddcabcc	FALSE
babdabbaacdbd	FALSE
bbaaccbcdbcab	FALSE
bbaaccbdcdabd	FALSE
bbcccddbccbbb	FALSE
bbccdcbabaada	FALSE
bcbaacdbaabca	FALSE
bcbaadabcdaab	FALSE
bcddacdabbdda	FALSE
bcddadaabbbca	FALSE
bdcacbadcdadb	FALSE
bdcacbcadbbbb	FALSE
cabaaababbcbd	FALSE
cabaaabbacaab	FALSE
cadcaddcabbba	FALSE
cadcadddcccbd	FALSE
cbbdcdcbdaaaa	FALSE
cbbddbbbbabdb	FALSE
ccacbacaaabad	FALSE
ccacbadbcabdb	FALSE
ccdaadbacdbbb	FALSE
ccdababdacbcc	FALSE
cdbbcbbcaaaac	FALSE
cdbbcbcbbbdcd	FALSE
daaaadacaacac	FALSE
daaaadddabdad	FALSE
daccddcbdbaad	FALSE
daccddddbdabd	FALSE
dbbbbcacbbdcb	FALSE
dbbbbdbcbadac	FALSE
dcaadbaccbabc	FALSE
dcaadcdbaccaa	FALSE
dccbdadcbbacc	FALSE
dccbdbdbabaab	FALSE
ddbadbbcbbdcd	FALSE
ddbadcaababdb	FALSE
adadadadadadbc	TRUE
adadadadadadcc	TRUE
adadccbcdbcadc	TRUE
adadccbcdbcdbc	TRUE
adbcbcaddadadc	TRUE
adbcbcaddbcadc	TRUE
adbcdbcdbcdbcd	TRUE
adbcdbcddcadbc	TRUE
adcbcddcccdccd	TRUE
adcbcdddcadbca	TRUE
addadbcdcdaddb	TRUE
addadbcdddbcad	TRUE
adddbcadddbcad	TRUE
adddbcbcadbcda	TRUE
bcadbcdcddbccb	TRUE
bcadbcddadcdcd	TRUE
bcbcadcadccadc	TRUE
bcbcadcbcadcca	TRUE
bcbccdaddbcbca	TRUE
bcbccdaddbcbcc	TRUE
bccbcadadcbcad	TRUE
bccbcadbcadcdb	TRUE
bccdcbcbcdcadc	TRUE
bccdcbccadccdc	TRUE
bcdcbcadbccccd	TRUE
bcdcbcadcaddad	TRUE
cadaddaddcbcbc	TRUE
cadaddadddbcdd	TRUE
caddbcadcccbca	TRUE
caddbcbcadbcbc	TRUE
cbcbccccbccadd	TRUE
cbcbccdbcbcadd	TRUE
ccadbcadadadcb	TRUE
ccadbcadadddbc	TRUE
cccdbcdbcdddbc	TRUE
cccdbcdcbccdad	TRUE
cdbcbcadadadca	TRUE
cdbcbcadbccdad	TRUE
dadadadbccaddb	TRUE
dadadadbcdccbc	TRUE
dadcbcdcadddbc	TRUE
dadcbcdcdadcbc	TRUE
dbcbcbcbcbcbca	TRUE
dbcbcbcbccdcbc	TRUE
dcadaddcbcddad	TRUE
dcadadddadadad	TRUE
dcccbcadcadadb	TRUE
dcccbcbcadadbc	TRUE
ddbcbcdadddccc	TRUE
ddbcbcdddcdada	TRUE
aaaaaaaabbcaba	FALSE
aaaaaabdbdbddc	FALSE
aacbdcdbdcccad	FALSE
aacbdcdcadbacb	FALSE
abadbdcbbbadad	FALSE
abadcaacacbddd	FALSE
abddababcadbcc	FALSE
abddabbadababc	FALSE
accacbababcddb	FALSE
accacbacbaaacb	FALSE
adbabcaaacdadd	FALSE
adbabdaacdcbda	FALSE
adddbadaacccba	FALSE
adddbadcbdbbbb	FALSE
bacbdbcdcdbbcd	FALSE
bacbdcaadaacdb	FALSE
bbbadaacbddbcc	FALSE
bbbadacabdddda	FALSE
bcaaabcacbabcb	FALSE
bcaaacddccbdcc	FALSE
bcccaadacacaaa	FALSE
bcccabacacabcb	FALSE
bdbbacdccbbccb	FALSE
bdbbbbbaddbbad	FALSE
bdddaadbddbcbd	FALSE
bdddabdacacdbc	FALSE
cacacccbacabbb	FALSE
cacacdadcababb	FALSE
cbadcdcdacbddb	FALSE
cbaddaabdbcaba	FALSE
cbdccccadabdbd	FALSE
cbdccdaaaaaaba	FALSE
ccbdcaaacbadbd	FALSE
ccbdcadadcbccd	FALSE
cdabbabdbaccca	FALSE
cdabbbbaaaadad	FALSE
cdcccbbbcddccd	FALSE
cdcccbcdcadcab	FALSE
daacbabdbaacaa	FALSE
daacbacadaddca	FALSE
dadbacacadbcbb	FALSE
dadbbadadddabd	FALSE
dbbdbdcbdabbbd	FALSE
dbbdcddbbbcddb	FALSE
dcabbcbbbddcbc	FALSE
dcabbdcdaaaabc	FALSE
dccddadbdbdbad	FALSE
dccddbbddbbbab	FALSE
ddbbdabdcadaad	FALSE
ddbbdacccddaad	FALSE
adadadadadadbcc	TRUE
adadadadadadcad	TRUE
adadcdbcadaddad	TRUE
adadcdbcbcdadad	TRUE
adbcbcbcdadaddc	TRUE
adbcbcbcdbcbcdc	TRUE
adcadbcadaddbca	TRUE
adcadbcadcdcadb	TRUE
adcccdbcbcbcbcb	TRUE
adcccdbccbcbcad	TRUE
addbcbcadcadbcb	TRUE
addbcbcadcadbcb	TRUE
adddddadadbccdc	TRUE
adddddadbcbcdbc	TRUE
bcadccddcadcddc	TRUE
bcadcdadbccdcbc	TRUE
bcbcbccadbcadbc	TRUE
bcbcbccadcddccb	TRUE
bcbcddbcdcdcddb	TRUE
bcbcddccbccddda	TRUE
bccccadadccaddd	TRUE
bccccaddbcbcdca	TRUE
bcdbcadadadddcc	TRUE
bcdbcadbcadcbca	TRUE
bcdddaddbcadcca	TRUE
bcdddbcadcdadad	TRUE
cadcbcadbcddada	TRUE
cadcbcaddbcdddc	TRUE
cbcaddcdcccadbc	TRUE
cbcadddadbcbcdc	TRUE
cbcdccdbcddaddb	TRUE
cbcdcdadadddcbc	TRUE
ccbcddadbcdadbc	TRUE
ccbcddadbcdcbcc	TRUE
cdadadbcbccadad	TRUE
cdadadbccaddcdd	TRUE
cdcaddcbcadbcca	TRUE
cdcaddcbcdddcad	TRUE
dadaddadcbcadca	TRUE
dadaddadccbcdda	TRUE
daddbcadcccdadb	TRUE
daddbcaddbcadbc	TRUE
dbcbcdbcbcbcbca	TRUE
dbcbcdbcbccdadc	TRUE
dcadcaddadcbccb	TRUE
dcadcaddaddadbc	TRUE
dcdbcadaddbccbc	TRUE
dcdbcadbcbccadc	TRUE
ddbccbccbcddbcb	TRUE
ddbccbcdbcadadc	TRUE
aaaaaaaabbcabad	FALSE
aaaaaabbdbddcca	FALSE
aacbdbbdbbdbbba	FALSE
aacbdcaaacabadb	FALSE
abbacacbdabdbbd	FALSE
abbaccabcabccab	FALSE
abddbabacabdcaa	FALSE
abddbacdbccdcdd	FALSE
accadcccaddaadb	FALSE
accadccdbcbadba	FALSE
adbacbdacdbdbcb	FALSE
adbaccdabbcbbad	FALSE
adddcaccbdbacda	FALSE
adddcacccccddca	FALSE
bacbdcabbaccaca	FALSE
bacbdccdcaacbda	FALSE
bbbaadabbaabcad	FALSE
bbbaadbbcbcdbaa	FALSE
bbdcbcacaddbaaa	FALSE
bbdcbdcdbcdccda	FALSE
bccaccaabcdbbdb	FALSE
bccaccbbadcccdd	FALSE
bdbbacabaabdabb	FALSE
bdbbacbaccccaaa	FALSE
bdddacbccabcdad	FALSE
bdddacdababdaad	FALSE
cacbcbacbaaadcb	FALSE
cacbcbbcddcacbc	FALSE
cbbabbbcaaccaab	FALSE
cbbabbcccdbbcab	FALSE
cbdcccdacdccdbd	FALSE
cbdccdccbababaa	FALSE
ccbdcdadaacabcd	FALSE
ccbdcdbbdcadaaa	FALSE
cdaabccabccadcd	FALSE
cdaabddacbbbcac	FALSE
cdcacddddcbcdab	FALSE
cdcadabdcaaddcd	FALSE
daadbaccbbacbdb	FALSE
daadbbabbaadcac	FALSE
dadbbbadbcabccb	FALSE
dadbbbddddddacb	FALSE
dbbddadbddabdbd	FALSE
dbbddbaabcbbdbd	FALSE
dcacaadccdcabac	FALSE
dcacabdadbbdbaa	FALSE
dcdbabbdbadadab	FALSE
dcdbacbddbdbaaa	FALSE
ddbcbbaddbacddc	FALSE
ddbcbbdcdbabbbc	FALSE
adadadadadadbccc	TRUE
adadadadadadcadd	TRUE
adadccbcdcadbcad	TRUE
adadccbcdccddadc	TRUE
adbcbcadbcbcccca	TRUE
adbcbcadbcbcdadd	TRUE
adbcdcadccbcdccb	TRUE
adbcdcadcdadccca	TRUE
adcbcdcadadcdadc	TRUE
adcbcdcadccbccdd	TRUE
addadcdadbcdddad	TRUE
addadcdadccbcdcc	TRUE
adddbccadbcaddca	TRUE
adddbccaddcddbcc	TRUE
bcadcbcdbcaddbcb	TRUE
bcadcbcdbcbcbcdc	TRUE
bcbcadddadbcbcbc	TRUE
bcbcadddcbcadcad	TRUE
bcbcddbcadadbcbc	TRUE
bcbcddbcadaddbca	TRUE
bcccbcdbcadbcdad	TRUE
bcccbcdcadbccccc	TRUE
bcdaddcadbccadbc	TRUE
bcdaddcdadbcadcd	TRUE
bcddbcdcddadadad	TRUE
bcddbcddadadadad	TRUE
cadbcdaddbcadcda	TRUE
cadbcdaddbcadddc	TRUE
cbcadaddbcdadada	TRUE
cbcadaddbcdadadd	TRUE
cbcccadddadccdda	TRUE
cbcccbcbcadaddbc	TRUE
ccbcbcadbcbcadad	TRUE
ccbcbcadbcbcbccc	TRUE
ccdcdcdbcdadbccd	TRUE
ccdcddadcdadcadd	TRUE
cdcadddbcbcdbcad	TRUE
cdcbcadadbcadcca	TRUE
dadaddcaddddddbc	TRUE
dadaddcbcccdcadc	TRUE
daddcadaddbcadbc	TRUE
daddcadadddbccad	TRUE
dbcbcdcdcadcbcca	TRUE
dbcbcddcbcbcbcad	TRUE
dcadbcdbcadccada	TRUE
dcadbcdbcaddbcbc	TRUE
dccddcaddadaddcd	TRUE
dccddccdbcccbcad	TRUE
ddbcbcdaddccbcad	TRUE
ddbcbcdbcdbccadc	TRUE
aaaaaacabdcddbbc	FALSE
aaaaacacddabbbbb	FALSE
aacccbdadcbdbccc	FALSE
aaccccddbbadbbdb	FALSE
abbbaaccaddbaadb	FALSE
abbbabdcbbcacabb	FALSE
abddacdabbdadccc	FALSE
abddbabaaaaaccba	FALSE
accabdbbcbcabdaa	FALSE
accacbaccbddbabd	FALSE
adacbdccbddcacab	FALSE
adaccbaabdbbdbbb	FALSE
addadadabadaabac	FALSE
addadadcbadbcadb	FALSE
babdcdadabcaccdd	FALSE
babdcdbddcadabdb	FALSE
bbabddbcbbdadcdd	FALSE
bbabddcdadcddbdc	FALSE
bbcddaabcccbcaba	FALSE
bbcddadcbddacddc	FALSE
bcbbdaddbbdbdddc	FALSE
bcbbdbbbbcbabddd	FALSE
bdabdcbcacaacaad	FALSE
bdabdccbcccbaacc	FALSE
bddbacbcddadcabc	FALSE
bddbbbccdacbbddd	FALSE
cacaacdbdbccdccd	FALSE
cacabababbbbabda	FALSE
cbaadbcbabadcabb	FALSE
cbaadbdcbaadcabb	FALSE
cbcccdcdcdaaacbd	FALSE
cbcccddacadcabdd	FALSE
ccbbbcbbadbdddac	FALSE
ccbbbcbcbbcdadbd	FALSE
ccdcdcdbadacbccd	FALSE
ccdcddaccdaacacd	FALSE
cdcadddbcbddbbab	FALSE
cdcbaacaccddcdca	FALSE
daadbbdbadbbccdd	FALSE
daadbbdddbbdaccb	FALSE
dadbdccaabdcacbc	FALSE
dadbdccddadacdcd	FALSE
dbbdbdcddbdbadaa	FALSE
dbbdcaadaacabaad	FALSE
dcabdcaddddbcdbd	FALSE
dcabdccaabbbabbd	FALSE
dccddcabaaaabdcd	FALSE
dccddccdbbccbaaa	FALSE
ddbbcbdcadcccdbd	FALSE
ddbbccaacbcddacd	FALSE
adadadadadcbcaddc	TRUE
adadadadaddccadcb	TRUE
adadccdadaddbcddc	TRUE
adadccddadbcadada	TRUE
adbcbcadadddccccd	TRUE
adbcbcadbcadadadc	TRUE
adbcdaddccdbcdccc	TRUE
adbcdaddcdcadadbc	TRUE
adcbccbccadccccda	TRUE
adcbccbccbcdbcbca	TRUE
addadbcbcbccbcdcb	TRUE
addadbcbccadadcbc	TRUE
adddadbcadbcadadc	TRUE
adddadbcbccdddbcd	TRUE
bcadbcdbccadadbcc	TRUE
bcadbcdbccadadccc	TRUE
bcbcadbcadbcddadb	TRUE
bcbcadbcbccadbcad	TRUE
bcbccdbcadbcadcbc	TRUE
bcbccdbcbcbccbcbc	TRUE
bccadddadadbccbcb	TRUE
bccadddbccaddbccb	TRUE
bccddbcbcadccaddb	TRUE
bccddbccadadadadb	TRUE
bcdcaddadadcccdbc	TRUE
bcdcaddaddbcadcad	TRUE
cadadcdadbcbcbcad	TRUE
cadadcdbcdbccdbcb	TRUE
caddbcadcddbcbcdb	TRUE
caddbcbcadcccdbcc	TRUE
cbcbcdadadddddada	TRUE
cbcbcdbcbcbcdbcbc	TRUE
ccadbcadcbcbcdbcc	TRUE
ccadbcbcbcbccddca	TRUE
cccddadbcdadbcbcb	TRUE
cccddbccbcbcbccad	TRUE
cdbcccadadcdcadbc	TRUE
cdbcccadddddbcada	TRUE
cdddbccadaddcdcda	TRUE
cdddbccadbcccdadd	TRUE
dadcbcbcdccadccdb	TRUE
dadcbccadcadccddc	TRUE
dbcbcbcbcadcadbca	TRUE
dbcbcbcbcadccdbca	TRUE
dbcddadccadaddcdb	TRUE
dbcddaddadadbcccc	TRUE
dcccdadadbcadbccc	TRUE
dcccdcadadccadcda	TRUE
ddbcbcbcdbcdaddca	TRUE
ddbcbcbcddadcadbc	TRUE
aaaaaacdabaaacaaa	FALSE
aaaaabbacabadcbdb	FALSE
aacdacdcdbdddbbab	FALSE
aacdadaddcabbabbd	FALSE
abbacabacdbbacccd	FALSE
abbacdabcdcadaddd	FALSE
abddbdbbdababcdbc	FALSE
abddcabbccccdadbc	FALSE
accbbadaabbacddcc	FALSE
accbbadbdbcbaaddd	FALSE
adacdadcdadacdccd	FALSE
adacdbaadddcddadc	FALSE
adcdddbdddabbcdbb	FALSE
addaaabaabcddadad	FALSE
babccbacdacabacad	FALSE
babccbbddbbacaaba	FALSE
bbaadbbaaaccbdbab	FALSE
bbaadcadbbbccbcdc	FALSE
bbcccadccbdbcabad	FALSE
bbcccdaaadaccadda	FALSE
bcbbddbdddcbccdba	FALSE
bcbcaaacbaabccdbd	FALSE
bcddaaaadcacaabca	FALSE
bcddaaabdcbaaacda	FALSE
bdcaccadadabbdacb	FALSE
bdcaccadbadaccbbb	FALSE
caacddacccaccbaca	FALSE
caacddbadbbdaabdc	FALSE
cadadccddbcbdacca	FALSE
cadaddacadbabaccb	FALSE
cbcaabbcbdcbdadca	FALSE
cbcaadadbccabdada	FALSE
ccabaccccabccdddc	FALSE
ccabadbdaaccaaadd	FALSE
cccddaabbdadbcbcb	FALSE
cccddbdcbabbbbcad	FALSE
cdbcabbddcddaabcd	FALSE
cdbcacbbbbaabbcdb	FALSE
cdddbbcadbaaaabba	FALSE
cdddbbcdabaddbbab	FALSE
dacbcdbdbabbcccab	FALSE
dacbdbaabaaccdbab	FALSE
dbbacaadaacadcbba	FALSE
dbbacacdadbbbdcad	FALSE
dbdcdadcbcaddadcc	FALSE
dbdcdbcbadcdccbaa	FALSE
dcccdadacbdaabacc	FALSE
dcccdcabacccabcda	FALSE
ddbbccabbddddabaa	FALSE
ddbbccbbabcdbdcdc	FALSE
adadadadadbcbcccad	TRUE
adadadadadbccadbca	TRUE
adadccaddadcadcadd	TRUE
adadccaddaddbcddcc	TRUE
adbcaddbcbcdcdadad	TRUE
adbcaddbcdbcbccbcb	TRUE
adbcdbcbcddcadddbc	TRUE
adbcdbccbcdbcadcbc	TRUE
adcbcddbcccbcdddbc	TRUE
adcbcddcadadbcadcb	TRUE
addadadcbcadbcccbc	TRUE
addadadcbccbccdbcc	TRUE
addcdbccbccbcbcadd	TRUE
addcdbcccadbcdcbcd	TRUE
bcadbcbcadddcccbca	TRUE
bcadbcbcbcadbcbcca	TRUE
bcadddccadadbccbcd	TRUE
bcbcadadadadbcbcad	TRUE
bcbccbccbcdbcdbcca	TRUE
bcbccbcdadbcadcdbc	TRUE
bccadddbcdcbcadcbc	TRUE
bccbcadadadadcadad	TRUE
bccdcbcaddbcadbcad	TRUE
bccdcbcadddccdddbc	TRUE
bcdcadbcbccccdcadd	TRUE
bcdcadbcbcdadbcadb	TRUE
cadadcbcaddaddbcbc	TRUE
cadadcbcbcccdbcdcc	TRUE
caddbcbcaddcbcadbc	TRUE
caddbccadadddadadd	TRUE
cbccadadadcbcadada	TRUE
cbccadaddadbcdaddb	TRUE
ccadbcbccadcadadad	TRUE
ccadbcbccdbcccbccb	TRUE
ccdbcbcaddbccddbcd	TRUE
ccdbcbcaddcadcddcd	TRUE
cdcadbcccaddaddadc	TRUE
cdcadbcddaddadcdad	TRUE
dadadcddbcccccbcad	TRUE
dadaddadaddbccbcda	TRUE
daddbcddadbcaddcca	TRUE
daddcadcbcadadcdad	TRUE
dbcbcddcdcdcaddcdc	TRUE
dbccadadaddccdadad	TRUE
dcadaddadadbcbcadb	TRUE
dcadaddadadcdbcbcd	TRUE
dcdadbccadcadadbcd	TRUE
dcdadbccdadcaddbca	TRUE
ddbcbcbcaddccbcadd	TRUE
ddbcbcbcbcdbccbcad	TRUE
aaaaadbadaabdccccc	FALSE
aaaabaacabaadbadad	FALSE
aacbdadcabcdcaaacb	FALSE
aacbdadddbabacbabd	FALSE
abbbadbcbdaabcaaab	FALSE
abbbbbbadccdabbcbd	FALSE
acaaaadadbbbbbaacd	FALSE
acaaaccbaaacbbbcdd	FALSE
acccbadcabbabbacab	FALSE
acccbcccbbdbcaadba	FALSE
adbacbcccdcdcadbda	FALSE
adbacbdcbcbacdbcbd	FALSE
addcaccddabbbabbcc	FALSE
addcacdccdbdbccadc	FALSE
babddadbadbabdcbba	FALSE
babddbccbbbadbacab	FALSE
bbadaadaaacabadddd	FALSE
bbadabcaddadababba	FALSE
bbdbacbdababacaccc	FALSE
bbdbacdbdaadccdaaa	FALSE
bcbbcdbcddcbaaabbc	FALSE
bcbbdcabbbcbaabbca	FALSE
bdaaadccacbdbcadda	FALSE
bdaabaaadcdcdbbdbb	FALSE
bdcbcbddddabcccada	FALSE
bdcbccdccdbbdbcaca	FALSE
caaddbdbabbaddbcdd	FALSE
caaddcbcababdccdbb	FALSE
cadbdabddcbdcbadbc	FALSE
cadbdaccbcdbbbcdab	FALSE
cbcaddbcadbbadbdab	FALSE
cbcaddbdddcbcbcddd	FALSE
ccbabbcbdaacadaadc	FALSE
ccbabcbcadacabcccc	FALSE
ccdcbadabdbcbcbcab	FALSE
ccdcbbbabbadabadbc	FALSE
cdcabccaadcdcdbaad	FALSE
cdcabdaddcaddddcbc	FALSE
daacdadbdacabddadc	FALSE
daacdbaadbbaacbdcd	FALSE
dadbbabdbcccacbcdb	FALSE
dadbbdaababdbbaabb	FALSE
dbbcdbccbadacacbdb	FALSE
dbbcdbdccaccaadbca	FALSE
dcabdbbcacacbddccd	FALSE
dcabdbdadabdadaadc	FALSE
dcdaacbdcdddcbccdd	FALSE
dcdaadcabaabbdadba	FALSE
ddbbdbbaccacdcabca	FALSE
ddbbdbbccaacdacbbc	FALSE
adadadadadbccadcdcc	TRUE
adadadadaddccbcbcbc	TRUE
adadccadccaddcbcbca	TRUE
adadccaddcadbcddbcc	TRUE
adbcbcadbcdaddbcadc	TRUE
adbcbcadbcddcddcbca	TRUE
adbcdddadadbcadadad	TRUE
adbcdddadadcbcbcbcd	TRUE
adccbcbcbccdcbcadad	TRUE
adccbcbccbcbcdbcdcd	TRUE
addbcadbcbcbcadcbcc	TRUE
addbcadbcbccdaddbcb	TRUE
adddbcddadbcadadbcb	TRUE
adddbcddadbcbcadcdd	TRUE
bcadcadbccbcdadaddd	TRUE
bcadcadbcccaddadbca	TRUE
bcbcadcadcdbccbcdda	TRUE
bcbcadcaddddcdbcada	TRUE
bcbcdadbccdbcadcbcb	TRUE
bcbcdadbcdbcbcdccad	TRUE
bccbccbccdcbcccbcca	TRUE
bccbccbccdccadbcbcb	TRUE
bccddadadadadadbcbc	TRUE
bccddadadcbccadcdbc	TRUE
bcdcbcadcdcccadbcbc	TRUE
bcdcbcadcddcddccbcc	TRUE
cadbcadcadcdadadbcc	TRUE
cadbcadcbcaddddbccd	TRUE
caddcbccadbcdadcccd	TRUE
caddccadadadcadcbcd	TRUE
cbccadadccadddadcca	TRUE
cbccadaddbcaddaddbc	TRUE
ccadcadbcadadadadca	TRUE
ccadcadbcdbccadbcad	TRUE
ccdaddbcdcdcdbcadda	TRUE
ccdaddcbcddddcbcddd	TRUE
cdcaddadbcadadbcbcd	TRUE
cdcaddbcdadbcadcdcc	TRUE
dadadccbcbcbcbcbcdc	TRUE
dadadccbcdcadaddcbc	TRUE
dadccdcdbcadadcadcd	TRUE
dadcdadaddaddcbcada	TRUE
dbcbcbcbcbcadcbcccb	TRUE
dbcbcbcbccadadbccbc	TRUE
dcadbcaddadadbccbcd	TRUE
dcadbcaddbcbccbcddd	TRUE
dccdadbcadddcadadcc	TRUE
dccdadbcdbcadcbccbc	TRUE
ddbcbcadccadbcbcadd	TRUE
ddbcbcadcdbccdcadca	TRUE
aaaaaabdbaadadbccdd	FALSE
aaaaacaaddaccdacbbc	FALSE
aacdababddadcabdadc	FALSE
aacdabddbbaaabdccad	FALSE
abaddadddbabcbabaca	FALSE
abaddbbcdbcbabdacca	FALSE
abdcbadcbaacacadcad	FALSE
abdcbbbdbcdadaabbdd	FALSE
accadbbbbcbbbddacdc	FALSE
accadbcddabacccbbdd	FALSE
adadbadcbbccdbdabdb	FALSE
adadbdadaccbbacdcba	FALSE
addcbcaccabdcbaddba	FALSE
addcbcdbadddbaaaada	FALSE
bacaaadccbababacbda	FALSE
bacaabbdccaccadbaac	FALSE
bbacaaadcdbccaaaaaa	FALSE
bbacaabdabacbcdadad	FALSE
bbdadbbcbbdcbbccadc	FALSE
bbdadbbdaddadbacbcd	FALSE
bcbccadacccbdacdcdc	FALSE
bcbccbbadacdbdcbaac	FALSE
bdaacbddbcaaaababcc	FALSE
bdaaccbacccbbdcadba	FALSE
bdccbbcdcdaccabcabd	FALSE
bdccbbddadcacddcaab	FALSE
cabbcccdbdcaddaabdb	FALSE
cabbccddcdabcbddcbc	FALSE
caddbccdcacccdccacb	FALSE
caddbdaabccdbbcbccd	FALSE
cbcbdcdcdddaccdddcb	FALSE
cbccabcaaddcaaacbcc	FALSE
ccbbbcccdbadaddcdcd	FALSE
ccbbbcdbdadacaadaba	FALSE
cdaabadcdbabcbbcccd	FALSE
cdaabbbaddbcccbcbbb	FALSE
cdcdabdaadcbbbbcdba	FALSE
cdcdbaaacdbddbbdcab	FALSE
dabbbbacdbdbbaddbaa	FALSE
dabbbbcdccddacdccab	FALSE
dadddbdcbbdddadcccc	FALSE
dbaaacdcbacbcbdbacb	FALSE
dbcdaabcadcdcdcaddc	FALSE
dbcdaabddbaabbaacac	FALSE
dcbadaaadbdddbdbbcd	FALSE
dcbadabcccdddacbdbb	FALSE
dcdcaadddabccdcccdd	FALSE
dcdcadabbadbddddaad	FALSE
ddbddbcdccdcdddbaac	FALSE
ddbddbddaaccbaadaaa	FALSE
