adadadadad	TRUE
adadadadad	TRUE
adadccadcc	TRUE
adadccadcc	TRUE
adbadcdbcd	TRUE
adbadcdcca	TRUE
adbcdccadd	TRUE
adbcdcddcb	TRUE
adcbbcccbc	TRUE
adcbbcccdb	TRUE
addadadada	TRUE
addadadadd	TRUE
addccbbcdd	TRUE
addccbbdad	TRUE
badadddada	TRUE
badaddddba	TRUE
baddcddcba	TRUE
baddcddcca	TRUE
bbcbbbadcb	TRUE
bbcbbbdcba	TRUE
bcbadadadb	TRUE
bcbadadbbd	TRUE
bcdcccadad	TRUE
bcdcccaddd	TRUE
bdbddcbdbd	TRUE
bdbddcdcbc	TRUE
cadadaddcb	TRUE
cadadadddd	TRUE
cadccdadcb	TRUE
cadccdadda	TRUE
cbbbbdcbad	TRUE
cbbbcadcca	TRUE
ccadbadbca	TRUE
ccadbadbcc	TRUE
ccdadadadb	TRUE
ccdadadbad	TRUE
cdbcccadad	TRUE
cdbcccdbad	TRUE
dadadadbbd	TRUE
dadadadbbd	TRUE
dadcbdddad	TRUE
dadccadadd	TRUE
dbbbbcbcdc	TRUE
dbbbbcbcdd	TRUE
dcadadadad	TRUE
dcadadadba	TRUE
dccccadcdb	TRUE
dcccccbada	TRUE
ddbbddcbda	TRUE
ddbbdddbdb	TRUE
aaaaaacaac	FALSE
aaaaaadcda	FALSE
aaccdbbbbd	FALSE
aaccdcabbc	FALSE
abbaddbcab	FALSE
abbbaaaacd	FALSE
abdadcaccd	FALSE
abdadcadbc	FALSE
acbbdbbcba	FALSE
acbbdcdabc	FALSE
acdddcccba	FALSE
acddddaddb	FALSE
adcbcdbbac	FALSE
adcbcdccaa	FALSE
baadaadbcb	FALSE
baadabadbc	FALSE
badcdaaadb	FALSE
badcdbcaba	FALSE
bbcbbbabcb	FALSE
bbcbbbdcaa	FALSE
bcbaabaaac	FALSE
bcbaacdcac	FALSE
bcdcccabba	FALSE
bcdcccadac	FALSE
bdbddcbdac	FALSE
bdbddcdcab	FALSE
caabaacdda	FALSE
caabaadcbb	FALSE
cadaabddba	FALSE
cadaacbadc	FALSE
cbbbbdcbab	FALSE
cbbbcabcca	FALSE
ccaadbcdba	FALSE
ccaadcacdb	FALSE
ccdaaadcdd	FALSE
ccdaabaadb	FALSE
cdbcccaaac	FALSE
cdbcccdbac	FALSE
daaacddcac	FALSE
daaacddddd	FALSE
daccbbdaba	FALSE
daccbcbdda	FALSE
dbbbbcbcab	FALSE
dbbbbcbcac	FALSE
dcaaaccbbd	FALSE
dcaabdadba	FALSE
dccccadbab	FALSE
dcccccbaaa	FALSE
ddbbddcbaa	FALSE
ddbbdddbab	FALSE
adadadadada	TRUE
adadadadada	TRUE
adadccadadb	TRUE
adadccadadb	TRUE
adbadcdbcbc	TRUE
adbadcdbdad	TRUE
adbdadbbbbd	TRUE
adbdadbbbca	TRUE
adcbcadadad	TRUE
adcbcadadbc	TRUE
addadadadad	TRUE
addadadadcc	TRUE
addccadadda	TRUE
addccadbbad	TRUE
badadddbbdd	TRUE
badadddcdcd	TRUE
baddbcbadad	TRUE
baddbccadad	TRUE
bbbdddcadbb	TRUE
bbcadadbcbd	TRUE
bcadbaddcdb	TRUE
bcadbbadbcd	TRUE
bcdadadbadd	TRUE
bcdadadbbba	TRUE
bdbbdbdddad	TRUE
bdbbdcdcdad	TRUE
cadadbadbdd	TRUE
cadadbadccd	TRUE
cadcdbdadba	TRUE
cadcdbdddad	TRUE
cbbbdadaddb	TRUE
cbbbdbadddd	TRUE
ccadadbdadc	TRUE
ccadadbdadd	TRUE
cccdadadcdb	TRUE
cccdadaddad	TRUE
cdbbdbaddad	TRUE
cdbbddccdba	TRUE
dadadadbadc	TRUE
dadadadbadd	TRUE
daddadadcad	TRUE
daddadadccd	TRUE
dbbdadddbca	TRUE
dbbdadddcdc	TRUE
dcadaddadcb	TRUE
dcadaddbbba	TRUE
dcccbaddcdb	TRUE
dcccbbcdbbc	TRUE
ddbbbbdcdcd	TRUE
ddbbbcaddcc	TRUE
aaaaaacaaca	FALSE
aaaaaaddaac	FALSE
aacbddacacc	FALSE
aaccaabadcc	FALSE
abbacbaaacb	FALSE
abbaccabcbb	FALSE
abdadcccaca	FALSE
abdadcdadcc	FALSE
acbcadbcccd	FALSE
acbcaddbdca	FALSE
acddddabcbb	FALSE
acddddacddb	FALSE
adcbbbaacba	FALSE
adcbbbaccaa	FALSE
baadcbcbbcb	FALSE
baadccdcbcb	FALSE
badbdacdcca	FALSE
badbdcbcbaa	FALSE
bbbdddcabbb	FALSE
bbcaaaabbdd	FALSE
bcabdbcbcac	FALSE
bcabdbcddaa	FALSE
bcdaabcbbba	FALSE
bcdaaccbbdd	FALSE
bdbbdbdddac	FALSE
bdbbdcdcdaa	FALSE
caaaddaadaa	FALSE
caaaddbbadb	FALSE
cacdddccacb	FALSE
cadaaaacdaa	FALSE
cbbbdadabdb	FALSE
cbbbdbacddd	FALSE
ccaabccddba	FALSE
ccaabcdcdca	FALSE
cccdaabaddb	FALSE
cccdaabbcda	FALSE
cdbbdbabdac	FALSE
cdbbddccdaa	FALSE
daaabdcdbca	FALSE
daaacbbbcdb	FALSE
dadacbdcbda	FALSE
dadacbdddda	FALSE
dbbdacdabca	FALSE
dbbdacdacdc	FALSE
dcaadbddbbc	FALSE
dcabaaaabbb	FALSE
dcccbadbcaa	FALSE
dcccbbcdbab	FALSE
ddbbbbdcdac	FALSE
ddbbbcacdcc	FALSE
adadadadadad	TRUE
adadadadadad	TRUE
adadcbdadcca	TRUE
adadcbdaddbc	TRUE
adbadcbbddcb	TRUE
adbadcbcbadb	TRUE
adbcdbadbdcd	TRUE
adbcdbbdadba	TRUE
adcbbddadccb	TRUE
adcbbddbadbd	TRUE
addadadadadd	TRUE
addadadadcad	TRUE
addcbbadbada	TRUE
addcbbadbadb	TRUE
badadcdcdada	TRUE
badadcdddcdd	TRUE
baddcbadcadb	TRUE
baddcbbadcad	TRUE
bbcadaddadcd	TRUE
bbcadbadadba	TRUE
bcadccddadad	TRUE
bcadcdadadba	TRUE
bcdbcbbbdadd	TRUE
bcdbcccbddcb	TRUE
bdbdbbddbbad	TRUE
bdbdbccdcbda	TRUE
cadadbadccad	TRUE
cadadbadcdcd	TRUE
cadccdadcddd	TRUE
cadccdcbccda	TRUE
cbbcbbadbddd	TRUE
cbbcbbcbbada	TRUE
ccadadadbcbd	TRUE
ccadadadcbca	TRUE
cccdcdbbadcb	TRUE
cccdcdcbadcb	TRUE
cdbcbadbbdba	TRUE
cdbcbadbcbcd	TRUE
dadadadbcdad	TRUE
dadadadbdbad	TRUE
dadccadcadad	TRUE
dadccadcadbd	TRUE
dbbadbadddcd	TRUE
dbbadbbdadca	TRUE
dbddadaddcbc	TRUE
dbddadbcbdba	TRUE
dccccadbadcd	TRUE
dccccaddccad	TRUE
ddbbddbcadad	TRUE
ddbcadadbcdb	TRUE
aaaaaaaaacca	FALSE
aaaaabcadbaa	FALSE
aaccdacbbcdb	FALSE
aaccdbbcddcc	FALSE
abbbbbbbbdad	FALSE
abbbbcddaadc	FALSE
abdcaccdddcc	FALSE
abdcacddcbda	FALSE
accacdbdbcab	FALSE
accadbbcbaca	FALSE
adacadaacabd	FALSE
adacadaccabb	FALSE
addadbcdbdaa	FALSE
addadccbbacb	FALSE
babcbcaadddc	FALSE
babcbdcbbddc	FALSE
bbaaaddddcdb	FALSE
bbaabaaddacd	FALSE
bbccdcbdbbac	FALSE
bbccddaacaab	FALSE
bcbbacbacaac	FALSE
bcbbacdbdcca	FALSE
bcddbccdcaad	FALSE
bcddcaaaacdc	FALSE
bdcbdbdbcbac	FALSE
bdcbdcbaccbd	FALSE
cabbcdcadaba	FALSE
cabbdabcddca	FALSE
cbaacabcddbd	FALSE
cbaacbaadcda	FALSE
cbcbdcbacddc	FALSE
cbcbdccaadda	FALSE
ccadcccddaca	FALSE
ccadcddabcad	FALSE
ccdcbbccddac	FALSE
ccdcbcddbcaa	FALSE
cdbdcbccdaad	FALSE
cdbdcbddddac	FALSE
daabdbdbaddb	FALSE
daabdbdcacac	FALSE
dadbbbdcccab	FALSE
dadbbbddabdd	FALSE
dbbdbbbdbbab	FALSE
dbbdbcdddaba	FALSE
dcabdacabada	FALSE
dcabdacbbdba	FALSE
dcdaaadbaacc	FALSE
dcdaaadcdcab	FALSE
ddbcaaddcdab	FALSE
ddbcabcdbccb	FALSE
adadadadadada	TRUE
adadadadadccd	TRUE
adadcbddddbad	TRUE
adadccadadcba	TRUE
adbaddddccadc	TRUE
adbbadadadadd	TRUE
adbdbccadadad	TRUE
adbdbccdadcad	TRUE
adcbddadbbbca	TRUE
adcbddbadadca	TRUE
addadcccdadca	TRUE
addadcccdbcdd	TRUE
adddaddadddda	TRUE
adddaddbbccbd	TRUE
badbcbadcadcd	TRUE
badbcbaddcbbb	TRUE
bbadadcadcdcc	TRUE
bbadadcbadbcb	TRUE
bbcbdcbadcdad	TRUE
bbccadadaddda	TRUE
bcaddddccbbad	TRUE
bcbadadadcdcb	TRUE
bdadadbcdbcba	TRUE
bdadadbcdddda	TRUE
bdcccdadadcbd	TRUE
bdcccdbadbcad	TRUE
cadbadcbadbad	TRUE
cadbadcbadcda	TRUE
cadddaddadbbd	TRUE
cadddbadadcad	TRUE
cbcbadadbcbcb	TRUE
cbcbadbaddcdd	TRUE
ccadcccbcbadc	TRUE
ccadcdadadddc	TRUE
ccdcbdbadbbca	TRUE
ccdcbdbaddadc	TRUE
cdcadadadcbcd	TRUE
cdcadadbadcbd	TRUE
dadadbdbadcdc	TRUE
dadadbdbbbadd	TRUE
dadccdbcddcad	TRUE
dadccdcadcbcb	TRUE
dbbbddccadbcc	TRUE
dbbcadadadadb	TRUE
dcadadcdccdcb	TRUE
dcadaddaddbcc	TRUE
dccdccccbddcb	TRUE
dccdcdadadbcd	TRUE
ddbbcaddadada	TRUE
ddbbcbdbdadcc	TRUE
aaaaaaaaaccad	FALSE
aaaaabadbaaba	FALSE
aaccbdbcaabbc	FALSE
aaccbdcbabbdc	FALSE
abbadbcbbadcc	FALSE
abbadcadbbddc	FALSE
abdccbabcbbac	FALSE
abdccccddacab	FALSE
accaaadbababd	FALSE
accaacbcabcda	FALSE
adacabcabccdb	FALSE
adacbacbddadb	FALSE
addadbdcddbac	FALSE
addadcdbbccac	FALSE
babdacabadbbb	FALSE
babdacacacdca	FALSE
bbaababddccbc	FALSE
bbaabacbccdda	FALSE
bbcbdcbaccdab	FALSE
bbccaabdbabaa	FALSE
bcaddddbabbab	FALSE
bcbaaaabdabdd	FALSE
bdaaacdabcada	FALSE
bdaabbadddcdd	FALSE
bdcccdacabcbd	FALSE
bdcccdbabbcaa	FALSE
cabbdbdbaabbb	FALSE
cabbdcbbcdaaa	FALSE
caddcbddccacd	FALSE
caddccdcabcdc	FALSE
cbcbacdbccabb	FALSE
cbcbadaaddcdd	FALSE
ccaccdcbbdbdc	FALSE
ccacdaadcbdcd	FALSE
ccdcbdbaadbbc	FALSE
ccdcbdbadcacc	FALSE
cdcaaaabdcacc	FALSE
cdcaaabbdabba	FALSE
daacadbaccdad	FALSE
daacbbcbbabdb	FALSE
daccddddbaaab	FALSE
dacdaaaabbbdc	FALSE
dbbbddccaabcc	FALSE
dbbcaaaadcddd	FALSE
dcaadcaccdcaa	FALSE
dcaaddbbcdbbc	FALSE
dccdccccbddab	FALSE
dccdcdabaabcd	FALSE
ddbbcacdababa	FALSE
ddbbcbdbdaacc	FALSE
adadadadadaddb	TRUE
adadadadadbadb	TRUE
adadccddadcdad	TRUE
adadcdadadadbc	TRUE
adbbbaddadaddb	TRUE
adbbbadddbbcdd	TRUE
adbddcddddbadb	TRUE
adbdddadcbccdc	TRUE
adccbbcadcdadd	TRUE
adccbcdbdccdbc	TRUE
addbadadadadbb	TRUE
addbadadadbbda	TRUE
addddccbbddccc	TRUE
addddccbccdadb	TRUE
badcadcbcdadcc	TRUE
badcadcbdbbcbd	TRUE
bbadbddaddddca	TRUE
bbadbddbadadad	TRUE
bbdadadcdbadda	TRUE
bbdadadddadbda	TRUE
bcbbbcbccadcbd	TRUE
bcbbbcdbdbcbcd	TRUE
bdadbadadcbddc	TRUE
bdadbadbbccdad	TRUE
bdccbadcddbadd	TRUE
bdccbbcbcdbdda	TRUE
cadaddadddcdcc	TRUE
cadaddbbadadad	TRUE
caddbdcadaddad	TRUE
caddbddadadcdc	TRUE
cbcbcbbccadbba	TRUE
cbcbcbdcddcbdc	TRUE
ccadcbdadbadbb	TRUE
ccadcbddbbbbda	TRUE
ccdbcbbcdadbcb	TRUE
ccdbcdccbcdbad	TRUE
cdbddcbcbadadd	TRUE
cdbdddadcdadcb	TRUE
dadadcbaddbadb	TRUE
dadadcbbbcbbda	TRUE
dadcddbcdccada	TRUE
dadcddccbbbdad	TRUE
dbbdadbadadada	TRUE
dbbdadbdcadcdd	TRUE
dcadbadccdadbd	TRUE
dcadbbbdbdbcca	TRUE
dcccddadbcadbc	TRUE
dcccddbcadadad	TRUE
ddbadcddcbbcad	TRUE
ddbadcdddcaddd	TRUE
aaaaaaadbabdba	FALSE
aaaaaabbbbdcac	FALSE
aacdabbcaaacdd	FALSE
aacdacabbdddda	FALSE
abbccbabdabcad	FALSE
abbccccbdbdcaa	FALSE
acaabbcdabcbbb	FALSE
acaabcabcbcaaa	FALSE
accddbcdbdadbc	FALSE
acdaaabcdcbdbb	FALSE
adbbbbddcbcbaa	FALSE
adbbcbbddadbac	FALSE
adddbdbbacbdba	FALSE
adddcbdadadbac	FALSE
bacacdbdcdaaca	FALSE
bacacdcbbbacbc	FALSE
bbabcbbcadcccc	FALSE
bbabcbcdbacdcc	FALSE
bbdaabbbabddbd	FALSE
bbdaabdccadcdd	FALSE
bcbbbcbccabcbd	FALSE
bcbbbcdbdbcbac	FALSE
bdaaddcaacbabd	FALSE
bdaaddccaababd	FALSE
bdccbadcddbabd	FALSE
bdccbbcbcdbdaa	FALSE
caadbbddcbcaab	FALSE
caadccdbdddbcd	FALSE
cadcbddbaadabb	FALSE
cadccaabdcbccc	FALSE
cbcbcbbccabbba	FALSE
cbcbcbdcddcbac	FALSE
ccaccaacbdcbbd	FALSE
ccaccababddbbd	FALSE
ccdbcbbcdabbcb	FALSE
ccdbcdccbcdbab	FALSE
cdbddcbcbaaadd	FALSE
cdbdddaacdaacb	FALSE
daabcacabcccad	FALSE
daabcdcabaaacc	FALSE
dacccaadccbcda	FALSE
dacccacbcbabcc	FALSE
dbbdabcacbddba	FALSE
dbbdabccaabdcc	FALSE
dcaadcacaddbbb	FALSE
dcabaabdbaccbb	FALSE
dcccddacbcacbc	FALSE
dcccddbcaaacaa	FALSE
ddbadabdcdbbca	FALSE
ddbadadcacddcb	FALSE
adadadadadadbcc	TRUE
adadadadadbbcad	TRUE
adadcbcdbdbbcda	TRUE
adadcbdadcadada	TRUE
adbaddadccdbbda	TRUE
adbaddaddadbada	TRUE
adbdbadccccadcd	TRUE
adbdbaddadadcdd	TRUE
adccadadcbaddad	TRUE
adccadbadaddadd	TRUE
addadcadadcbbbb	TRUE
addadcadbadadbb	TRUE
addcddddadbddda	TRUE
adddadadcadcbcd	TRUE
badbcbccaddbdba	TRUE
badbcbcdcbdbbba	TRUE
bbadadaddcbcadb	TRUE
bbadadbadadbddb	TRUE
bbcbdbbadcaddbb	TRUE
bbcbdbcadbccbad	TRUE
bcadccdcadadbda	TRUE
bcadccddcddddbb	TRUE
bcdadcdbadbcdcd	TRUE
bcdaddadadaddcc	TRUE
bdcadadcdbdbcca	TRUE
bdcadbdadccccad	TRUE
cadaddadadbdbdd	TRUE
cadaddadcadcbad	TRUE
caddbbddcadaddd	TRUE
caddbcadcadbcdd	TRUE
cbcaddadcbdcbbc	TRUE
cbcaddbbdcadbda	TRUE
ccadcbcdbdbbcad	TRUE
ccadcbdddbbadad	TRUE
cccdcaddbadcdca	TRUE
cccdcaddcbdcbbd	TRUE
cdbbbcadbdcadcc	TRUE
cdbbbcccdbbbbda	TRUE
dadadadcadcbbbd	TRUE
dadadadcaddcdad	TRUE
dadcccdbddadbcb	TRUE
dadccdadbbbbbdb	TRUE
dbbbdbccadadcbd	TRUE
dbbbdcbaddbcbcb	TRUE
dcadbcadbdbdccc	TRUE
dcadbcaddadcdcd	TRUE
dccdbbbdbccadad	TRUE
dccdbbcdadccada	TRUE
ddbcadadbbccadd	TRUE
ddbcadddadcadad	TRUE
aaaaaabddbdbddd	FALSE
aaaaaacbddcdaba	FALSE
aaccddcbbccdaad	FALSE
aacdaaabccaadbc	FALSE
abbacdabcccabad	FALSE
abbacdbcabdacdb	FALSE
abdcbdcbbcdcada	FALSE
abdccaabbbcaacd	FALSE
accbacbaabdaabc	FALSE
accbacdaaddbccd	FALSE
adacbcbdddbabad	FALSE
adacbdddcbdacab	FALSE
addacaadcaadadb	FALSE
addacbbbabaabac	FALSE
babccccbddddcdc	FALSE
babccccdcbdbdad	FALSE
bbaabdcabcdddca	FALSE
bbaacabbadadada	FALSE
bbcbdbbaacaadbb	FALSE
bbcbdbcaabccbad	FALSE
bcaccccaadcbaca	FALSE
bcaccdabaddcbba	FALSE
bcdaccbbbacbcdc	FALSE
bcdaccbcddbbcca	FALSE
bdcaacbbcacaaad	FALSE
bdcaadadbdbadaa	FALSE
caadaaadbacccda	FALSE
caadabaacadbabc	FALSE
cadbcccccbdccaa	FALSE
cadbcdbdddaccab	FALSE
cbcacccdcdacbdd	FALSE
cbcacdcbcdcbdcc	FALSE
ccabdadadcabdda	FALSE
ccabdbcbaadcbcd	FALSE
cccdcaadbacabcd	FALSE
cccdcacdcbdcbbd	FALSE
cdbbbcacbdcaccc	FALSE
cdbbbcccdbbbbaa	FALSE
daaacaacdcadcba	FALSE
daaacacaacacada	FALSE
dadabaacaabddda	FALSE
dadabaacbdcdbca	FALSE
dbbbdbccaaadcbd	FALSE
dbbbdcbaadbcbcb	FALSE
dcaadddcddcbadc	FALSE
dcabaaabcdbbadb	FALSE
dccdbbbdbccadaa	FALSE
dccdbbcdaaccaaa	FALSE
ddbcaacdacbbcca	FALSE
ddbcabacbdaaacd	FALSE
adadadadadadbcbc	TRUE
adadadadadadcadc	TRUE
adadcbdadadbadad	TRUE
adadcbdadcdcadad	TRUE
adbbadbbadaddcdd	TRUE
adbbadbdaddadbcc	TRUE
adbdccdbcbccdbad	TRUE
adbdcdadbcddddcc	TRUE
adccaddadaddbadd	TRUE
adccaddadbaddadb	TRUE
addbadadadadddad	TRUE
addbadadaddddadd	TRUE
adddbdcadbbbcadd	TRUE
adddbdccbbdadcad	TRUE
badbdcddcbadcadd	TRUE
badbddadadcddddb	TRUE
bbadbaddcdbdbbcc	TRUE
bbadbbaddbcbcddc	TRUE
bbcdbcddadddcdca	TRUE
bbcdcadadadadadc	TRUE
bcbbaddbadddbbdb	TRUE
bcbbbcadbcbcdadd	TRUE
bdadadbdbadddcda	TRUE
bdadadcadbadbbdc	TRUE
bdcbdadaddcbadad	TRUE
bdcbdbcdbdccadbb	TRUE
cadadddcdbadadba	TRUE
cadaddddadadbdad	TRUE
caddcadcdbcadbcb	TRUE
caddcaddbddcadcb	TRUE
cbcadbbbadadbcbd	TRUE
cbcadbcdcddcadbd	TRUE
ccaddbadcaddbbbb	TRUE
ccaddbcbadadadad	TRUE
ccdcadbadccbbada	TRUE
ccdcadbadcdaddad	TRUE
cdcadddbadcadddb	TRUE
cdcaddddadcadcca	TRUE
dadaddbbdcccccdb	TRUE
dadaddbcbadbcbca	TRUE
daddbadbddccadad	TRUE
daddbbadcadbadba	TRUE
dbbddadbadadadba	TRUE
dbbddbccadcdbdba	TRUE
dcadbadcbadcddbd	TRUE
dcadbadcbbadcccd	TRUE
dccdcadbcddcdcbb	TRUE
dccdcbcdaddcbbdb	TRUE
ddbcadbadddbbadc	TRUE
ddbcadbddcddbadd	TRUE
aaaaaadddbbcddaa	FALSE
aaaaabbdcadcbcbc	FALSE
aacccdbabccbacac	FALSE
aaccdacadccdacba	FALSE
abbbcabdbcacdbba	FALSE
abbbcadabdbbcada	FALSE
abddbbcbddccdcdc	FALSE
abddbcbbbbdddbcc	FALSE
accbccaaddcbcaad	FALSE
accbccaccabbcdad	FALSE
adadcabaddaaabac	FALSE
adadcabdbddcadaa	FALSE
addcaccdbbdaaccb	FALSE
addcacdbacdacbca	FALSE
babdabcbcacaaaba	FALSE
babdaddcddabcdbd	FALSE
bbaadccadbddbccd	FALSE
bbabaaabdbacddcc	FALSE
bbcdbcddadddcdaa	FALSE
bbcdcaaaacbabaaa	FALSE
bcbbadbddbddbbaa	FALSE
bcbbbcaabcbcdadd	FALSE
bdaabacddbccdccb	FALSE
bdaabcdcdbcccabb	FALSE
bdcbdadbdccbadaa	FALSE
bdcbdbcdbdccabbb	FALSE
caaccccabcadacac	FALSE
caacccccccabdcca	FALSE
cadcbcaddbbaacad	FALSE
cadcbdcadcaddbaa	FALSE
cbcabdccbaabbcdb	FALSE
cbcacbaaacdbbbad	FALSE
ccadadcadbdcdabd	FALSE
ccadbaccaabbddcc	FALSE
ccdcabacdbaabbac	FALSE
ccdcabbdacbaccaa	FALSE
cdcadaccadaccaad	FALSE
cdcadcbaadcadcca	FALSE
daadadbbadccaabb	FALSE
daadaddbaadbbdaa	FALSE
dadadcbcaabdacbc	FALSE
dadaddbdcaddaacc	FALSE
dbbddadbacacabba	FALSE
dbbddbccadcdbdaa	FALSE
dcabacdcbccbccba	FALSE
dcabadbdccacdccb	FALSE
dccdcabbcddcdcbb	FALSE
dccdcbcdacdcbbdb	FALSE
ddbcacadcddbbadc	FALSE
ddbcacadddcddbaa	FALSE
adadadadadbbcdcad	TRUE
adadadadadcaddcad	TRUE
adadcdbbbdbbadbad	TRUE
adadcdbcadadaddbc	TRUE
adbbcbadcbadbcdcb	TRUE
adbbcbbbbcbadbbad	TRUE
adbddcdadadbaddad	TRUE
adbddcdbadaddcbbb	TRUE
adccdadadcdbadadd	TRUE
adccdadcadadcdbbc	TRUE
addbbdadadadbaddb	TRUE
addbbdadcddcbbbcc	TRUE
addddbbdbadcadadb	TRUE
addddbbdbcbcbcbcd	TRUE
badcbbcadbcadccad	TRUE
badcbbcbbadddadbd	TRUE
bbaddbdbadadbcada	TRUE
bbaddcbcdadbcdadb	TRUE
bbdbdadadcbdddbdb	TRUE
bbdbdbadadbbadcca	TRUE
bcbdbcadadadbbcad	TRUE
bcbdbcbbadccdaddb	TRUE
bdadbcdadbbbddccc	TRUE
bdadbcddbdbcadcbc	TRUE
bddadaddadbcddada	TRUE
bddadbbaddcbbdbad	TRUE
cadbbcbccdbadcbcb	TRUE
cadbbcdadaddccbbb	TRUE
caddcdbdcdadddcad	TRUE
caddcdcbdbbadcbdd	TRUE
cbcadcdcdcbadbdbb	TRUE
cbcaddadcbadbcbad	TRUE
ccadccdadbcadbada	TRUE
ccadcdadadcadadad	TRUE
ccdcadadcadadcadc	TRUE
ccdcadbbbddadbdad	TRUE
cdcadbadadccbaddc	TRUE
cdcadbadbddcccccb	TRUE
dadadbbadccbbbbad	TRUE
dadadbbadcddbadcd	TRUE
dadcdbcadcadbbada	TRUE
dadcdbccadbcdbada	TRUE
dbbbadbcdadadadad	TRUE
dbbbaddadbdadadad	TRUE
dbddadccdbcadadda	TRUE
dbddaddcbadadadbd	TRUE
dccccdadadadcdcdd	TRUE
dccccdcadaddccada	TRUE
ddbbcaddbadaddbca	TRUE
ddbbcbaddcadccbbb	TRUE
aaaaadaddddcabbcb	FALSE
aaaabaadacabcbdcc	FALSE
aacdaccabdaabbacc	FALSE
aacdadaadcdadabdc	FALSE
abbbadccbcbccdaac	FALSE
abbbbaabaacacdada	FALSE
abdccdbcbcbdbccaa	FALSE
abdcdaaadcbaccdbb	FALSE
acccbaccdbcdbdbab	FALSE
acccbbbacdbbaadaa	FALSE
adbadccdcdbbcdcac	FALSE
adbbababbbdddcabb	FALSE
adddcbababbbdabba	FALSE
adddcbacdbadcadbb	FALSE
bacaddabdaddabcbc	FALSE
bacaddbacbcbacabc	FALSE
bbadbaaacccdcacaa	FALSE
bbadbadddcdbabbbc	FALSE
bbdbdaaaccbdddbdb	FALSE
bbdbdbacdaabbadcc	FALSE
bcbdbcadacadbbcad	FALSE
bcbdbcbbaaccdaadb	FALSE
bdabccdbadabbdcbc	FALSE
bdabcdadddcdbaaaa	FALSE
bddaacaabccddbabb	FALSE
bddaacdcdbcdaccdc	FALSE
cabbdcaadcdcdcadd	FALSE
cabbddddcbdcbbbad	FALSE
cadcdcbdbdccbcaca	FALSE
cadcddbacadbaacdb	FALSE
cbcacadbcdcbadbdb	FALSE
cbcacadbdbcdcddba	FALSE
ccadababdcbcabbad	FALSE
ccadabcbdadaaacdc	FALSE
ccdcabaadcaaaacaa	FALSE
ccdcabbcbddbbddab	FALSE
cdcabacaccacddada	FALSE
cdcabacdaacbaadac	FALSE
daabdadccccbcdaaa	FALSE
daabdcdbbdadacada	FALSE
dacdcaabbcabcaabc	FALSE
dacdcabbccbacbabd	FALSE
dbbbabbdcddcdacaa	FALSE
dbbbacaabdadbdaaa	FALSE
dbddadbbcaaaadada	FALSE
dbddadbbdababaabd	FALSE
dccccdacaaaacdcdd	FALSE
dccccdcaaaddccaba	FALSE
ddbbcabdbacabdbca	FALSE
ddbbcbaddcabccbbb	FALSE
adadadadadadadbadc	TRUE
adadadadadadcddbad	TRUE
adadcccadbccadcbdc	TRUE
adadcccadcbdccadbc	TRUE
adbbadbadccdadadcd	TRUE
adbbadbadcdadadadb	TRUE
adbdcbadaddbaddcad	TRUE
adbdcbaddddadadbbd	TRUE
adccadaddcbadbcbcd	TRUE
adccadbadbadbaddcd	TRUE
addadcdadcbdadbada	TRUE
addadcdadcbdadbbad	TRUE
adddaddcaddbadccca	TRUE
adddadddcbadcccbca	TRUE
badbdbbadccbbadccd	TRUE
badbdbcadcbaddcdcc	TRUE
bbadccdcadbadbdbcd	TRUE
bbadcdadadbdbaddad	TRUE
bbdadcdadddcbbadad	TRUE
bbdbadadadbbbcbcca	TRUE
bcbcadccbdcbbdbbdd	TRUE
bcbcaddbcbdadaddad	TRUE
bcddbcaddcadadcadc	TRUE
bcddbdcadbcddadcca	TRUE
bdccccadbadadccadb	TRUE
bdcccdcdbccccdbbad	TRUE
cadbcadadccdbaddbb	TRUE
cadbcadaddccbbdbbd	TRUE
cbadadadcdcadddbad	TRUE
cbadadaddadadadadb	TRUE
cbccdcadddcaddbcca	TRUE
cbccdcbbadcbdddddb	TRUE
ccaddcbdcadbadcbbb	TRUE
ccaddccddcbddcdbbd	TRUE
ccdcadadcdbdbadadd	TRUE
ccdcadbbadcbcdccca	TRUE
cdcbbaddbadadcadda	TRUE
cdcbbbdadbccdbbccb	TRUE
dadbadcddadbbdadad	TRUE
dadbaddaddadbbdddc	TRUE
dadddaddbbcadadccb	TRUE
dadddaddbdadadccbd	TRUE
dbcadbcaddbbbcadca	TRUE
dbcadbdadcbadbbdad	TRUE
dcadcadadadadddadd	TRUE
dcadcadaddadaddbcb	TRUE
dcdadcbbadbcdddadc	TRUE
dcdadcccdadccadadb	TRUE
ddbccadadaddbccadb	TRUE
ddbccadcdcccadadad	TRUE
aaaaaaabdacdbbbaac	FALSE
aaaaabcbbdaaadddbc	FALSE
aacccbdbbaaabbaddd	FALSE
aacccccdbbcacabcda	FALSE
abbbcadddcbbacccbc	FALSE
abbbcbdbbacbdabdcd	FALSE
abdcdcbcbbabcbdaab	FALSE
abdcdcddaacabcccbb	FALSE
accbaddbbdddcaadcb	FALSE
accbadddbdcbacbaca	FALSE
adacbdbdcbcadaacbb	FALSE
adaccaadaddcabccad	FALSE
addadbdddddccccbab	FALSE
addadcccbaccccdbdd	FALSE
bacaacdacbcabbbbab	FALSE
bacabaaadadcadbcab	FALSE
bbacccadddaabacaad	FALSE
bbacccccbdddacdcab	FALSE
bbdaddbadddcbbadac	FALSE
bbdbaaaabaaaccdbdc	FALSE
bcbcadacbdcbbdbbdd	FALSE
bcbcaddbcbdabaddac	FALSE
bcddbcaddcaaaacacc	FALSE
bcddbdcabbcddadcca	FALSE
bdccccaabadabccadb	FALSE
bdcccdcdbccccdbbac	FALSE
cabadcccadbbbcbbbc	FALSE
cabbaaacacabcbbbcd	FALSE
cbaaadaabcbbdbbdbd	FALSE
cbaaaddaacdacddbab	FALSE
cbccdcabddcabdbcca	FALSE
cbccdcbbabcbdddddb	FALSE
ccaddabdccaabaccbb	FALSE
ccaddbcdcbddcdbbab	FALSE
ccdcaacabacdbcdbdb	FALSE
ccdcaadcacdabbcacc	FALSE
cdcbbadccacadcacda	FALSE
cdcbbbdaabccdbbccb	FALSE
dabaacbbdcbcbbbadc	FALSE
dabaaccacbbdaadbbb	FALSE
dadccabcadbbaabadd	FALSE
dadccabcdbcabbcbbb	FALSE
dbcabdabaaadaccdcb	FALSE
dbcabdbadbacccccad	FALSE
dcabcddcdcdccbdacd	FALSE
dcabdbbdcabadbcaac	FALSE
dcdadbabacbcdddadc	FALSE
dcdadbdcdacccaaacb	FALSE
ddbccaacacacdbccad	FALSE
ddbccaadadcccadaba	FALSE
adadadadaddadadbcdd	TRUE
adadadadbadbcdccadc	TRUE
adadcdbadadbbadccad	TRUE
adadcdbadbadaddbbad	TRUE
adbbbcccaddccadadad	TRUE
adbbbccccbcddbadccc	TRUE
adbddccdaddbcadcbbb	TRUE
adbddcdadadcdcadadd	TRUE
adcccccccadcddadbad	TRUE
adcccdadadccccdadbd	TRUE
addbadbbcccbbcbbadc	TRUE
addbadbcadddbbdbdcd	TRUE
adddbdadaddcbbbdadc	TRUE
adddbdaddadcbdaddad	TRUE
badbdcdcadbbadccdba	TRUE
badbddadbdcadbbbcba	TRUE
bbadadaddbbadcaddcd	TRUE
bbadadbadddccbdbada	TRUE
bbccdbbaddcadbbcada	TRUE
bbccdbbcbccdccadada	TRUE
bcbadccbcbaddcdaddb	TRUE
bcbadccddccddbdbbbb	TRUE
bcddaddcbcbdddadcad	TRUE
bcddadddbadcdaddadb	TRUE
bdcadddbadbadbbadad	TRUE
bdcbadbadadbaddbddc	TRUE
cadbbbdccccadbbadad	TRUE
cadbbbddadadadcbadc	TRUE
cadddadcaddadcadadc	TRUE
cadddadcdadbadaddbb	TRUE
cbcbdadcadadcbdcddc	TRUE
cbcbdaddadcddadddad	TRUE
ccaddcadccddcdbbbbc	TRUE
ccaddcadcddaddaddda	TRUE
ccdbadadcadadddccad	TRUE
ccdbadadcadbbdbbadc	TRUE
cdbcdbddddbadbdcbad	TRUE
cdbdadadbadcadbdadb	TRUE
dadadbcadcdaddbbbad	TRUE
dadadbcadcdbbcdadbb	TRUE
daddadbbaddadddadad	TRUE
daddadbcdbcbaddbbda	TRUE
dbbddbcccddbddbdbcb	TRUE
dbbddcdcdadbbcadbad	TRUE
dcadbdcdddbaddbccbd	TRUE
dcadcadcaddcbadbbbc	TRUE
dccdadbbbdadbbadada	TRUE
dccdbaddddcbadbdadb	TRUE
ddbbcdcadbadaddbcbb	TRUE
ddbbdbadccbbbaddada	TRUE
aaaaaabcdcbbbadcadc	FALSE
aaaaabddccdbadcbaac	FALSE
aacccacbcbabbdbadab	FALSE
aacccbabcbddcdacdda	FALSE
abbbbcacccbbbcbabaa	FALSE
abbbbcdbaacdbaabcda	FALSE
abdccadddbbacbcccba	FALSE
abdcccbbdacbcbacdab	FALSE
accacddacaadaaaabdd	FALSE
accadacabbbbdbacaca	FALSE
adaddbbbacadaacbdcc	FALSE
adaddbbdbdcbcccadac	FALSE
addbbbbbdacacabccab	FALSE
addbbbcdcbcccabaccc	FALSE
babdadaddcccbbbaaba	FALSE
babdbcdcadcadacdcdc	FALSE
bbaababccbdabdcbcbc	FALSE
bbaabadbcabbbacbdca	FALSE
bbccdbbaddcacbbcaca	FALSE
bbccdbbcbccdccadaba	FALSE
bcbabbdbaccbcdabbcb	FALSE
bcbabcacbbbdddccddb	FALSE
bcddabddacddbcbddda	FALSE
bcddacbbdccaacdadda	FALSE
bdcadddbacbaabbabad	FALSE
bdcbababbacbaabacdb	FALSE
caaddbadbadccbbdbaa	FALSE
caadddaaacbabcbccac	FALSE
cadcddabbabbdbcbdca	FALSE
cadcdddbadddddabddc	FALSE
cbcbdaacdababcbdcdd	FALSE
cbcbdabaaacddabddac	FALSE
ccadcaacbabacabcdcd	FALSE
ccadcacadcbbdbbdabd	FALSE
ccdbacbadaaccabbabd	FALSE
ccdbadbdbbddbdbbacc	FALSE
cdbcdbddddbabbdcbad	FALSE
cdbdaaacbcccabdcabb	FALSE
daabcaabbbbdbacdbab	FALSE
daabcbabdbbcbdbcbbb	FALSE
dadaacccdaadcaabbaa	FALSE
dadaadadbcadcadadbb	FALSE
dbbddbcccddbddbdbab	FALSE
dbbddcdcdaabbcadbad	FALSE
dcabcbbbddbddddbbbd	FALSE
dcabcdacbdacdbbbdbc	FALSE
dccdadbbbdacbbacada	FALSE
dccdbabdddcbaabdadb	FALSE
ddbbcdcaababaddbcbb	FALSE
ddbbdbadccbbbacdada	FALSE
