abbbbbbbcc	TRUE
abbbbbbbdd	TRUE
abcccbbbcb	TRUE
abcccbbcdb	TRUE
abddcccdcc	TRUE
abddccdbcb	TRUE
accbdddcdb	TRUE
acccbbbbbb	TRUE
adbbbbbccd	TRUE
adbbbbbcdd	TRUE
adccbbcbdb	TRUE
adccbbcccc	TRUE
adddccbccd	TRUE
adddcccbdd	TRUE
bacdcbbdcc	TRUE
bacdcbcccb	TRUE
bbadbdcccb	TRUE
bbadcbbdbb	TRUE
bbdcadcbdb	TRUE
bbdcadccbc	TRUE
bccabccdbd	TRUE
bccabddcbc	TRUE
bdaccbbbdd	TRUE
bdaccbcbbb	TRUE
bdcdadbbbb	TRUE
bdcdadcccd	TRUE
cacbbcdccb	TRUE
cacbbcddcd	TRUE
cbabdcddcd	TRUE
cbabddbbdc	TRUE
cbcdddcacd	TRUE
cbdabbbbcb	TRUE
ccbdabbdbd	TRUE
ccbdabddcc	TRUE
cdabcdbccb	TRUE
cdabcdbccc	TRUE
cdccabddcd	TRUE
cdccaccbcd	TRUE
dabdbddcbd	TRUE
dabdcbbdbc	TRUE
dadcddbbbd	TRUE
dadcddcbdc	TRUE
dbbdcbbdba	TRUE
dbbdcdbcca	TRUE
dcabcbbccc	TRUE
dcabcbbdcb	TRUE
dcccabbcbb	TRUE
dcccabcdbb	TRUE
ddbbaccddb	TRUE
ddbbacdcbc	TRUE
aaaaaaddad	FALSE
aaaaabaabd	FALSE
aacccaaacb	FALSE
aacccabdca	FALSE
abadcbcbac	FALSE
abadccbcdc	FALSE
abdcabccca	FALSE
abdcabcdab	FALSE
accbbadbbc	FALSE
accbbbbdad	FALSE
adbacbbcaa	FALSE
adbaccaadd	FALSE
adddadabbb	FALSE
adddadbcab	FALSE
bacbbbcdba	FALSE
bacbbcbacd	FALSE
bbadaaabbb	FALSE
bbadaccbbd	FALSE
bbdcadbbad	FALSE
bbdcadcabc	FALSE
bccaabbbda	FALSE
bccabacdad	FALSE
bdabcdbabc	FALSE
bdabcdcbba	FALSE
bdcdadbaaa	FALSE
bdcdadcbca	FALSE
cabbcbdbac	FALSE
cabbdaabac	FALSE
cbabaccdad	FALSE
cbabbaaaac	FALSE
cbcdddcaca	FALSE
cbdaaaabca	FALSE
ccbdaabdbd	FALSE
ccbdaaddcb	FALSE
cdaadadcca	FALSE
cdababaaaa	FALSE
cdccabddca	FALSE
cdccaccabc	FALSE
dabababaad	FALSE
dabababcba	FALSE
dadbcdddda	FALSE
dadbdbbdba	FALSE
dbbdcbbdaa	FALSE
dbbdcdbcaa	FALSE
dcaabcbacd	FALSE
dcaacbaaab	FALSE
dcccaaadbb	FALSE
dcccaabada	FALSE
ddbbacadac	FALSE
ddbbaccaba	FALSE
abbbbbbbccb	TRUE
abbbbbbbddb	TRUE
abccbcdddcc	TRUE
abccbdbcccb	TRUE
abddcbdcccd	TRUE
abddcbdcdbb	TRUE
acccbcdcbbb	TRUE
acccbcdcccb	TRUE
adbbbbcdcbb	TRUE
adbbbcbdcbb	TRUE
adcbddddbcc	TRUE
adcbddddbdc	TRUE
adddcddbdbd	TRUE
addddbbbbdd	TRUE
baccddbbdbd	TRUE
baccddbbdbd	TRUE
bbbadcdcbdc	TRUE
bbbaddccbcb	TRUE
bbdccaccccd	TRUE
bbdcdbcddab	TRUE
bccaddbdbdd	TRUE
bccaddbddbb	TRUE
bdaccddbcbc	TRUE
bdacdbcbbbb	TRUE
bdcdbabccdc	TRUE
bdcdbbbadbc	TRUE
cacbbcddcbd	TRUE
cacbbdbdcdc	TRUE
caddddbdccb	TRUE
caddddcbbbb	TRUE
cbccbbbbdab	TRUE
cbccbbdcdad	TRUE
ccbbbbabddb	TRUE
ccbbbbbcbab	TRUE
ccddcadcddd	TRUE
ccddcbacddb	TRUE
cdcbbdddddd	TRUE
cdcbcabbddb	TRUE
dabddcbdccb	TRUE
dabddcbdddd	TRUE
dadcdbdccdb	TRUE
dadcdcbddcb	TRUE
dbcabdcdccb	TRUE
dbcabdddcdd	TRUE
dcaccdcbdcd	TRUE
dcacdbbccdd	TRUE
dcdacdbcbcb	TRUE
dcdacddbddd	TRUE
ddbcbbdbddd	TRUE
ddbcbcabcbb	TRUE
aaaaaacbdaa	FALSE
aaaaaacbdda	FALSE
aaccababddb	FALSE
aaccabbddda	FALSE
abbabaacaaa	FALSE
abbababbbca	FALSE
abdbbbbddab	FALSE
abdbbcabcca	FALSE
accacbcbadb	FALSE
accacbdbbab	FALSE
adaaddcadad	FALSE
adaaddcddbb	FALSE
adccbbabdcb	FALSE
adccbbddaca	FALSE
babaabcbdac	FALSE
babaabcddad	FALSE
badacdcadcc	FALSE
badadaacdcb	FALSE
bbbdacabcaa	FALSE
bbbdacdccba	FALSE
bcabbabdbdd	FALSE
bcabbbaacbc	FALSE
bccdddbdcaa	FALSE
bccdddccaca	FALSE
bdbbcbdccaa	FALSE
bdbbcbddbaa	FALSE
bddddbbadda	FALSE
caaaacaddad	FALSE
cacbdbcaadb	FALSE
cacbdcacacd	FALSE
cbaddacbcac	FALSE
cbaddaccabd	FALSE
cbdcdaaaadd	FALSE
cbdcdcaadad	FALSE
cccbbdcbcaa	FALSE
cccbcabbbca	FALSE
cdadbcdaccc	FALSE
cdadcdabaaa	FALSE
cddbbacdbba	FALSE
cddbbadcabd	FALSE
dacaabcbccd	FALSE
dacaadbdccb	FALSE
dbadbbccbca	FALSE
dbadbcddcba	FALSE
dbddaccdcda	FALSE
dbddbaccaba	FALSE
dccdaaddbbd	FALSE
dccdabbddba	FALSE
ddbbcabacbb	FALSE
ddbbcbdbcaa	FALSE
abbbbbbcdbbc	TRUE
abbbbbccbbcd	TRUE
abccbdbdcddd	TRUE
abccbdbddddc	TRUE
abdddbbcdbcc	TRUE
abdddbdbbcdb	TRUE
accbccbcccbb	TRUE
accbcccbbccd	TRUE
acdcbcdcdddc	TRUE
acdcbdbccdcb	TRUE
adbdcdcdddcb	TRUE
adbdcddbccdd	TRUE
addbdbdcdbdc	TRUE
addbdcbbbbcb	TRUE
babcdddddbcb	TRUE
babdbbbbbbcd	TRUE
badccbdbccbb	TRUE
badccbdcbcbc	TRUE
bbbccdcdaddc	TRUE
bbbcdbabddbd	TRUE
bcacbcbdbcbd	TRUE
bcacbccddbbd	TRUE
bccdcdbbacdd	TRUE
bccdcdbbbddb	TRUE
bdbbddcacbbb	TRUE
bdbcabcbcbcd	TRUE
bdddddcabcdc	TRUE
cabbbbcbcbbb	TRUE
cadbbbddbbbb	TRUE
cadbbbddcbdc	TRUE
cbbadddbcbbd	TRUE
cbbadddddddc	TRUE
cbdccbdbccad	TRUE
cbdccdccabdc	TRUE
cccbccaccdcc	TRUE
cccbccccaddb	TRUE
cdadddcddbbc	TRUE
cdbabbbbcddc	TRUE
cddbdacddddb	TRUE
cddbdadbbcbb	TRUE
daccbbccbcbb	TRUE
daccbbcdbcbb	TRUE
dbacdbcdccdd	TRUE
dbacdbdcdccd	TRUE
dbdbdccabbbd	TRUE
dbdcabccdddd	TRUE
dccbbdabdccb	TRUE
dccbbdadcbcc	TRUE
ddbabddbbbbd	TRUE
ddbacbbbcccd	TRUE
aaaaaacbdaad	FALSE
aaaaaacbddcc	FALSE
aaccacdaadbc	FALSE
aaccadcaacdd	FALSE
abaddcbcdcdd	FALSE
abaddcccdddd	FALSE
abdbdacbbbac	FALSE
abdbdcadddad	FALSE
acbdbadabbcc	FALSE
acbdbadacddc	FALSE
adabbadabaac	FALSE
adabbbccacac	FALSE
adcbdcdcadab	FALSE
adcbddacdcda	FALSE
baadccbbaddc	FALSE
baadccbdcaba	FALSE
badadbdaacdb	FALSE
badadcbbdadb	FALSE
bbbccdcdacda	FALSE
bbbcdbaacdad	FALSE
bcabcbdacdcb	FALSE
bcabdaadabab	FALSE
bccdcdbbacca	FALSE
bccdcdbbbdaa	FALSE
bdbbddcababa	FALSE
bdbcabcabacd	FALSE
bdddddcaacdb	FALSE
caaaabccbabb	FALSE
cacdbaddbbdd	FALSE
cacdbccbbdda	FALSE
cbbadcacccca	FALSE
cbbaddacdddc	FALSE
cbdccbdbccaa	FALSE
cbdccdccabda	FALSE
cccbccacbdca	FALSE
cccbccccadda	FALSE
cdaddcddcabb	FALSE
cdbaaadcabdd	FALSE
cddbdacadcab	FALSE
cddbdaccacaa	FALSE
dabcddaaccab	FALSE
dabdaacccdac	FALSE
dbacaddaccdd	FALSE
dbacbacbdcdc	FALSE
dbdbdccabaad	FALSE
dbdcabccddca	FALSE
dccbbdaadbca	FALSE
dccbbdadcacb	FALSE
ddbabaadcadc	FALSE
ddbabacacabb	FALSE
abbbbbbcdbbcb	TRUE
abbbbbcbbcdcc	TRUE
abccbdcbbbbbb	TRUE
abccbdcbddccd	TRUE
abdddbdbcddcb	TRUE
abdddbdbdbdbb	TRUE
accbcbccdddbb	TRUE
accbcbdbbcbdd	TRUE
acdccbbddbccd	TRUE
acdccbcbbbdcb	TRUE
adbdcdbdcbdcd	TRUE
adbdcdbddcbcb	TRUE
addbcccdddcdd	TRUE
addbccdcdccbb	TRUE
babdccdbcdccc	TRUE
babdcddbdcdcd	TRUE
baddcbdddcddb	TRUE
baddccccdbccc	TRUE
bbcabddbbdddd	TRUE
bbcacbdcbbdbb	TRUE
bcaccddcdbccc	TRUE
bcacdbbccdddb	TRUE
bccddddaccddd	TRUE
bccddddaddccd	TRUE
bdbbadbdbdcbc	TRUE
bdbbaddcdbddd	TRUE
bddddbccddbdb	TRUE
cabbbbbbdbdcb	TRUE
cacdddbdbdccb	TRUE
cacdddbdccdcb	TRUE
cbbbaddbdcbbc	TRUE
cbbbadddbddcc	TRUE
cbdcdcacddddc	TRUE
cbdcdcdaccdcb	TRUE
cccaddddcdcdd	TRUE
cccbabbcdcccc	TRUE
cdadbdbcddddc	TRUE
cdadbdcccddbc	TRUE
cddbaddddcdbd	TRUE
cddbbcacbccbd	TRUE
daccdbbccddbc	TRUE
daccdbccbdbdb	TRUE
dbadccbbcbcbd	TRUE
dbadccbdcddcc	TRUE
dbddbcabcdbdc	TRUE
dbddbcdbcbbdc	TRUE
dccccabbbbdbd	TRUE
dccccabbcdcbc	TRUE
ddbbaddbbccbc	TRUE
ddbbbacbbdbbb	TRUE
aaaaaaabdcbac	FALSE
aaaaaabdabdba	FALSE
aacabdddbbbda	FALSE
aacacadbddbca	FALSE
abacaccaadccd	FALSE
abacadbbabada	FALSE
abdbcbcacbacd	FALSE
abdbcbcdcbdda	FALSE
accadaaacadcc	FALSE
accadbadbdbcc	FALSE
adbadcbacaaaa	FALSE
adbadcddbcaaa	FALSE
adddcacabcacd	FALSE
adddcadbddaba	FALSE
bacacdadaadcc	FALSE
bacacddabacda	FALSE
bbbabaabdbacc	FALSE
bbbabbbbdcbab	FALSE
bbddcddadbbda	FALSE
bbdddcbcdabba	FALSE
bccbacadccacd	FALSE
bccbaccaaddbd	FALSE
bdbaacdacddbd	FALSE
bdbaadaabbcda	FALSE
bdddaacbddbdd	FALSE
bdddaaccaaaab	FALSE
cacbbbbccbacc	FALSE
cacbcadcabdbb	FALSE
cbaddcaadbdcb	FALSE
cbbaabadbccad	FALSE
cbdbdcbbbacda	FALSE
cbdcaabdbaaba	FALSE
cccadabbcbcbc	FALSE
cccadaccbcdcb	FALSE
cdabccacdbdcc	FALSE
cdabcccbdcdca	FALSE
cdcdddbaaabcc	FALSE
cddaaaabbddca	FALSE
dabbcccbbacdc	FALSE
dabbcccdcaddc	FALSE
daddadccadcda	FALSE
daddadcdbcdca	FALSE
dbcabdbdadcad	FALSE
dbcabdcaadcba	FALSE
dcadbdbadcdac	FALSE
dcadbdcddbdca	FALSE
dcdacbbddbaab	FALSE
dcdacbdcadcbd	FALSE
ddbccbddbcaca	FALSE
ddbccbddddaca	FALSE
abbbbbbbcbbcbb	TRUE
abbbbbbbdbcccb	TRUE
abcbdccbdbbbcc	TRUE
abcbdcdcbdbddb	TRUE
abdcdbdcbdcdbb	TRUE
abdcdbdcbddbcd	TRUE
accbbdcbddccdc	TRUE
accbbddcdbdbcb	TRUE
acddbdddddddcd	TRUE
acddcbcbddcbcb	TRUE
adccbbdbdbddcc	TRUE
adccbbddbbbdbb	TRUE
addddcdbdbcddb	TRUE
addddcddccddbc	TRUE
bacdcccbcbbdcb	TRUE
bacdcccbccdddd	TRUE
bbbbbadbdcbbdd	TRUE
bbbbbbbbcdcadd	TRUE
bcabbbcdbcccbc	TRUE
bcabbccbcdccbb	TRUE
bccccabdcdbcdb	TRUE
bccccacbdbcddc	TRUE
bdbabbdcccdbcd	TRUE
bdbabbdcccddbc	TRUE
bddccdccadbbbd	TRUE
bddccdccccdbad	TRUE
caccdbbdccbddd	TRUE
caccdbcbcdbcbd	TRUE
cbacdbdcbbbccd	TRUE
cbacdbdcbdbcdb	TRUE
cbdabcbcbbbddc	TRUE
cbdabcbcdcddcb	TRUE
ccbbcbcabdccbd	TRUE
ccbbccabcbdbdb	TRUE
cdabbcdbbdbcdb	TRUE
cdabbcdbdcbbbd	TRUE
cdcbdcabcbbbdc	TRUE
cdccabdcbdbdbc	TRUE
dabdccdddcdccc	TRUE
dabdcdbcdbbcbb	TRUE
dadcdcbdcdddbc	TRUE
dadcdccbbbcdbc	TRUE
dbbdddadbccddd	TRUE
dbcabbcdcccddb	TRUE
dcacdcbbdcbbcb	TRUE
dcacdcbcbcdbcd	TRUE
dcdbacddbdbcbd	TRUE
dcdbbadbdbcbcd	TRUE
ddbcbdadbbbcbc	TRUE
ddbcbdbcddadcb	TRUE
aaaaabbacbbacc	FALSE
aaaaabbbdadbcc	FALSE
aacbbdddbcbbbb	FALSE
aacbcadacaaddb	FALSE
abadadbaaaddaa	FALSE
abadadbdacccba	FALSE
abdbccbbaadadc	FALSE
abdbcddbaadcca	FALSE
acbddbabadcbbc	FALSE
acbddbbcadaaab	FALSE
adacbbccbadacd	FALSE
adacbdaddcdbab	FALSE
addbdbcbcccdca	FALSE
addbdccddcddda	FALSE
bacaaacadcaddb	FALSE
bacaabbbbdcdcd	FALSE
bbaccdbbccdcba	FALSE
bbaccddbdbbdba	FALSE
bbdbbccbaadcca	FALSE
bbdbbcdbaadbcb	FALSE
bccaaacaabbddb	FALSE
bccaacabbbcdac	FALSE
bdacadccadbbad	FALSE
bdacadccbbdbbc	FALSE
bddbbbadacbdda	FALSE
bddbbbbcabcadb	FALSE
cabcbcbbacabdb	FALSE
cabcbcbbacbcda	FALSE
cbaacadabcdbdc	FALSE
cbaacbaacacbbd	FALSE
cbccacacaaddbd	FALSE
cbccacbcdbcdda	FALSE
ccbabccabcbabc	FALSE
ccbabcdcadddac	FALSE
ccdcbbcbdcddaa	FALSE
ccdcbbdbdbbcaa	FALSE
cdccacdbbcadaa	FALSE
cdccadbacdcdcb	FALSE
daadcbcaaabbda	FALSE
daadcdbbaadaac	FALSE
dadcabacaabbad	FALSE
dadcabadabccbd	FALSE
dbbdaaaddcdabb	FALSE
dbbdaabddccaad	FALSE
dcacaccccabaad	FALSE
dcacadbccbaddb	FALSE
dccdddaaaacabd	FALSE
dccdddbbddcbaa	FALSE
ddbcbcdbcbaaac	FALSE
ddbcbdaaadcbba	FALSE
abbbbbbdbbbcddd	TRUE
abbbbbbdbdcdbbb	TRUE
abccbdcdbcbbbdb	TRUE
abcccbbccddbcbc	TRUE
abdddbcdbccdddc	TRUE
abdddbdbdcbccbc	TRUE
accbdcdddddddbc	TRUE
accbddbbcdbcccb	TRUE
acdcdccccbbbcdd	TRUE
acdcdccccbcbbcb	TRUE
adcbcbcbbbcbbcd	TRUE
adcbcbddbcdcccd	TRUE
addcddbbbdbdccb	TRUE
addcddcbcbdbbdd	TRUE
baccbdddcbbbdcb	TRUE
bacccbbccdcdccb	TRUE
bbaccdcdbcdbbdb	TRUE
bbacdbbbdbbddcb	TRUE
bbdbadbcccbdcbb	TRUE
bbdbadcbbcdcdcd	TRUE
bcbcacddcbbbcdb	TRUE
bcbcadccbcbcccb	TRUE
bdabdbdcccbcbdc	TRUE
bdabdbdcdbbcddb	TRUE
bddadbcbbcbbbcc	TRUE
bddadbcbcbdccbb	TRUE
cacbddcdbbdbccb	TRUE
cacbddcdcbccbdd	TRUE
cbabbccdcddcddb	TRUE
cbabbcdccdcbdcc	TRUE
cbcccccabbbbdcd	TRUE
cbcccccaccbccdb	TRUE
ccbaccbdbdbcbcb	TRUE
ccbaccccddcbbbc	TRUE
ccdcdbdbbddcdcb	TRUE
ccdcdcacddddcbb	TRUE
cdcbabcbdbbbccd	TRUE
cdcbabccdddbcdd	TRUE
dabcdcbddcbbccc	TRUE
dabcdcdcdbccdcd	TRUE
dadcdbbdbbdccdc	TRUE
dadcdbccbdcdbbc	TRUE
dbbcdddabccdddb	TRUE
dbbcdddbcccabdd	TRUE
dcabdcbbccbbdbb	TRUE
dcacbbbbcdcdbdb	TRUE
dcccdbbdbacbbbb	TRUE
dcccdbcaddbbccc	TRUE
ddbbabbccbdcddc	TRUE
ddbbabcdbcdbdbc	TRUE
aaaaaadabbddbbd	FALSE
aaaaabcdcaddbaa	FALSE
aaccaabdadcdccd	FALSE
aaccabdcadbcccb	FALSE
abbadbabaabdbca	FALSE
abbadbabbbcdcad	FALSE
acaaabcdbaaadbd	FALSE
acaaacadacadbbb	FALSE
acccdabccdaabba	FALSE
acccdcaadaacaaa	FALSE
adbadcddccdabcb	FALSE
adbaddcbdacbdba	FALSE
adddccddabdddbb	FALSE
addddababacacad	FALSE
baccaadcbcccada	FALSE
baccabadcbbbacb	FALSE
bbbadcbdabaccbc	FALSE
bbbadcbdcbabadb	FALSE
bbdcbbdcacdbbab	FALSE
bbdcbdbdbadcabb	FALSE
bcbddcdddabddda	FALSE
bcbdddccdaccdda	FALSE
bdacbbbccdacdac	FALSE
bdacbcaacbccabb	FALSE
bddacbbcaabbcdd	FALSE
bddacccbcccbbca	FALSE
cabcdabaccdcbca	FALSE
cabcdadacbacccb	FALSE
cbabacaabdbccdb	FALSE
cbabaccaaddcbbc	FALSE
cbcdbaaaadaabdd	FALSE
cbcdbdddbbcddaa	FALSE
ccbbddaaaabbabd	FALSE
ccbbddaddddccca	FALSE
ccddbcdcaacbbdb	FALSE
ccddbcddadddbba	FALSE
cdcacdcabcccddc	FALSE
cdcadbbcccacaba	FALSE
daadabbbdcdddac	FALSE
daadacbccaadbad	FALSE
dadabbcadcbbdca	FALSE
dadabcbabccbccb	FALSE
dbbdcccbbdbdaaa	FALSE
dbbdcddbaacdaaa	FALSE
dcabbcbcadbbdbd	FALSE
dcabbcdabccbbaa	FALSE
dcdabacbbbacadb	FALSE
dcdabaddbddbaaa	FALSE
ddbcbbbbacbdbda	FALSE
ddbcbdaadabacba	FALSE
abbbbbccbbbbdccb	TRUE
abbbbbcdccdbcccd	TRUE
abccbddbccbdddcc	TRUE
abccbddccdbcdccb	TRUE
abddcbdbddcdbcdb	TRUE
abddccbbbbcdbbbc	TRUE
accccdbcdbcdbdcd	TRUE
accccdbdcbcbcbcc	TRUE
adbbbcbbccbbdccd	TRUE
adbbbcbdcbbccbdc	TRUE
adccbccdbbbdddbd	TRUE
adccbcdccbdbddbd	TRUE
addddccbdbccccbb	TRUE
addddccdcdcccbbc	TRUE
bacdcccdbdbbcdcb	TRUE
bacdccddcdbcdbcd	TRUE
bbbabcdbdccbdbbd	TRUE
bbbabdbdbddbcdbb	TRUE
bbdccbbbcbbbadcc	TRUE
bbdcccbabddcdcdc	TRUE
bccadbbcbcbdddcd	TRUE
bccadbbdbcdbbcbb	TRUE
bdadbbbbbbcdbcdc	TRUE
bdadbbbdbbccdccd	TRUE
bddadccddccbddbc	TRUE
bddadcdbcdcdcdcc	TRUE
cacccccbbbccbdbc	TRUE
caccccdcbccdcbbd	TRUE
cbacdcccbbdbcccd	TRUE
cbacddbcbcbcdbdb	TRUE
cbcddbcbbddbaccc	TRUE
cbcddcbcdcabbddd	TRUE
ccbbbdcadcdbdbbd	TRUE
ccbbcabbddcdbbcc	TRUE
ccdccacbdbdddcbc	TRUE
ccdccaccdbbdbdcb	TRUE
cdcadddddbcbcddb	TRUE
cdcbacbbbddbdbdb	TRUE
dabccddbbcdcbdcd	TRUE
dabccddbccbcbcdd	TRUE
dadcbbddddcdbcdb	TRUE
dadcbcbbcdbcbcdd	TRUE
dbbdcadbcbccdcbd	TRUE
dbbdcbabbbcdbbdd	TRUE
dcabccdbdcddbccd	TRUE
dcabccdcbcbcbbdc	TRUE
dccdcbdaccdcdccc	TRUE
dccdcbdccddcaccd	TRUE
ddbcabdbbcdcbccc	TRUE
ddbcabdbdcddddcb	TRUE
aaaaaabcbbcaaabb	FALSE
aaaaabbbdbbbbcdb	FALSE
aacccabaddcdadcc	FALSE
aacccabdbadbaabc	FALSE
abaddbadabdbdbbb	FALSE
abaddccdbcbccbdc	FALSE
abdbcbadbdabcbbb	FALSE
abdbcbbbabbbbacd	FALSE
accbaaccabcdbcdd	FALSE
accbabaadcdcdbda	FALSE
adadbcaabcdbbabd	FALSE
adadbcbddbbaacdd	FALSE
addcaccdcbaddaac	FALSE
addcbaaabbabbacc	FALSE
bacadbccadcabdbc	FALSE
bacaddcabbabcdaa	FALSE
bbacbddbdcdcccca	FALSE
bbacbddcbabcbbbc	FALSE
bbdacadcdaadaabb	FALSE
bbdacbcddabacdac	FALSE
bcbcbdddbdbabdba	FALSE
bcbccaaabaadcadd	FALSE
bdaadaccbbbbcaac	FALSE
bdaadbbdcdacbbcb	FALSE
bdcccabbabddbdda	FALSE
bdcccbcacabdbccc	FALSE
cabbbcdcabacbddb	FALSE
cabbbdadacacadcb	FALSE
cbabbbdbadaacabc	FALSE
cbabbcbadbcdddad	FALSE
cbdbbbdddcccabba	FALSE
cbdbbdcaabbcdbab	FALSE
ccbccdaaaaabaadd	FALSE
ccbccdadbcbdabdc	FALSE
ccdddddbbabdbaaa	FALSE
cdaaaaaaccdcadbd	FALSE
cdcbcdbabdcdbdda	FALSE
cdcbcdbbdadaabdd	FALSE
dabbabbabddbdcca	FALSE
dabbacabaabdbadd	FALSE
daddccabaadbaccb	FALSE
daddcdcbdadadbbc	FALSE
dbcbaaadcdcaccdb	FALSE
dbcbaabbbbadabca	FALSE
dcacbdbbabdaddac	FALSE
dcacbdcbaabacddb	FALSE
dcdabcccbccaddbb	FALSE
dcdacbaadadbabdc	FALSE
ddbcbcadaddbaada	FALSE
ddbccadbbbdddbaa	FALSE
abbbbbbbbcdddbddb	TRUE
abbbbbcbbbccdbcbc	TRUE
abccbddbbddcdddbd	TRUE
abcccbbbbcdbcbdbc	TRUE
abdddccddbdbbddcc	TRUE
abdddcdbbdcccdbbd	TRUE
accbcbcddddcbcccc	TRUE
accbccbccdcbdbddc	TRUE
acdcddcbdbbddbdbd	TRUE
acdcdddcdbbcbdbbb	TRUE
adcbccddccdcdbcdc	TRUE
adcbcdbbdbcdccdcb	TRUE
adddcccccbcccddcc	TRUE
adddccdbddbbccbcb	TRUE
bacccccbcddbdcbdc	TRUE
bacccccbdcddbdddd	TRUE
bbacbbbddbbbcbbcd	TRUE
bbacbbdbdbcbddbcb	TRUE
bbdabdcbcccdbcccd	TRUE
bbdabdcddcdbdbcbb	TRUE
bcbdacdbdbdcbbddd	TRUE
bcbdacddddccbcdbc	TRUE
bdabdcdcbdbcbdccd	TRUE
bdabddcdbbccbccdb	TRUE
bddabbbddbbbbccdc	TRUE
bddabbccdcbbcbdbb	TRUE
cabdddbddbdbbcdbb	TRUE
cabdddccbdbcbbdbd	TRUE
caddddbcddcbccdbb	TRUE
caddddcbcdbbdbbbb	TRUE
cbccbaccbccddbbbc	TRUE
cbccbacddbbdcbbbd	TRUE
ccaddbdbddbbbdcbb	TRUE
ccaddbdcbccdcddcb	TRUE
ccddacbcdbcdbdbbd	TRUE
ccddbbbdaccbdbcdd	TRUE
cdcbddddabbdbccdb	TRUE
cdccabcddbdcdcbbc	TRUE
dabdcbcdccbdbdbcd	TRUE
dabdcdbcbccdccbbd	TRUE
daddcdbbbcddcbddc	TRUE
daddcdbcddddccbdd	TRUE
dbcbcddbdabbdcdbd	TRUE
dbcbdabcbbcbdbcdd	TRUE
dcaddccbccbdddbcd	TRUE
dcaddcccccddddddc	TRUE
dcdcacbdccdcccbcb	TRUE
dcdcacbdddbddbccb	TRUE
ddbcdcadbccddcccd	TRUE
ddbcdcdbdbcddbbab	TRUE
aaaaaaaccadadcdac	FALSE
aaaaacaadbcbabaac	FALSE
aaccdbbaacdbabbac	FALSE
aaccdbbdbcbaadbac	FALSE
abbadabcddbdddddd	FALSE
abbadacaccdcacbbc	FALSE
abdcaccaddcbbaadc	FALSE
abdcaccbcdabbabcc	FALSE
accabbdcabddcbbcd	FALSE
accabcdbbdcbcabcc	FALSE
adadbcbcaabcbacab	FALSE
adadbddaddddbddcc	FALSE
addbbccdddcddabca	FALSE
addbbdbcbccbbbadd	FALSE
babcdbbacccadcaaa	FALSE
babcdbdcbddddddda	FALSE
bbaadbcaaabacaada	FALSE
bbaadbcababcaaacd	FALSE
bbccdccbdaacbddad	FALSE
bbccddcbacddaaddc	FALSE
bcbbcddcaabdcdbaa	FALSE
bcbbdabcbcdaccccb	FALSE
bcddbdcadabccbcdd	FALSE
bcddbdcdacdbbacaa	FALSE
bdcbcdabdcaccddca	FALSE
bdcbcdacddbddabcb	FALSE
cabaabcbababdbbdd	FALSE
cabaadaadddbbcaaa	FALSE
cadcbcacccbcaaadc	FALSE
cadccaaddbdabcbcc	FALSE
cbcadaabaacbabcbc	FALSE
cbcadabcdddbdbacc	FALSE
ccbaacbccdcdbdcdd	FALSE
ccbaadbdcabccbcbb	FALSE
ccdcabdabbbcdacda	FALSE
ccdcadbccbcadbbda	FALSE
cdbcddcdccddbaacb	FALSE
cdbdabaccaccdadbd	FALSE
daacdbbbbaabbcdbc	FALSE
daacdcdababadabaa	FALSE
dacdbbabcccdcdcbd	FALSE
dacdbbcabcddccddd	FALSE
dbbcbbbdacadccadb	FALSE
dbbcbcdaaaacbddac	FALSE
dcaaddbdbdcaabbaa	FALSE
dcaaddccbdadbbdad	FALSE
dcdabcadbadbddbab	FALSE
dcdabcbdbccdcddca	FALSE
ddbcaaddcdbccaadb	FALSE
ddbcabcbcabdbdcdb	FALSE
abbbbbbdcccbcddbdd	TRUE
abbbbbbdddbbbbcbcd	TRUE
abccbcbdbbbcccbddb	TRUE
abccbccbccbdbcbcbd	TRUE
abddcccccbdcbccbcc	TRUE
abddcccccdcdcbcbbc	TRUE
accbcccdccddcbdbcb	TRUE
accbccdbbcbccccccc	TRUE
acddbbdbdcccdbbcbc	TRUE
acddbbdbddbcddbcdd	TRUE
adcbccddbdccbbcdcb	TRUE
adcbccddcdbbdcccbb	TRUE
addcdbbcdbbcdbdbbb	TRUE
addcdbbdbbdbcddbdd	TRUE
bacbcbddcdbddbcccc	TRUE
bacbcbdddcdbbddcdd	TRUE
bbabbcdbbdbdbbccbc	TRUE
bbabbcdcbdbdbbdbdb	TRUE
bbcbcccbdccabcdbdd	TRUE
bbcbccddabdcccccbd	TRUE
bcbbacbcbdddbbccbd	TRUE
bcbbacbcccddbbbcbb	TRUE
bcddabccdccbbbbcbd	TRUE
bcddacbcddccbcdcbc	TRUE
bdcbbdcccacddbdcdc	TRUE
bdcbcabddcbccdcbbc	TRUE
cabdbcbdbdcddbdbcd	TRUE
cabdbdbcbccdcdbdbc	TRUE
caddcbdcccddcccbbd	TRUE
caddccbdddccddbddb	TRUE
cbcbcdacdbcbdcdbdd	TRUE
cbcbcddccdbddbbacb	TRUE
ccadcddcdbdbdddbbc	TRUE
ccadcddcdcbbdbbbbc	TRUE
ccdcabcbcbcbdbdcdc	TRUE
ccdcabdccbbbdbddbc	TRUE
cdcacdbdbbbbcdccbd	TRUE
cdcacdcdbcccddccdc	TRUE
dabcccdcddbccbdbcd	TRUE
dabcccddccbdccdbcc	TRUE
dadbcdddbdcbbbcbbd	TRUE
dadbdcbbbcccbccdcb	TRUE
dbbbccbccbbcbcdbda	TRUE
dbbbcdbacccdbbddbc	TRUE
dcabcbdccbbccccdcd	TRUE
dcabccbdbcddddbbcb	TRUE
dccdaddddbbbbcdcdb	TRUE
dccdbabbddccddddcd	TRUE
ddbcadbccbbcdcdccb	TRUE
ddbcbaccbbdbdbdbbc	TRUE
aaaaabbaabaadddcac	FALSE
aaaaabcbdbbbddbbcc	FALSE
aacbbdccdbbbcabbdc	FALSE
aacbcacdcacbbcdcdc	FALSE
abaddacabcabaccddd	FALSE
abaddbabcdddbbbbab	FALSE
abdcdbbbbcbaccadbc	FALSE
abdcdbcaadacccacca	FALSE
accaadcbacaacabdcb	FALSE
accabadadbbdabdbcc	FALSE
adadadacbcbbbdbbbb	FALSE
adadbabadadadcacbb	FALSE
addbdcddcadccadcdb	FALSE
addcaaddadaaaaadac	FALSE
babdcadbddacdcdbcc	FALSE
babdcbaaaccdacdcdd	FALSE
bbababaddbaaaacaba	FALSE
bbabadacdaaabbbddc	FALSE
bbcdbcdcdbabaddaca	FALSE
bbcdbcddbccbbdbdaa	FALSE
bcbccbbadcaabdbdbc	FALSE
bcbccccabbcabdbdcb	FALSE
bdaaacbadbaddcdadd	FALSE
bdaaadbcaaababbbdd	FALSE
bdcddbbabacdaacdba	FALSE
bdcddbbdabbdccdcba	FALSE
cabcbdbbdcbabdccab	FALSE
cabccaadcddbcaadac	FALSE
cbaabcbdcabbddcdbd	FALSE
cbaabdcaadaddaacdb	FALSE
cbcccdcadacbaabdaa	FALSE
cbccdacadcacbdabac	FALSE
ccbbcaaabaadbdbabd	FALSE
ccbbcabcadbbbcdacd	FALSE
cdaabaadddbccbdbcc	FALSE
cdaabbcbcbcdcbbcca	FALSE
cdcbbabbabaabcddcd	FALSE
cdcbbbdccabadddacc	FALSE
dabbbabcddbabccacc	FALSE
dabbbbcdacdcaabcbd	FALSE
dadbdbbddaccbdcbcd	FALSE
dadbdcaaccbbaacbdc	FALSE
dbbcdacdbcdcccdbca	FALSE
dbbcdbbbaadadadbbd	FALSE
dcabacadadbddabacc	FALSE
dcabbbabbdbabbcdbc	FALSE
dccdcbcdcddbacadbd	FALSE
dccdcbdcdbdabcddca	FALSE
ddbcbadadbdbdccaac	FALSE
ddbcbbbcbbabacdcba	FALSE
abbbbbbcbdbddbddbbc	TRUE
abbbbbbcdcbccbbcbcb	TRUE
abccbcbdcdbcbbdbbbd	TRUE
abccbccdbbdcbcbccdc	TRUE
abddcdcbcbcdcdbdccd	TRUE
abddcdccbdbdbbbcdbd	TRUE
acccbbbbccbcdbbcddc	TRUE
acccbbbcddbcbcbdccb	TRUE
acddbdddccbbcddbdbc	TRUE
acddcbbdcccddcdbcdd	TRUE
adcbcccdccccbdbcccd	TRUE
adcbcdbdbdddbcbcbbb	TRUE
adddbcbddcbccbcdccd	TRUE
adddbccbdcdcbbbbcdb	TRUE
baccbcddccddcbbccbb	TRUE
baccbdbdbbcbcbccbcb	TRUE
bbacddbcdccccdbbbcd	TRUE
bbacddbddcdbdbddddc	TRUE
bbdacdbdbbccdcdbdbd	TRUE
bbdacddcbddbdbddcbd	TRUE
bccabccbcccbcbccdcb	TRUE
bccabccdbcddbdcbcdb	TRUE
bdacccccbcccdcdcccb	TRUE
bdaccdbbbbccdcbbcdd	TRUE
bddacbdbddbcbcbbccd	TRUE
bddaccbbcbcbbdddbcb	TRUE
cacbcdccdccdbbbdcbd	TRUE
cacbdbbbcbddbcccbbd	TRUE
cbabbcbcdbbbcdcbbbd	TRUE
cbabbcbddddbbdccdbb	TRUE
cbcdabddccdbdddcdbc	TRUE
cbcdaccbdcdbdbbcccb	TRUE
ccbcbabdbdbbbcccbbc	TRUE
ccbcbaddcdbccdcdddd	TRUE
cdabcbbcdbdbdddcdcb	TRUE
cdabcbbdccbcddcdddd	TRUE
cdcdabbccbdbccdbccb	TRUE
cdcdabbdbbccbdccbdd	TRUE
dacbcbcbdcbbcbdcddb	TRUE
dacbcbccddccccdccdb	TRUE
daddccbbccbbddcdccd	TRUE
daddccbcdbbbddbcdcc	TRUE
dbcadbdcdbdcbcddddd	TRUE
dbcadbddddcbdbdbbcc	TRUE
dcadccdbccddbbbdbcb	TRUE
dcadccdcbdbbdcbccbb	TRUE
dcdbbcbbaccccbcdbdb	TRUE
dcdbcadcddccccbdcdc	TRUE
ddbbccadccbccbccbcb	TRUE
ddbbcccbabbccccdccd	TRUE
aaaaaadadaaddcaccbc	FALSE
aaaaacbaccabbadddda	FALSE
aacbdadbabbbaacdacb	FALSE
aacbdcbcaabdaadacca	FALSE
abadbaddbabdbcadabc	FALSE
abadbbcbbdddadcbcac	FALSE
abdcbadabccdcacdadd	FALSE
abdcbadcddbbddcdaad	FALSE
accabbabcadcaabdacb	FALSE
accabbbbdbdaabcabbc	FALSE
adabdacaccbccdddccc	FALSE
adabdbbcdbaabcdcdcd	FALSE
adcdabadbdabbbacbac	FALSE
adcdabbbcccdbcaaddd	FALSE
babcdcbcadddabbdbdc	FALSE
babcdccabcbabacabac	FALSE
bbacbbacbdcdddcbaba	FALSE
bbacbccddadbbcddddd	FALSE
bbcdbacaadbbbcdbacb	FALSE
bbcdbacddabdbdabdbb	FALSE
bcbbbccbcdababcabdd	FALSE
bcbbbcdbcccdcabcbda	FALSE
bdaacaadbadcdcdacab	FALSE
bdaacacccabaabbdbba	FALSE
bdccbdbacaccbbaaabc	FALSE
bdcccaccccbdacbbdbc	FALSE
cabadbccbacacdbccbc	FALSE
cabadcaccddacdbcbda	FALSE
caddadadbdabaddbcda	FALSE
caddadcbbdaabdcdbdc	FALSE
cbcadbabdbcdbdddabd	FALSE
cbcadbddcdbacdcaacd	FALSE
ccabcbcabacbdaddacc	FALSE
ccabcdcccbbcccabbab	FALSE
ccdaadccdbaadcbbacd	FALSE
ccdaadcddbccdabadaa	FALSE
cdbcdcaacccacbdbdcc	FALSE
cdbdaacbdbbcddcbddd	FALSE
daaccabbcccaccbccdc	FALSE
daaccadababcdbdbcbd	FALSE
dadbbaddabcacaadacd	FALSE
dadbbdbcbddcaccbada	FALSE
dbbcdcbccbaadbbdadb	FALSE
dbbcdcbccbccdbcbdaa	FALSE
dcaabaaaaadccdadccb	FALSE
dcaabcddbacdcdaabcb	FALSE
dccdbbccaaaabdbdbda	FALSE
dccdcbbabadcacaaabc	FALSE
ddbbddacbdcacdbabaa	FALSE
ddbcaabbbbccbcabbcb	FALSE
