aaaaaaaaaa	TRUE
aaaaaadaad	TRUE
aaccdacdcc	TRUE
aaccdcaaca	TRUE
aadddddddc	TRUE
acaaaaaccc	TRUE
acccccddca	TRUE
accccdaadc	TRUE
acddddcdad	TRUE
acddddcdad	TRUE
adccccacaa	TRUE
adccccadac	TRUE
adddcccdda	TRUE
adddccdaac	TRUE
bacdcdccdc	TRUE
bacdcdcdda	TRUE
bbadddcacd	TRUE
bbadddccdd	TRUE
bbdbdccbba	TRUE
bbdbddbbca	TRUE
bcbddddcaa	TRUE
bccaaacdad	TRUE
bdaccdcddc	TRUE
bdaccdddac	TRUE
bddadcdadd	TRUE
bddaddadac	TRUE
cacaddcada	TRUE
cacaddccdc	TRUE
cbaacdadac	TRUE
cbaacdccaa	TRUE
cbccbcdccc	TRUE
cbcccaccdd	TRUE
ccaddccccc	TRUE
ccaddccdaa	TRUE
ccdccbacca	TRUE
ccdcccdbba	TRUE
cdcbdcaadc	TRUE
cdccaacadd	TRUE
daacdcacad	TRUE
daacdccaac	TRUE
dadcddaaaa	TRUE
dadcddacaa	TRUE
dbbdbaacaa	TRUE
dbbdbbbaca	TRUE
dcaccadcdc	TRUE
dcacccaaac	TRUE
dccdbacada	TRUE
dccdbbdadc	TRUE
ddbbbbbccd	TRUE
ddbbbcbdbb	TRUE
aaaaaaabba	FALSE
aaaaabccbd	FALSE
aacdaadaab	FALSE
aacdabbcaa	FALSE
abbbcbbbda	FALSE
abbbcbbccb	FALSE
abdcdcddbb	FALSE
abddabdbbb	FALSE
accbcdbdcc	FALSE
accbcdddcd	FALSE
adbabaccac	FALSE
adbabbbacd	FALSE
addcdbbbcd	FALSE
adddadaccb	FALSE
bacbcbdddc	FALSE
bacbccddca	FALSE
bbaddbacda	FALSE
bbaddcddab	FALSE
bbdbdccbab	FALSE
bbdbddbbab	FALSE
bcbddddcab	FALSE
bccaabaacd	FALSE
bdacabbbdd	FALSE
bdacadbddc	FALSE
bddadadacb	FALSE
bddadbaadb	FALSE
cabdabaabd	FALSE
cabdabbcad	FALSE
cbaacddaab	FALSE
cbaadbbcac	FALSE
cbccbcdcab	FALSE
cbcccabcdc	FALSE
ccadcbbbbb	FALSE
ccadcbbccc	FALSE
ccdccbabca	FALSE
ccdcccdbab	FALSE
cdcbdcabcb	FALSE
cdccaacacb	FALSE
daadaddacb	FALSE
daadbacdcd	FALSE
dadbdbcdaa	FALSE
dadbdccbdc	FALSE
dbbdbaabba	FALSE
dbbdbbbacb	FALSE
dcabdadbcd	FALSE
dcabdadbdc	FALSE
dccdbabada	FALSE
dccdbbdadb	FALSE
ddbbbbbcab	FALSE
ddbbbcbdab	FALSE
aaaaaaaaaaa	TRUE
aaaaaadadad	TRUE
aacccdaaacc	TRUE
aacccdadadd	TRUE
aadddddcddd	TRUE
acaaaaaccdc	TRUE
acccadaccaa	TRUE
acccaddddda	TRUE
acdddcdddac	TRUE
acddddaadaa	TRUE
adccacaadaa	TRUE
adccaccdaad	TRUE
adddccddccc	TRUE
adddcddaddd	TRUE
bacdcaadaac	TRUE
bacdcadacac	TRUE
bbaddaadcdd	TRUE
bbaddaccdda	TRUE
bbdcbbdacac	TRUE
bbdcbbdbaaa	TRUE
bcbccaadcdc	TRUE
bcbcccacadd	TRUE
bdaccdaadac	TRUE
bdaccdaadad	TRUE
bddbacdaaac	TRUE
bddbadaaacd	TRUE
cacadcacccd	TRUE
cacadccddda	TRUE
cbaaadcaaad	TRUE
cbaaadcaaad	TRUE
cbccaddaadd	TRUE
cbccbadcdda	TRUE
ccbbbadcaca	TRUE
ccbbbaddccc	TRUE
ccddcacdacd	TRUE
ccddcacddcc	TRUE
cdcbbbcaadd	TRUE
cdcbbcbdadc	TRUE
daacadadcda	TRUE
daacadcdcca	TRUE
dadcaaddcaa	TRUE
dadcaaddcdd	TRUE
dbbcaccdada	TRUE
dbbcaccddad	TRUE
dcaaacacdda	TRUE
dcaaaccdddd	TRUE
dccdacdadad	TRUE
dccdacdccdc	TRUE
ddbbbaaadad	TRUE
ddbbbaaddda	TRUE
aaaaaaabbaa	FALSE
aaaaabcbdaa	FALSE
aaccbdbdbca	FALSE
aacccaddccb	FALSE
abbbccbbbbb	FALSE
abbbccbdbbd	FALSE
abddbbcdcab	FALSE
abddbbdbddb	FALSE
acccaddacba	FALSE
acccbacbaab	FALSE
adbacbdbcda	FALSE
adbaccabcbd	FALSE
addcbdbbbca	FALSE
addcbddaddb	FALSE
bacadbcbaab	FALSE
bacadccbdca	FALSE
bbadccdabba	FALSE
bbadcdacccb	FALSE
bbdcbbdabab	FALSE
bbdcbbdbaab	FALSE
bcbccaadcdb	FALSE
bcbcccabadd	FALSE
bdabdddcbba	FALSE
bdacaababca	FALSE
bddbacccaab	FALSE
bddbadaaabc	FALSE
cabdaacabbb	FALSE
cabdaadbbba	FALSE
cbaaadcacdb	FALSE
cbaaadcdaab	FALSE
cbccaddaadb	FALSE
cbccbadbcdb	FALSE
ccbbbacadab	FALSE
ccbbbadaccb	FALSE
ccddcaccddb	FALSE
ccddcacdabb	FALSE
cdcbbbcabdd	FALSE
cdcbbcbdadb	FALSE
daacbcababb	FALSE
daacbdadbcc	FALSE
dadabcbcbdb	FALSE
dadacaadbdc	FALSE
dbbcabbbaca	FALSE
dbbcacbaadc	FALSE
dcaaacaddcb	FALSE
dcaaacbbcbb	FALSE
dccdabdbdcd	FALSE
dccdacabbdb	FALSE
ddbbbaaadab	FALSE
ddbbbaadccb	FALSE
aaaaaaaaaaaa	TRUE
aaaaaadacaca	TRUE
aaccdadddada	TRUE
aaccdcaacada	TRUE
aadddddcaccd	TRUE
acaaaaadacdc	TRUE
accccdadccaa	TRUE
accccdaddcca	TRUE
acdddcdacdaa	TRUE
acdddcddcdda	TRUE
adcaddddaaaa	TRUE
adccaaacdddc	TRUE
adddcacadccc	TRUE
adddcadacdaa	TRUE
bacdadadccad	TRUE
bacdadccdcdd	TRUE
bbadacddddac	TRUE
bbadaddcdaaa	TRUE
bbdbbbccacdc	TRUE
bbdbbcccbada	TRUE
bcbdcbcbaadd	TRUE
bcbdcbcdacca	TRUE
bdacddccadac	TRUE
bdacddccdacc	TRUE
bddbaadddcdd	TRUE
bddbaccacacc	TRUE
cacadaddccaa	TRUE
cacadcaaccca	TRUE
cbaacdccdcac	TRUE
cbaadadaadad	TRUE
cbccdacaadca	TRUE
cbccdccbacda	TRUE
ccbbbbdacdcc	TRUE
ccbbbbdadaad	TRUE
ccdcdadaddcc	TRUE
ccdcdcadddad	TRUE
cdcacadaddac	TRUE
cdcacdadacda	TRUE
daaccaccccdc	TRUE
daaccadcdadc	TRUE
dadaaaddadad	TRUE
dadaaaddcaac	TRUE
dbbacaaddaca	TRUE
dbbacaccdcad	TRUE
dbdccadcdaac	TRUE
dbdcccadccdc	TRUE
dcccbccaddaa	TRUE
dcccbdcadaad	TRUE
ddbbadddacaa	TRUE
ddbbbaaddcac	TRUE
aaaaaacacaab	FALSE
aaaaaacccaba	FALSE
aaccdcbcbccb	FALSE
aaccdccabcbd	FALSE
abbacadbadba	FALSE
abbacbabbcab	FALSE
abdbddbccdca	FALSE
abdbddbcdbbc	FALSE
acbdcdbccdda	FALSE
acbddbcabddc	FALSE
adabbcdcaddc	FALSE
adabbdaabdcc	FALSE
adcdaadcbaca	FALSE
adcdabdbcbba	FALSE
babaaccccabb	FALSE
babaacdcbbbd	FALSE
baddaddbccda	FALSE
baddbbdcadbc	FALSE
bbcbadbbdbcd	FALSE
bbcbbaacbcdd	FALSE
bcaddbcddcdb	FALSE
bcaddcbcacbd	FALSE
bcdbbcbcdcab	FALSE
bcdbbdbbbcab	FALSE
bdcabadbaddd	FALSE
bdcabaddcbcc	FALSE
caaccbbcabdc	FALSE
caaccbbcadcd	FALSE
cacdbccaccba	FALSE
cacdbccbccda	FALSE
cbbbbadcabdd	FALSE
cbbbbbaaaaab	FALSE
cbddabbbcdbb	FALSE
cbddacbbbaba	FALSE
cccabccaaccc	FALSE
cccabdcbbaba	FALSE
cdacbaadbcab	FALSE
cdacbabacabd	FALSE
cddcadaccbad	FALSE
cddcbacadcdb	FALSE
dacbbbdbcccd	FALSE
dacbbbddadbc	FALSE
dbadcbdcadcd	FALSE
dbadcdabbdaa	FALSE
dbdcaabbdacd	FALSE
dbdcbbccbbab	FALSE
dccbbdacdddb	FALSE
dccbbdcbcdab	FALSE
ddbbbadccbac	FALSE
ddbbbbadbcba	FALSE
aaaaaacddaccd	TRUE
aaaaacaaccaca	TRUE
aaccdacaaadaa	TRUE
aaccdaccacddd	TRUE
aadddaaacccdd	TRUE
aadddaacacada	TRUE
accacadadccac	TRUE
accacadaddcad	TRUE
acdcdaaccaaac	TRUE
acdcdacdcaaad	TRUE
adadcccacadac	TRUE
adadcccacdcca	TRUE
addacaddaadad	TRUE
addaccaaaacaa	TRUE
baaddacadadad	TRUE
baaddcaddddca	TRUE
bbaaaaadadaca	TRUE
bbaaaadcdcadc	TRUE
bbcaccccadaaa	TRUE
bbcaccddccdda	TRUE
bcacdcdcacacc	TRUE
bcacddaaccacd	TRUE
bcdbdcbbbcbac	TRUE
bcdbdcbdcacdc	TRUE
bdcaaadcccddc	TRUE
bdcaacadcdcda	TRUE
caacaadccacda	TRUE
caacacaccdaad	TRUE
cadaaaadddcaa	TRUE
cadaaacaccada	TRUE
cbbbcbdbaacdd	TRUE
cbbbccdaaacca	TRUE
ccaaccdacdaac	TRUE
ccaacdaadacdc	TRUE
ccccadaaddddc	TRUE
ccccadcadccac	TRUE
cdbaaacddcacd	TRUE
cdbaadaadccca	TRUE
cddcadddaaaac	TRUE
cddcbbadddcca	TRUE
dacccdddddccd	TRUE
daccdaddcddda	TRUE
dbadacdacdccd	TRUE
dbadadadaadac	TRUE
dbdbddaddacac	TRUE
dbdcacaccaaaa	TRUE
dcccbacccdaaa	TRUE
dcccbadcdcadc	TRUE
ddbaddcaacadd	TRUE
ddbbaaacddcdc	TRUE
aaaaaacacaaba	FALSE
aaaaaaccabadd	FALSE
aaccbaabbbbba	FALSE
aaccbaadabddc	FALSE
abbabbbcccabd	FALSE
abbabcddbcabb	FALSE
abdbbbcdcabaa	FALSE
abdbbcbdaddab	FALSE
acbdadcdaacbc	FALSE
acbdbababdacb	FALSE
adabbacadddbd	FALSE
adabbbaaacddc	FALSE
adcccbaccbcca	FALSE
adcccbbbaacda	FALSE
babbccbabbbcb	FALSE
babbccbccaacb	FALSE
bbaaabdbadddd	FALSE
bbaaadaacaccb	FALSE
bbcaccadabaca	FALSE
bbcacccbddbac	FALSE
bcaccbbbbacbb	FALSE
bcacccdddbbba	FALSE
bcdbdcbbbcbab	FALSE
bcdbdcbdcacdb	FALSE
bdcababaadbdb	FALSE
bdcabaccadaad	FALSE
caabdccbaccaa	FALSE
caacaaaacaaab	FALSE
cacdbabdbacba	FALSE
cacdbbbdaddab	FALSE
cbbbcbdbaacdb	FALSE
cbbbccdaaabcb	FALSE
ccaacabcdabda	FALSE
ccaacbccbbccd	FALSE
ccccacbcdcadd	FALSE
ccccacddbdccd	FALSE
cdbaaccdbbdbc	FALSE
cdbaadbdbbbab	FALSE
cddcadddaabac	FALSE
cddcbbadccbca	FALSE
dacabcacaabcc	FALSE
dacacabbcacdc	FALSE
dbacdcabddbdc	FALSE
dbacdcbbbbdac	FALSE
dbdbddacdacab	FALSE
dbdcababdccda	FALSE
dcccbabcbdbaa	FALSE
dcccbaccccadb	FALSE
ddbaddcabcadd	FALSE
ddbbaadbaadcc	FALSE
aaaaaaacaaaadd	TRUE
aaaaaaaccdcccc	TRUE
aacccdccdadaca	TRUE
aacccddacccddd	TRUE
acaaaddccdaacd	TRUE
acaaadddacdaad	TRUE
acccaacddcaddd	TRUE
acccaadaaaadca	TRUE
acddacdcadaadd	TRUE
acddadcaccccaa	TRUE
adcacddddddddd	TRUE
adcadaaaaaddaa	TRUE
addcdaaadcdcca	TRUE
addcdacaacccaa	TRUE
bacaadccaaadad	TRUE
bacaaddaddccad	TRUE
badddccddadaac	TRUE
badddcdcdccada	TRUE
bbccbdbaacccad	TRUE
bbcccadadadaad	TRUE
bcbaccdcacdcda	TRUE
bcbacdccdcccaa	TRUE
bcddbbacdacaad	TRUE
bcddbbcbaddaac	TRUE
bdcadcadadaacd	TRUE
bdcadcddadadda	TRUE
caacacccddadcd	TRUE
caacaccdaaddda	TRUE
cadaaaaadadcad	TRUE
cadaaaacdacdca	TRUE
cbbbacaaacddad	TRUE
cbbbadaccacccc	TRUE
cbddbadadcccaa	TRUE
cbddbadcadccaa	TRUE
cccbbccbacccac	TRUE
cccbbccbcaadaa	TRUE
cdbcbcdcdadacc	TRUE
cdbcbdaaccccdd	TRUE
daaacdaaacdccd	TRUE
daaacdaaadaada	TRUE
dadaacdddadaaa	TRUE
dadacaacaccadd	TRUE
dbbcaaccaacadd	TRUE
dbbcaacccacacd	TRUE
dcaaaadcccddca	TRUE
dcaaacaadacdcc	TRUE
dccccaaddaaaad	TRUE
dccccadcaaadcd	TRUE
ddbbbbacdddaac	TRUE
ddbbbbbcdaacad	TRUE
aaaaabcbddbdac	FALSE
aaaaabccbdbadb	FALSE
aacccdcddddccb	FALSE
aaccdbbdacbbcd	FALSE
abbbcaddbaddda	FALSE
abbbcccbddccda	FALSE
abdcddadddaadb	FALSE
abdcddcbaaacdc	FALSE
accadccbdacbad	FALSE
accadcdbdadadd	FALSE
adadbbadbbccbd	FALSE
adadbcadbabdbb	FALSE
addabcabcacacc	FALSE
addabcdabddcdc	FALSE
babcadccaacacc	FALSE
babcbbbdcadccc	FALSE
baddbadbddbacc	FALSE
baddbbccacbbad	FALSE
bbccbdbaabcbad	FALSE
bbcccadadbdbac	FALSE
bcbacacbdccdab	FALSE
bcbacbadcadcbd	FALSE
bcddbbabdbbabd	FALSE
bcddbbcbaddabb	FALSE
bdcadccadaabca	FALSE
bdcadcdaadcabb	FALSE
caabddadacadbb	FALSE
caacabbdcbaacb	FALSE
cacccabbbbadcc	FALSE
cacccbaddbbaad	FALSE
cbbbababbbdcad	FALSE
cbbbadabcbbbbc	FALSE
cbddbacdadbbca	FALSE
cbddbaddbdbbab	FALSE
cccbbccbacbbac	FALSE
cccbbccbcaacab	FALSE
cdbcbcdcdadacb	FALSE
cdbcbdaabbbcdd	FALSE
daaaccaacbcaac	FALSE
daaacdbcdbcbcc	FALSE
dacccdddaadbdc	FALSE
daccdaaccbaadb	FALSE
dbbcaacbcdcbac	FALSE
dbbcaaccaacacb	FALSE
dcaaabcbcbbcbd	FALSE
dcaaacdbcbdddb	FALSE
dccccaaddbaaad	FALSE
dccccacbdabadc	FALSE
ddbbbbacccdabb	FALSE
ddbbbbbcdabbad	FALSE
aaaaaaaadaaadaa	TRUE
aaaaaaaadaaddaa	TRUE
aaccadccdcaddda	TRUE
aaccaddcccdaddc	TRUE
aadddcdadcaadca	TRUE
aadddcdccacddcc	TRUE
acccadcdcdaddcc	TRUE
acccaddacdcacdc	TRUE
acddccaaaaacaad	TRUE
acddccaddcccaaa	TRUE
adcadaccacadacc	TRUE
adcadacddddacac	TRUE
adddaacdcdaacca	TRUE
adddaadcdccddac	TRUE
bacccccdddcaacc	TRUE
baccccdacdaaaac	TRUE
bbaacaaccaaddaa	TRUE
bbaacacaddcdccc	TRUE
bbccbbcdcbdcada	TRUE
bbcccbbdbbccbdb	TRUE
bcbbbbaacdcdaad	TRUE
bcbbbdadadadacd	TRUE
bcdddadccaadcca	TRUE
bcdddddaacacada	TRUE
bdcbddbdadcacad	TRUE
bdccaacddacddaa	TRUE
caadcccccdaadac	TRUE
caadccdaccccdca	TRUE
caddaddccccacad	TRUE
caddadddadaccda	TRUE
cbcacadadccadcc	TRUE
cbcaccdcccaccdc	TRUE
ccacdcaadcccaad	TRUE
ccacdcdcdaaccca	TRUE
ccdacaadddddacc	TRUE
ccdacadcdadcdac	TRUE
cdbdddacddaacaa	TRUE
cdcaaacaccaccca	TRUE
daacddaaadcaacc	TRUE
daacddaaadcaacc	TRUE
dadccacddcdcddd	TRUE
dadcccacadddddd	TRUE
dbbcccddbdacdda	TRUE
dbbccdbbccbcccd	TRUE
dcacdcddcacddcc	TRUE
dcacddcdaacacdc	TRUE
dcdaccdddacacda	TRUE
dcdacdcdacaaaac	TRUE
ddbcbaaaccadadc	TRUE
ddbcbaccacadcad	TRUE
aaaaaaabbabcdda	FALSE
aaaaabddcdcacbd	FALSE
aacdabdaabaaaba	FALSE
aacdacbcacbcccd	FALSE
abbbccdabdabdba	FALSE
abbbdabbdbaadda	FALSE
acaabccaaacbbca	FALSE
acaabcccaaddddb	FALSE
accbcbbadbcdcab	FALSE
accbcddadcaacdc	FALSE
adadcbddaddacdc	FALSE
adadcddddadcaab	FALSE
addcaaaadcbaacd	FALSE
addcaacbdcacdad	FALSE
babddcaccdbaccc	FALSE
bacaaabacadadbb	FALSE
bbaacbcdcbcaccb	FALSE
bbaaccaaabdaddb	FALSE
bbccbbcdcbdcadb	FALSE
bbcccbbdbbccbab	FALSE
bcbbbbabbdbdaad	FALSE
bcbbbdadadadabd	FALSE
bcdddadbcaacbba	FALSE
bcdddddaacabada	FALSE
bdcbddbdadcabad	FALSE
bdccaabddacddba	FALSE
cababcaaaddaaad	FALSE
cababcbbabaacba	FALSE
cadcadccadccbbd	FALSE
cadcaddaadcaadb	FALSE
cbcabbdccadbbad	FALSE
cbcabdaddbbcacb	FALSE
ccacbbadabdabbb	FALSE
ccacbbcbadbccaa	FALSE
ccdabbabddddcdd	FALSE
ccdabbbbbbccbcc	FALSE
cdbdddacccaabaa	FALSE
cdcaaadbabbbccc	FALSE
daadcbabbadbada	FALSE
daadcbbaccaabca	FALSE
dadbadcbaadcddb	FALSE
dadbadccaaaaddb	FALSE
dbbcccddbdacddb	FALSE
dbbccdbbccbccab	FALSE
dcacbbddcbbddca	FALSE
dcacbcbabdbddcc	FALSE
dcdacacacdaddab	FALSE
dcdacbaacaccdca	FALSE
ddbcbaaacbbdadb	FALSE
ddbcbabcbbacbac	FALSE
aaaaaaacddacddcc	TRUE
aaaaaaaddacaaaac	TRUE
aaccadacdccdccad	TRUE
aaccadadaacaacac	TRUE
acaaacddcccaccac	TRUE
acaaadaadcccdada	TRUE
accccdcadcccccdc	TRUE
accccdccaaddacac	TRUE
acddddadaadcacaa	TRUE
acddddadddddccca	TRUE
adccadddaaacddda	TRUE
adccaddddcaddcda	TRUE
adddadddcccadacd	TRUE
adddcaaadcadcdaa	TRUE
baccaadcdcdaadcc	TRUE
baccacacdaacacdc	TRUE
bbacaddcdddccddd	TRUE
bbacadddaaaaaccd	TRUE
bbccddacccdcdcdd	TRUE
bbcdadadddadcadc	TRUE
bcbccdcbbbadcddc	TRUE
bcbccdcdaacccaaa	TRUE
bdacacdcccdccaac	TRUE
bdacacddcdccaaaa	TRUE
bddaacdacccddaca	TRUE
bddaacdadadcaada	TRUE
cacacdadcacadaca	TRUE
cacacdccacaadaaa	TRUE
cbaaadcacddcaccd	TRUE
cbaaadcccaadaadd	TRUE
cbcdbdcccdddacdc	TRUE
cbcdbdcdcdcbcdcb	TRUE
ccbcdcbcccbcbbac	TRUE
ccbcddbacaacdccd	TRUE
cdaadcddcdacadad	TRUE
cdaaddccddaadada	TRUE
cdcdbbbcdbbbcdba	TRUE
cdcdbbcacaccaacd	TRUE
daadddcaddddddaa	TRUE
daaddddcaccaadda	TRUE
dadcdaaddaacccac	TRUE
dadcdacdaacccacc	TRUE
dbcbbcdccbcdacaa	TRUE
dbcbbdadcacdadcc	TRUE
dcadcaacaacacdda	TRUE
dcadcaacadacaadc	TRUE
dcdbcdaadadacacc	TRUE
dcdbcdbaaadaccdd	TRUE
ddbcdcdbacaaddda	TRUE
ddbdaccadaaacddc	TRUE
aaaaaacadabcdbca	FALSE
aaaaacabbddaccdb	FALSE
aacbdcbbcdcabaca	FALSE
aacbddacdddabcbc	FALSE
abbcdaabacbabccc	FALSE
abbcdababbacaddc	FALSE
acaacbcbdddadabd	FALSE
acaaccbacbadcacc	FALSE
accddcbcbbccddbc	FALSE
acdaaaacdcccbcad	FALSE
adbbbdbaccccdcbb	FALSE
adbbcacaacabdcbc	FALSE
addcbbababdbdcac	FALSE
addcbbcabcccabab	FALSE
babdabdbddacabba	FALSE
babdacdbbccddbcb	FALSE
bbabcacbbdadadaa	FALSE
bbabcbaabccccadc	FALSE
bbccddabcbdbccdd	FALSE
bbcdacbcdcdadcac	FALSE
bcbccdcbbbadbddc	FALSE
bcbccdcdaabcbbbb	FALSE
bdabcdaabbcdcdbc	FALSE
bdabcdabacbbaddc	FALSE
bddaabacdbabdbbd	FALSE
bddaacbbbcbdcaad	FALSE
cabcacadbcdbbadb	FALSE
cabcadccbacbcbbd	FALSE
cbaaadcdbccdbbac	FALSE
cbaabbacaadadcba	FALSE
cbcdbdcccdddacdb	FALSE
cbcdbdcdcdcbcdab	FALSE
ccbcdcbcccbcbbab	FALSE
ccbcddbacaabdbbd	FALSE
cdabacccbdadcadd	FALSE
cdabadcddaadbdbb	FALSE
cdcdbbbcdbbbcdab	FALSE
cdcdbbcabaccaabd	FALSE
dabbadbccdababca	FALSE
dabbadbcdcdbdcad	FALSE
dadbdddcbbcbbbda	FALSE
dadbddddacddcddc	FALSE
dbcbbcdccbcdacab	FALSE
dbcbbdadbbbdadcb	FALSE
dcadbbdcadcbaddb	FALSE
dcadbcabdcabaadc	FALSE
dcdbcdaadbcbcabb	FALSE
dcdbcdbaaacbbbdd	FALSE
ddbcdcdbabaaddda	FALSE
ddbdabcadabbcddc	FALSE
aaaaaaaaadaacddaa	TRUE
aaaaaaaacdcdaadad	TRUE
aaccacaadcdaadadd	TRUE
aaccacadaaaaccaca	TRUE
aaddddacadcccaaac	TRUE
aaddddadaaacddcdc	TRUE
accadaacdcddadddd	TRUE
accadaadcdddcaacc	TRUE
acdcdddddddddadad	TRUE
acddaaaaccadcdada	TRUE
adcaccdcaacddddad	TRUE
adcaccdcdaaaaacac	TRUE
addccacacdaddcaaa	TRUE
addccaccadcddddac	TRUE
bacadcaaccacadcaa	TRUE
bacadcadcadcdadcd	TRUE
baddcdddadadccdca	TRUE
baddcdddcdddaddca	TRUE
bbccbaacdcacaadad	TRUE
bbcccaccddacccaaa	TRUE
bcbadcdaadaaaadda	TRUE
bcbadcdadadcdacad	TRUE
bcdcbbadacccdacdc	TRUE
bcdcbcdbacdadadad	TRUE
bdcacdcaddcaadada	TRUE
bdcadaacaacdacaac	TRUE
caacccadadcccacca	TRUE
caacccdacadadacca	TRUE
cadcdcacadccadacc	TRUE
cadcdcadaddadaddc	TRUE
cbcaaacdcdadddccc	TRUE
cbcaadcccacdcadaa	TRUE
ccadccdadaacadada	TRUE
ccaddaaadcdcddccd	TRUE
ccdbbcccaddadaada	TRUE
ccdbbdbdaaaccdacc	TRUE
cdbcddbdcdcacdcad	TRUE
cdbdaacdcacacdddc	TRUE
daaacadaaadcacdca	TRUE
daaacadacddddddaa	TRUE
dadaaaddadaadaccd	TRUE
dadaaaddcdcdcadda	TRUE
dbbdbacccddaacdda	TRUE
dbbdbccdbbdcaddca	TRUE
dcaadccacacadccac	TRUE
dcaadcdaccaddccac	TRUE
dcccdcbcbadcadcdc	TRUE
dcccddaccadaaaaad	TRUE
ddbbdbbcbcaadcacc	TRUE
ddbbdbcbcbbcbbdcc	TRUE
aaaaaaaaaabaaccdd	FALSE
aaaaaacddbcbabdad	FALSE
aacddcabdabccaadc	FALSE
aadaaaabdcbaabcbd	FALSE
abbbcaacacbbdbada	FALSE
abbbcaddbdcaadccc	FALSE
abdcdccacbdaccbbd	FALSE
abdcddaacdadbbbdc	FALSE
accadccddbddadacc	FALSE
accbaabcbbbdbabad	FALSE
adacbdcbbddaddccb	FALSE
adaccaabbbcacdaba	FALSE
addabcaaaabcbbbdb	FALSE
addacbbacabdcbcca	FALSE
babcbbcccadacbbab	FALSE
babcbdccadadddabd	FALSE
baddbbcdddbdbcdbb	FALSE
baddbbddcdadccaad	FALSE
bbccbabcdcacabdac	FALSE
bbcccabcccacbbbab	FALSE
bcbadcdaaabadcada	FALSE
bcbadcdadccabbdca	FALSE
bcdcbbadabbbdabdb	FALSE
bcdcbcdbaccbdacad	FALSE
bdcacabcddbabdada	FALSE
bdcadaabbacdacaab	FALSE
caadaaaacadaddbcb	FALSE
caadaaacdcbbcabaa	FALSE
cadbcdccbaddbcaab	FALSE
cadbdaccbaddadacd	FALSE
cbcaaaabdbdadcdbb	FALSE
cbcabadbadaadbdba	FALSE
ccadcaabadacbabba	FALSE
ccadcaaccbabadacc	FALSE
ccdbbcccaddadbada	FALSE
ccdbbdbdaaacbdbbb	FALSE
cdbcddbdcdcabdcad	FALSE
cdbdaaabcbacacdcd	FALSE
daaacacaabbbaaaaa	FALSE
daaadaacdccdcccab	FALSE
dacccddbdddbaacba	FALSE
daccddaddbdbaddaa	FALSE
dbbdbabcacdaabdca	FALSE
dbbdbccdbbdcacdcb	FALSE
dcababbabddabbdab	FALSE
dcababbdcabdaabac	FALSE
dcccdcbcbadbadbdc	FALSE
dcccddaccadababbd	FALSE
ddbbdbbcbcaadbbcc	FALSE
ddbbdbcbcbbcbbdab	FALSE
aaaaaaaacaaccdacdc	TRUE
aaaaacadcddacaccdc	TRUE
aacccdcdcacddcdaad	TRUE
aacccddccddcaacdaa	TRUE
acaaadcaaaddaaaadc	TRUE
acaaadcadadcdcddaa	TRUE
acccccddadaacaadaa	TRUE
acccccddddcdddddda	TRUE
acdddacdadccdadcca	TRUE
acdddadaadadcaddca	TRUE
adcadcdcccdadaddda	TRUE
adcaddacaccddaaaca	TRUE
addddcccdcdaccaddd	TRUE
addddccdddaccaccdd	TRUE
bacdccdcaacdddcccd	TRUE
bacdccdcacccacdcaa	TRUE
bbadcdddcacddacacd	TRUE
bbadcddddcacdcccdc	TRUE
bbdcdacddcdaaccadd	TRUE
bbdcdbaaaadcdddccc	TRUE
bcccbaaacadaddddac	TRUE
bcccbaacacdaaddacc	TRUE
bdadadacdcadccccdd	TRUE
bdadadccdaccccddaa	TRUE
bddbacaccdccccadcd	TRUE
bddbacacdadaaccddd	TRUE
cacacdaaacdadadcdd	TRUE
cacacddaccdcdadcad	TRUE
cbacacacdcdcdadaad	TRUE
cbacacccdcaccacacc	TRUE
cbcdacadccacddadda	TRUE
cbcdacadcdaaaddcad	TRUE
ccbbbaadacaaaaadad	TRUE
ccbbbacaaaaaccaadd	TRUE
ccddcacdccaaacddca	TRUE
ccddcbbadcaaaccdaa	TRUE
cdcbdaadaddacdddca	TRUE
cdcbdbbccdaccaaacc	TRUE
daadcdacadaaccdaca	TRUE
daaddaaccdadacadcc	TRUE
daddcaccacadaddcad	TRUE
daddcacccdaaaddaad	TRUE
dbcaddadaddcadcadc	TRUE
dbcaddadcdaaacddac	TRUE
dcadaccaaacdddacac	TRUE
dcadaccacccadadada	TRUE
dccdcacaddcccadddc	TRUE
dccdcbcadacaaccaac	TRUE
ddbdaaaaccdaddcadc	TRUE
ddbdaadadaaaccacdc	TRUE
aaaaaabccbdaaaadca	FALSE
aaaaaabddcddcdbcad	FALSE
aaccacddbcbcabdadd	FALSE
aaccadcacadadcbcdc	FALSE
abadccddbacddcaddd	FALSE
abadcdaadcaabdccbc	FALSE
abdbcadadcdbddccba	FALSE
abdbcbccadaadcaadd	FALSE
accbbbadcacbcbdddd	FALSE
accbbbbdbcdaddcddd	FALSE
adaddbdaabaabddbcd	FALSE
adaddcaacaacdbadbd	FALSE
addbbabbdbabcccbda	FALSE
addbbacdbdbcbbdbab	FALSE
babbdbbabcdcddbcab	FALSE
babbdccdbdaaccccad	FALSE
bbaadbddcaababdbda	FALSE
bbaaddccabccabbccd	FALSE
bbccdddaabddcdaacb	FALSE
bbcdaacabadddcdadd	FALSE
bcbabcddcadaccaabc	FALSE
bcbacbbaccdaddcaca	FALSE
bcddbcaaadaabcbdbc	FALSE
bcddbcbbcbcbbabcac	FALSE
bdcbbdabdcbaabcbcd	FALSE
bdcbbdbbabacadccdc	FALSE
caaddadadcccdaaadb	FALSE
caaddbcdaabbcddcca	FALSE
cadcbcddcdbacbccaa	FALSE
cadccadbaddbbdbbbd	FALSE
cbccaaabbbabadaacb	FALSE
cbccaaabcbdabddaad	FALSE
ccbabacbbbdabbccba	FALSE
ccbacaccccdbdabdba	FALSE
ccddaccddaabbcdcbb	FALSE
ccddaddacadbdacdda	FALSE
cdcacbabacadcbaaac	FALSE
cdcaccbcdccdccabbd	FALSE
daacdccdbbcbcadadc	FALSE
daacddccccabbccddb	FALSE
dadabddaaaabbcabac	FALSE
dadacacadcddcdbcab	FALSE
dbbcccacacdbccdcbb	FALSE
dbbcccdbadddaacaab	FALSE
dcaadaadcacaabccbc	FALSE
dcaadadabcabdabcbb	FALSE
dccddbdabbccdabbda	FALSE
dccddbdcbcbbaadcdb	FALSE
ddbcaaadccacabbbdc	FALSE
ddbcaabcbbdbcacccc	FALSE
aaaaaaaacacdcdaaaac	TRUE
aaaaaaacaadaacdcdaa	TRUE
aacccddcacdcadcddcd	TRUE
aacccddccdcadacacdd	TRUE
aaddccddcddaccddada	TRUE
aaddcdacaccaadccdad	TRUE
acccaacdccadacdccca	TRUE
acccaacdccdcddaaaca	TRUE
acddacccdccaaccccac	TRUE
acddacdadacdaaccccd	TRUE
adcacdacadddadcdccc	TRUE
adcacdacdddaaaaddcd	TRUE
addccdacdadaaaaaccc	TRUE
addccdacdccadcdcdcc	TRUE
baccaacccccddaadcda	TRUE
baccaaccddaacacdcaa	TRUE
bbaacdccacddadddaac	TRUE
bbaacdddddccacccdca	TRUE
bbcbdcaccadaccdcacd	TRUE
bbcbdccaacccdcadddd	TRUE
bcbaadacaadccacaccc	TRUE
bcbaadacaadddcadcaa	TRUE
bcdcbadadccacaaddaa	TRUE
bcdcbbcbcbcbbaccddd	TRUE
bdcacdcdaddacadacdd	TRUE
bdcacdcdccacaccddcd	TRUE
caacdcaacacdccacdad	TRUE
caacdccaaddcaacddcd	TRUE
cadccdaccccaaacccaa	TRUE
cadccdcccaacaadddda	TRUE
cbbdbcbaddaaaaaccac	TRUE
cbbdbcccdccacacaddc	TRUE
ccacdcddaaadaaadcac	TRUE
ccacddacdacaccdacaa	TRUE
ccdbddadcccaccdaddd	TRUE
ccdcaadacddaaccccca	TRUE
cdcaaacddaccdacdddd	TRUE
cdcaacaacdccadcaadc	TRUE
daaccdacdcacadacdca	TRUE
daaccdadcdacccacddc	TRUE
dadcacaccdaaadcaadc	TRUE
dadcaccccccccdaadcd	TRUE
dbbddacaccaaccacada	TRUE
dbbddacddcaddccddca	TRUE
dcacddcdcdaaadccada	TRUE
dcacdddadacdddcadaa	TRUE
dcdadcddaddcadadacd	TRUE
dcdbaaadaacadaddaaa	TRUE
ddbccdbbbdbbdcbdddb	TRUE
ddbcdbcbacadcaddaaa	TRUE
aaaaabddcacbdabbbda	FALSE
aaaababacbdadaacdcc	FALSE
aacdbdadabbbacaccac	FALSE
aacdcabdbcdbdabccbc	FALSE
abbcaccbcdaacaccdbd	FALSE
abbcacdabccbcbaabcd	FALSE
acaabcbabbaacdbbcac	FALSE
acaabdcccabccdbccad	FALSE
accccaadadbabbddbdc	FALSE
accccadbbaabdabaaab	FALSE
adbbbdcbcaabddbcbba	FALSE
adbbbdddccacbadccbc	FALSE
addcbabddacacbaacbc	FALSE
addcbacdaabcbacabcd	FALSE
bacbacaabccdaaacbbb	FALSE
bacbadaddbdcbbdddaa	FALSE
bbbadbccacadcbcdcca	FALSE
bbbadbdcadcadddbbcd	FALSE
bbdcbbcbccdcbdbacbc	FALSE
bbdcbbccabbdbbaabbb	FALSE
bcbdbabcdaaaaaddacc	FALSE
bcbdbabcdaadbdcdbad	FALSE
bdabaccccbadadbbdda	FALSE
bdabadcadcdcdbccccc	FALSE
bdcccaaaaccdbdcdbaa	FALSE
bdcccbbadcbdccdabcb	FALSE
cabbaadbbbdccdbcbda	FALSE
cabbababdbcbdbbbcdb	FALSE
cadddbbaabdbdbcacad	FALSE
cadddbbbcaadbbcbcac	FALSE
cbcccccaaddbacaadbd	FALSE
cbcccdabdccaaddbdcc	FALSE
ccbaddbbabcbdcaacca	FALSE
ccbbaaadbdcdacccacb	FALSE
ccdcdcaadaccdbdbbaa	FALSE
ccdcdcbbaaddadaaadb	FALSE
cdcabcabcbacdbabcab	FALSE
cdcabcdbadbcdcbbccc	FALSE
daabbbdcbcbaccaddcb	FALSE
daabbcbbbcbadabbddd	FALSE
dacdabaabdadaacbbda	FALSE
dacdabbdddaccccdaaa	FALSE
dbbbbbccdacabcbcaca	FALSE
dbbbbbdddaddbdbdccd	FALSE
dbddcddbccddddaadba	FALSE
dbdddacbbadabcaaabc	FALSE
dccbdabaaaacbaadabc	FALSE
dccbdbcacabadcaacbc	FALSE
ddbbaaacbbcccadaabb	FALSE
ddbbadbcabbcbacbdab	FALSE
