aaaaabdccc	TRUE
aaaaacaddb	TRUE
aacddbdcaa	TRUE
aadaabcacc	TRUE
abaddccdda	TRUE
abaddcdadc	TRUE
acaabadaaa	TRUE
acaabdcaad	TRUE
accccbcdda	TRUE
acccccbdcd	TRUE
adbcaddaaa	TRUE
adbccaaccc	TRUE
addcdaabdc	TRUE
addcdabadc	TRUE
bacadacdda	TRUE
bacadadaac	TRUE
badcdaaccc	TRUE
badcdaaccd	TRUE
bcaddacaaa	TRUE
bcaddacadd	TRUE
bcdcaaacad	TRUE
bcdcaaacdd	TRUE
bdadccacda	TRUE
bdadccadac	TRUE
bddacccaaa	TRUE
bddaccdadd	TRUE
cabaccdacd	TRUE
cabacdaada	TRUE
cadcbaddad	TRUE
cadcbcdcdd	TRUE
cbcdacdcac	TRUE
cbcdadaadc	TRUE
ccbadacdca	TRUE
ccbadadaca	TRUE
ccddbddddd	TRUE
ccddcbaaad	TRUE
cdcbddddad	TRUE
cdccaabcac	TRUE
dabacdaaac	TRUE
dabacdaccd	TRUE
daddcbacdd	TRUE
daddccadab	TRUE
dbcdccdaaa	TRUE
dbcdccdccc	TRUE
dcadcccccb	TRUE
dcadcdadcb	TRUE
dcdacdcaba	TRUE
dcdadaaabc	TRUE
ddbccadcac	TRUE
ddbccadcdc	TRUE
aaaaabdcbb	FALSE
aaaaacaddc	FALSE
aacddbdbba	FALSE
aadaabbaac	FALSE
abbbaddaba	FALSE
abbbbaabab	FALSE
acaabadaab	FALSE
acaabcabbd	FALSE
accccbbccb	FALSE
acccccbdcb	FALSE
adbbbdcaba	FALSE
adbbcbaaad	FALSE
addcdaabdb	FALSE
addcdabadb	FALSE
bacbbbbabc	FALSE
bacbbbdbdb	FALSE
bbacbbabbd	FALSE
bbaccaadaa	FALSE
bbdacbdacd	FALSE
bbdaccaddb	FALSE
bcbcbbacdc	FALSE
bcbcbcdaad	FALSE
bcddbccacd	FALSE
bcddbdbacc	FALSE
bdcdaddcbc	FALSE
bdcdbadcbc	FALSE
cabadaacab	FALSE
cabadcaacb	FALSE
cadcbbccca	FALSE
cadcbbcddc	FALSE
cbcbcdcdcc	FALSE
cbcbdcbaaa	FALSE
ccbadcbccb	FALSE
ccbaddabba	FALSE
ccddbdcadb	FALSE
ccddcbaabd	FALSE
cdcbddcdab	FALSE
cdccaabbac	FALSE
dabadacbbc	FALSE
dabadadcbb	FALSE
daddcbacdb	FALSE
daddccadac	FALSE
dbcbdbaaba	FALSE
dbcbdbbadd	FALSE
dcadccccca	FALSE
dcadcdadcd	FALSE
dcdacdcabb	FALSE
dcdadaaabb	FALSE
ddbbcdbaad	FALSE
ddbbcdbbba	FALSE
aaaaabdccca	TRUE
aaaaacddccb	TRUE
aacdddbadac	TRUE
aadaaaacccb	TRUE
abaddccddac	TRUE
abaddccddad	TRUE
acaabaddada	TRUE
acaabdcaddd	TRUE
accdabccada	TRUE
accdadadadb	TRUE
adbaadcccaa	TRUE
adbaaddacac	TRUE
addcccdacbc	TRUE
addcdacaaab	TRUE
baccacaaadc	TRUE
baccacadadc	TRUE
baddccdaccd	TRUE
baddcdaaaad	TRUE
bccacdccaad	TRUE
bccacdddaad	TRUE
bcdccaccaad	TRUE
bcdccacdadc	TRUE
bdadcaccaad	TRUE
bdadccadacd	TRUE
bddaadcdaac	TRUE
bddaaddcdaa	TRUE
cabadaacdcc	TRUE
cabadacaccd	TRUE
cadcbadaadd	TRUE
cadcbadadda	TRUE
cbcdcacdacc	TRUE
cbcdcacdccd	TRUE
ccbacccadcd	TRUE
ccbaccccaac	TRUE
ccddaccbcad	TRUE
ccddacddaab	TRUE
cdccdbcadcd	TRUE
cdccdcaacba	TRUE
dabadaadacc	TRUE
dabadacddda	TRUE
dadcdcabddc	TRUE
dadcddbcdca	TRUE
dbccdacacac	TRUE
dbccdacacda	TRUE
dcacdbcddda	TRUE
dcacdcbaaac	TRUE
dccddaddbcc	TRUE
dccddbddcad	TRUE
ddbcadcdcad	TRUE
ddbcccaacad	TRUE
aaaaabdcbbb	FALSE
aaaaacddcca	FALSE
aacdddbbdac	FALSE
aadaaaacccc	FALSE
abbbbadbcdd	FALSE
abbbbbacddb	FALSE
acaabbcadca	FALSE
acaabdbbadd	FALSE
accdabcbada	FALSE
accdadadadd	FALSE
adbabcaacba	FALSE
adbabdbdadc	FALSE
addcccdacbb	FALSE
addcdacaaaa	FALSE
bacbcccdaab	FALSE
bacbcdddbdd	FALSE
bbadddabbcc	FALSE
bbbaaacbabc	FALSE
bbdabddcbad	FALSE
bbdacbbbdda	FALSE
bcbcddbcccb	FALSE
bcbdaadddbd	FALSE
bdaabdbabdc	FALSE
bdaacabcccc	FALSE
bdcccabcdba	FALSE
bdcccabdcbb	FALSE
cabaddcdccb	FALSE
cabbacdbadd	FALSE
cadcbaddbad	FALSE
cadcbbddada	FALSE
cbcbcbcbadb	FALSE
cbcbccaaada	FALSE
ccbacdbdadb	FALSE
ccbadaaaacb	FALSE
ccddaccbbad	FALSE
ccddacddaad	FALSE
cdccdbbaccd	FALSE
cdccdcaacbb	FALSE
dabacacacab	FALSE
dabacaccdba	FALSE
dadcdcabddb	FALSE
dadcddbbadc	FALSE
dbcabdcdbcd	FALSE
dbcacaadbad	FALSE
dcacdbcdddb	FALSE
dcacdcbbacd	FALSE
dccddaddbcb	FALSE
dccddbddcab	FALSE
ddbcaabddba	FALSE
ddbcacacaab	FALSE
aaaaaaaaddcb	TRUE
aaaaaacadcab	TRUE
aaccddbcaccd	TRUE
aacdaacbddaa	TRUE
abcaadacadca	TRUE
abcaadacaddd	TRUE
acaaadccbcac	TRUE
acaabadaadaa	TRUE
acccddacabaa	TRUE
acccddcccbcc	TRUE
adadcbaccdad	TRUE
adadcdcdbacd	TRUE
addbcddcccdc	TRUE
addbdcaaadaa	TRUE
bacaacaddcca	TRUE
bacaacaddcda	TRUE
badcacadaada	TRUE
badcaccccdca	TRUE
bcadccacccac	TRUE
bcadccadaacc	TRUE
bcdcacdacdad	TRUE
bcdcadacadda	TRUE
bdadddaddcac	TRUE
bdaddddadcaa	TRUE
bddcaaacacdd	TRUE
bddcaaacdaca	TRUE
cabaddccccca	TRUE
cabcaaaddcdd	TRUE
caddacadccba	TRUE
caddaddadbcc	TRUE
cbdaaacccadd	TRUE
cbdaaaccdcad	TRUE
ccbacccacadc	TRUE
ccbacccdcada	TRUE
ccdbadcdaaaa	TRUE
ccdbcaacdcca	TRUE
cdcacbdccdcc	TRUE
cdcacccdbcda	TRUE
dabacddaacad	TRUE
dabadaaaccaa	TRUE
daddabcaccaa	TRUE
daddacbdadca	TRUE
dbcdaaaccdaa	TRUE
dbcdaaccddda	TRUE
dcabccccddcd	TRUE
dcabdaacdcda	TRUE
dccdccbacdda	TRUE
dccdccbccdcd	TRUE
ddbacdcaaddd	TRUE
ddbacdddaaca	TRUE
aaaaaaaaddca	FALSE
aaaaaacadcaa	FALSE
aaccddbbabcd	FALSE
aacdaacbddba	FALSE
abbbddababba	FALSE
abbcaaacdaca	FALSE
acaaadccbbab	FALSE
acaabacaadab	FALSE
acccddacabab	FALSE
acccddcccbbb	FALSE
adadcbabbdad	FALSE
adadcdcdbbcd	FALSE
addbccbbdcdd	FALSE
addbcccdcccb	FALSE
babdcccdabbb	FALSE
babdcdadabcb	FALSE
bbabcddaacab	FALSE
bbabdababbdd	FALSE
bbcdadacaada	FALSE
bbcdbacbadab	FALSE
bcbacdccdbcb	FALSE
bcbadbaaccac	FALSE
bdaaabdbaddb	FALSE
bdaaacaacdbb	FALSE
bdccdddabadb	FALSE
bdcdaaadacab	FALSE
cabbbbdacccb	FALSE
cabbbcadbbaa	FALSE
caddacadccbb	FALSE
caddaddadbbc	FALSE
cbcccbccbbda	FALSE
cbccccbdcaca	FALSE
ccbacabacbbb	FALSE
ccbacadabadd	FALSE
ccdbbbabaabc	FALSE
ccdbbcabdccd	FALSE
cdcacbcccdcb	FALSE
cdcacccdbcdb	FALSE
dabbaacbdddd	FALSE
dabbabccaaab	FALSE
daddabbaccaa	FALSE
daddacbcadba	FALSE
dbcbabcbddda	FALSE
dbcbabccaaca	FALSE
dcabcbbdbdda	FALSE
dcabcdccbcad	FALSE
dccdccbabdda	FALSE
dccdccbbbdcd	FALSE
ddbacdabcdad	FALSE
ddbacdabddba	FALSE
aaaaaaaaddcab	TRUE
aaaaaacbcaacc	TRUE
aaccdacbadadc	TRUE
aaccddbccdaaa	TRUE
abcaaacddddca	TRUE
abcaaaddddaaa	TRUE
acaaabddddcac	TRUE
acaaadbaaaddc	TRUE
accbacdaacdcd	TRUE
accbadcdadadd	TRUE
adbaaddaadada	TRUE
adbaadddacada	TRUE
addbacddcadad	TRUE
addbacdddaaca	TRUE
bacacaaddaccd	TRUE
bacacacdddaad	TRUE
badcddcccddcc	TRUE
badcddccdcada	TRUE
bccaaaadaadca	TRUE
bccaaaadcacdd	TRUE
bcdcaaccacacc	TRUE
bcdcacaccdaca	TRUE
bdadccdaaccca	TRUE
bdadccdaaddad	TRUE
bddadddcadcdd	TRUE
bddadddcdaacc	TRUE
cabcdccdccdca	TRUE
cabcdccddcddc	TRUE
cbaaadaaaadca	TRUE
cbaacaaadaacc	TRUE
cbdaacadccdda	TRUE
cbdaaccaadcdc	TRUE
ccbadadaddaad	TRUE
ccbadccadacda	TRUE
ccddcaabccdda	TRUE
ccddcdcbacddd	TRUE
cdcbaaccacaad	TRUE
cdcbacaaaccca	TRUE
dabaaccaaadaa	TRUE
dabaaccacddad	TRUE
dadcdcabcadcc	TRUE
dadcdcddadaab	TRUE
dbcdacccaccdd	TRUE
dbcdaccdccada	TRUE
dcacdccbaccac	TRUE
dcadabccdaaca	TRUE
dcdaddbddaadc	TRUE
dcdbaaaaaacad	TRUE
ddbdacdcdadac	TRUE
ddbdadcacddcc	TRUE
aaaaaacbacccb	FALSE
aaaaabdcdbdda	FALSE
aacccbadbbcbc	FALSE
aacccbbbdbcca	FALSE
abbbaadbdddba	FALSE
abbbabacdadba	FALSE
abddacabdcdac	FALSE
abddacddabbcc	FALSE
accbadddacdcb	FALSE
accbbbcdacbab	FALSE
adadcadcbcdab	FALSE
adadcaddbabaa	FALSE
addbbdccbdcdc	FALSE
addbcbacbacdc	FALSE
bacabdccadaca	FALSE
bacacbadcdaab	FALSE
bbaccbcccddab	FALSE
bbacccaccddbd	FALSE
bbdacbbdbcaaa	FALSE
bbdacdcdbbdcb	FALSE
bcbcdddaacbda	FALSE
bcbdaacaddada	FALSE
bdacacccdbaac	FALSE
bdacbbdbcdaad	FALSE
bddbcabbabadc	FALSE
bddbcacabbbbd	FALSE
cacbabbdcbdbb	FALSE
cacbadcbdbcba	FALSE
cbadbdabacacb	FALSE
cbadccbbdadac	FALSE
cbdcaaacbbdbb	FALSE
cbdcaabcbacdd	FALSE
ccbdbaddcbabd	FALSE
ccbdbbcbdcdad	FALSE
cdaadaabcdcbb	FALSE
cdaadaccaccdd	FALSE
cdccdbddcccdb	FALSE
cdccddbcacadb	FALSE
daadcbcbaadbc	FALSE
daadcbcdbacab	FALSE
dadccaccdaada	FALSE
dadccccbacbad	FALSE
dbcbbcbcdbabb	FALSE
dbcbbdabbacad	FALSE
dcaccadbabdcd	FALSE
dcaccadbcbbcd	FALSE
dcdabcccaabdb	FALSE
dcdacbbcabdad	FALSE
ddbdbadbbbdda	FALSE
ddbdbbbcbdadc	FALSE
aaaaaacbaccdad	TRUE
aaaaabddaddadc	TRUE
aacccadacbcdaa	TRUE
aacccdacaaaaab	TRUE
abaddaaadccdaa	TRUE
abaddacaadcada	TRUE
abddcdccccaddd	TRUE
abddcdddaadcac	TRUE
accbacaaaadacd	TRUE
accbacccdccdaa	TRUE
adadbadddacdad	TRUE
adadbcadcccacc	TRUE
addcabcdadcdcc	TRUE
addcabcdcdddac	TRUE
baccacadcddadc	TRUE
baccacccccdacc	TRUE
badddcaccdddcc	TRUE
badddcdacdaacc	TRUE
bccccaaaadddad	TRUE
bccccaaadadcca	TRUE
bcdddcdcaacccd	TRUE
bcdddcdddadcaa	TRUE
bdccaddcaccdaa	TRUE
bdcccaacaddada	TRUE
bdddadaddacdad	TRUE
bdddadcaaacddd	TRUE
cacbaacdadcccd	TRUE
cacbaadadacdcc	TRUE
cbadaaaaadcacc	TRUE
cbadaacdacaccd	TRUE
cbdccacaccddad	TRUE
cbdccacddddcac	TRUE
ccbdccacaacccc	TRUE
ccbdccacaacdac	TRUE
cdabcacdacdddc	TRUE
cdabccadddcdca	TRUE
cdcdcaaabdcdcd	TRUE
cdcdccccbcddac	TRUE
dabaacdacddadc	TRUE
dabaacdccdccaa	TRUE
dadbdaccadcdad	TRUE
dadbdaccaddacd	TRUE
dbcccddaaccccd	TRUE
dbcccddaddadaa	TRUE
dcacabddccddcd	TRUE
dcacacbcdadccd	TRUE
dcdacdbaaaccca	TRUE
dcdacddbcaaddd	TRUE
ddbcdaddddccca	TRUE
ddbcdcccacccaa	TRUE
aaaaaacbacccab	FALSE
aaaaabcdbddadb	FALSE
aacccadacbcdbb	FALSE
aacccdacaaaaaa	FALSE
abbacbbbccbcbb	FALSE
abbacccbbdaadd	FALSE
abdccddccbbbcc	FALSE
abdcdccdbabbdb	FALSE
accbacaaacddab	FALSE
accbacacbdbadd	FALSE
adadbbcdacdacb	FALSE
adadbbddcbbabc	FALSE
addcabbbdbbdcd	FALSE
addcabcbddddac	FALSE
baccaabacccdaa	FALSE
baccaadbcbadbc	FALSE
bbbcacaadadcad	FALSE
bbbcacbdaabbcd	FALSE
bbdddacbadcdcc	FALSE
bbdddadbacdadc	FALSE
bccbcddbdbdbac	FALSE
bccbdbacbccacc	FALSE
bdadacccbacbcb	FALSE
bdadacdbdcaabb	FALSE
bddbacccdbdada	FALSE
bddbadacbcacdd	FALSE
cacbaabdadbbbd	FALSE
cacbaadadabdcb	FALSE
cbadcbaadcbdba	FALSE
cbadccaaccbabd	FALSE
cbdadbaabcdccc	FALSE
cbdadbbcbabbaa	FALSE
ccbdbbbaabcbab	FALSE
ccbdbbcbddabba	FALSE
cdabbcadcbcddd	FALSE
cdabbcbcadddbd	FALSE
cdcdcaaabdbccd	FALSE
cdcdccccbccdab	FALSE
dababbadcbcdac	FALSE
dababbcacdbbaa	FALSE
dadbdbbaaccbad	FALSE
dadbdbddbdcbab	FALSE
dbcabbdddcdcad	FALSE
dbcabcdabccabd	FALSE
dcacabddccddbd	FALSE
dcacacbccadbbd	FALSE
dcdacdbaabcbcb	FALSE
dcdacddbbaacdd	FALSE
ddbcbacbbbcddc	FALSE
ddbcbadcbbbacb	FALSE
aaaaaadbddcadac	TRUE
aaaaaadcacbaacc	TRUE
aacdadcbadacccc	TRUE
aacdbaaccdacaad	TRUE
abaddcccadacdad	TRUE
abaddccdddcaccd	TRUE
abdddccdacccaaa	TRUE
abdddcdaddcdaac	TRUE
accabdcdddacddc	TRUE
accacaacdacbdca	TRUE
adadcdbcacaaaad	TRUE
adadcdbddacacac	TRUE
addbddaddccaddc	TRUE
addbdddcddaddcc	TRUE
bacacdcdaadddcd	TRUE
bacacddacccacda	TRUE
badcdcaaadddddc	TRUE
badcdcacccadadd	TRUE
bcaddcaadddadac	TRUE
bcaddcadaaddcac	TRUE
bcdcacddadaaccd	TRUE
bcdcacddadcdcdd	TRUE
bdadacccaaaaadc	TRUE
bdadacccdaaddad	TRUE
bddaacdacaaccda	TRUE
bddaacddcaadcca	TRUE
cabacaddacccdcd	TRUE
cabaccaaacdaada	TRUE
cadcacdaaacdaba	TRUE
cadcbaaadddcaac	TRUE
cbcccacdcaadaad	TRUE
cbccccadccacddc	TRUE
ccabcdcaaaaddac	TRUE
ccabcdcacddddcd	TRUE
ccdaccdbdccdaac	TRUE
ccdaccdcadcbcad	TRUE
cdbddddcccdcadc	TRUE
cdbddddcddacaad	TRUE
daacaabdacaaddd	TRUE
daacaabdaddadcd	TRUE
dacdbdacaadcdad	TRUE
dacdbdcaacadada	TRUE
dbcacccdcdccddd	TRUE
dbcaccdcaacaccd	TRUE
dcaadcbddcaadda	TRUE
dcaadccbdaaaada	TRUE
dccdacbaddaaddd	TRUE
dccdbaddcddddaa	TRUE
ddbcdcacaadaccc	TRUE
ddbcdcacaccddcd	TRUE
aaaaaadbdcbadab	FALSE
aaaaaadcacbbacb	FALSE
aacdadcbadabbbb	FALSE
aacdbaabccdacab	FALSE
abbadcbdadcaaba	FALSE
abbadddcdbdbbcd	FALSE
abddcbdbbacbcaa	FALSE
abddcbdbcddcccc	FALSE
accabddbcdbbdcc	FALSE
accacaacdacbdcb	FALSE
adadcdbbacababc	FALSE
adadcdbdcacbbab	FALSE
addbdcddbacdcdc	FALSE
addbdcddcdaddcb	FALSE
bacaadcaccccacb	FALSE
bacababbcbbcada	FALSE
bbacbdbdcadbcdc	FALSE
bbaccabcabdadab	FALSE
bbcddccbcacadaa	FALSE
bbcdddacbbdbdbc	FALSE
bcbbdbccdddcabb	FALSE
bcbbdbdaabbcbdb	FALSE
bdaaaacddabbcda	FALSE
bdaaabdacacdbdc	FALSE
bdcbbcadaddbdaa	FALSE
bdcbbcccbabadbc	FALSE
cabaccabaadcbdb	FALSE
cabacdadadaaacb	FALSE
cadcacdaaacdabb	FALSE
cadcbabdadddcba	FALSE
cbbddabcbbacdbd	FALSE
cbbddbabbbadbcb	FALSE
ccabcabddbbacca	FALSE
ccabccdacdddccb	FALSE
ccdaccdbdccdaab	FALSE
ccdaccdcadcbbad	FALSE
cdbddccccbbdbcc	FALSE
cdbdddcaddacaab	FALSE
daacaabccbdaadd	FALSE
daacaabcdccadcb	FALSE
dacdbcdccaadcdb	FALSE
dacdbdbaabbdada	FALSE
dbbcbdcdbccbaba	FALSE
dbbccbbbbdaacdc	FALSE
dcaadcbccbabcca	FALSE
dcaadccbdaaaadb	FALSE
dccdacbaddaaddb	FALSE
dccdbaccbccddaa	FALSE
ddbcbbacdbcbacd	FALSE
ddbcbdcdbbcddcd	FALSE
aaaaaacaccbccacc	TRUE
aaaaabadccadcdad	TRUE
aacbccdcadddcddc	TRUE
aacbccddadcccdcc	TRUE
abadaaadcccdddcc	TRUE
abadaacdaccccada	TRUE
abdcddddaadccdaa	TRUE
abddaaacacdaaaca	TRUE
accabcadccaadaac	TRUE
accabcdccaacdcdc	TRUE
adacdacabaaaaaaa	TRUE
adacdaccbcadcada	TRUE
addadaaabcdaddca	TRUE
addadbaadaacacda	TRUE
bacaacdaaadcddad	TRUE
bacaacdaddddddad	TRUE
badcacadacdadcac	TRUE
badcacadcaaccccc	TRUE
bcadaddccacadcad	TRUE
bcadcaaacddacadd	TRUE
bcdcadcadddcdccc	TRUE
bcdcaddacaadaadd	TRUE
bdaddaaacccdaaad	TRUE
bdaddaadacdccacd	TRUE
bddccacacdadadad	TRUE
bddccacddcaddcaa	TRUE
cabccdccdddddccc	TRUE
cabccddcdaccccaa	TRUE
cadcabaacadcacdd	TRUE
cadcabdadcdccdcc	TRUE
cbccdadcaaccaadc	TRUE
cbccdcacacccdadc	TRUE
ccacbcaacccaddac	TRUE
ccacbcadcdacddac	TRUE
ccdbaaddddcaddca	TRUE
ccdbacdcdadaddca	TRUE
cdcaacbdddacadaa	TRUE
cdcaacccddcdccbc	TRUE
daabdccddaacaadd	TRUE
daabddcaaadcadac	TRUE
dadadbdcddcaacad	TRUE
dadaddbccdaaaaad	TRUE
dbcccacccddaaadd	TRUE
dbcccadccccccdac	TRUE
dcacccadadcdcbca	TRUE
dcaccddaccdbcdaa	TRUE
dcdbaccdadcddcdd	TRUE
dcdbacddaddcaadc	TRUE
ddbcdcddcaaaccac	TRUE
ddbcdcddccdaaddd	TRUE
aaaaaacaccbcbbcc	FALSE
aaaaabbdbbadcdac	FALSE
aacbbbadcaabaadd	FALSE
aacbbcdacdbaadad	FALSE
abadbdbdadaccdbc	FALSE
abadbdbddcbcdddb	FALSE
abdcaccbaadaaabb	FALSE
abdcacdbdaccbcab	FALSE
accabbccabcbacba	FALSE
accabcbbbabdcdbc	FALSE
adacdacabaaaaaba	FALSE
adacdaccbcadcacb	FALSE
addadaaabcdbddba	FALSE
addadbbadbacabca	FALSE
babcddbaaaaabccc	FALSE
babcddcabbabdcca	FALSE
bbabcdadacddddca	FALSE
bbabdcbbcddaabdb	FALSE
bbdaccbaabdaadab	FALSE
bbdacdcbdbcaabda	FALSE
bcbdbadddbccadad	FALSE
bcbdbcbccbdbadbb	FALSE
bdacaabbdbdabccd	FALSE
bdacaacacaadabdb	FALSE
bddaabbacdaddcab	FALSE
bddaadbadaccbbbc	FALSE
cabcaddccccbbbbc	FALSE
cabcbaccccdadcdc	FALSE
cadcabaacacbbcdc	FALSE
cadcabdadbdbbccb	FALSE
cbcacadddacddcab	FALSE
cbcacbaaaadbcdbc	FALSE
ccacbbaabbcaddac	FALSE
ccacbbadcdabdcac	FALSE
ccdbacbddddcacdc	FALSE
ccdbbcaaddcabccb	FALSE
cdcaacbdddacbdab	FALSE
cdcaacccddcdccbb	FALSE
daabddcaaaddddba	FALSE
daabddcbbdbacaca	FALSE
dadadbdbdcbbacad	FALSE
dadaddbcbdaaaabd	FALSE
dbbddbccbdbbdbba	FALSE
dbbddbdacbccbcbd	FALSE
dcacccadadcdcbcb	FALSE
dcaccddaccdbbdaa	FALSE
dcdbacbbaadbcdbc	FALSE
dcdbacdccbdccaad	FALSE
ddbcadacabdcaacb	FALSE
ddbcadddddbaddda	FALSE
aaaaaaaadaccdabad	TRUE
aaaaaabcdacdaadda	TRUE
aacbdcccadcaddaad	TRUE
aacbdcdaacaadddac	TRUE
abadaadaadccdcdcd	TRUE
abadacadddcddadda	TRUE
abdcddadddaadcdca	TRUE
abddaaaacccdaddcc	TRUE
acbdcdddcadcdaaca	TRUE
acbddadacdddcdaaa	TRUE
adabdaccaccacdcdd	TRUE
adabdaddcadaccccc	TRUE
addacbccddccdccaa	TRUE
addacbdacdcdaccdd	TRUE
baaddccaaaaddccdd	TRUE
baaddccdadcaaadad	TRUE
badcadadcaddddada	TRUE
badcadcccdcdaacaa	TRUE
bcadccdcdcaacaadc	TRUE
bcadcdaccdadcaaac	TRUE
bcdcadcaacadcccac	TRUE
bcdcadccacddcadca	TRUE
bdcaaaacacdadddaa	TRUE
bdcaaacccccaaaddd	TRUE
bddcadcaccaacacca	TRUE
bddcaddaaaadadadc	TRUE
cabacacaadacadadc	TRUE
cabaccacccddcadcc	TRUE
cadcdbacccaccacda	TRUE
cadcdbadaaaaaacac	TRUE
cbcdadacacdcadcca	TRUE
cbcdadacdccaddccc	TRUE
ccbacaccdadaaaccd	TRUE
ccbaccdacddddccca	TRUE
ccdbdcccdcdccdaac	TRUE
ccdcabddcdaadaaac	TRUE
cdcbaadacdacdaaad	TRUE
cdcbacdccaccdcaaa	TRUE
daadacdddcabdadad	TRUE
daadbcadccaacddcc	TRUE
dadbdcadadaddadcd	TRUE
dadbdcaddddccacaa	TRUE
dbcdaddddccaddaad	TRUE
dbcdcaadcaacaaaca	TRUE
dcaddcdcbddaaacca	TRUE
dcadddcbaaddcdacd	TRUE
dcdbcacccaccccdca	TRUE
dcdbccacdcacdadcd	TRUE
ddbcaccdcadaaadcc	TRUE
ddbcacdaaaaaaacca	TRUE
aaaaaabbbcbcbddbb	FALSE
aaaaacddbcddabbdc	FALSE
aaccddcadcdddacdc	FALSE
aaccdddcaddabdbbd	FALSE
abbbbbddddbabccad	FALSE
abbbbcbccbacaadba	FALSE
abdcccdbbdacbbdcc	FALSE
abdccdaaadddbddcc	FALSE
accbbbddbddbbacda	FALSE
accbcaadbcdcddacc	FALSE
adaddbbaaabbaddaa	FALSE
adbaaaadcdbbaaaab	FALSE
addbdaaaddcddcbdb	FALSE
addbdadadadaaabdc	FALSE
babcdbdbbdcadacad	FALSE
babcdbdcadbaaabcb	FALSE
bbabcadbddcaddcdc	FALSE
bbabdabdddabbccdd	FALSE
bbcdcdacacaddcbbd	FALSE
bbcdcdbdccaabbcdb	FALSE
bcbdadcaabcdbcdbc	FALSE
bcbdaddaaacbdcdbc	FALSE
bdabadbdbaddcddca	FALSE
bdabbabcdacbdbdda	FALSE
bddabaacacbcddcac	FALSE
bddababbcaaadadda	FALSE
cabccdaddbadaccdc	FALSE
cabcdbdbdabaccacb	FALSE
cbaadbacbbdcbadcd	FALSE
cbaadcdabcbdcccbd	FALSE
cbcbddabaccadcaac	FALSE
cbcbddddcdcccacda	FALSE
ccbabcccbabaaaaac	FALSE
ccbabdcccbcbadbca	FALSE
ccddcaaabcbadabbd	FALSE
ccddcaaaddcabcdbd	FALSE
cdcadabbdbadbdbaa	FALSE
cdcadadadcccbcdba	FALSE
daadacdbdabaaacaa	FALSE
daadacdcbaadaaccb	FALSE
dacdccbaccdaacaab	FALSE
dacdcdcdcacddbcab	FALSE
dbbdabccdadcdbcaa	FALSE
dbbdacbbbaaddcabc	FALSE
dcabccdcaccaaccbd	FALSE
dcabccdcadcbdaadb	FALSE
dccdbdbbbccdcdbbb	FALSE
dccdcabbadbabaabd	FALSE
ddbbbcbbbcbcabdca	FALSE
ddbbbccccaddddcda	FALSE
aaaaaabcccadcddacd	TRUE
aaaaacdbcddaccdccd	TRUE
aacdadbacaddcdaddd	TRUE
aacdbaacaadcadcdcc	TRUE
abaddddccccadccada	TRUE
abcaaaaccdacccacca	TRUE
abddadddaddcadccad	TRUE
abddcdadcaccadcadc	TRUE
accbacaacadcdacaad	TRUE
accbacaaddcccddcdc	TRUE
adadcaaadddbaccaaa	TRUE
adadccacabacaadddc	TRUE
addbadacdadadcccac	TRUE
addbadddadacacddcd	TRUE
bacaadacddccdadadc	TRUE
bacaadaddcaacaacac	TRUE
badcccccdcddacccda	TRUE
badcccddaaddacacdc	TRUE
bccaaadacddadaadca	TRUE
bccaaadadadaacaaca	TRUE
bcdccdccaaddcadcac	TRUE
bcdccddaccacaddcdd	TRUE
bdcaacacdccacdadda	TRUE
bdcaacadadccaaaada	TRUE
bddcccacaccdcacdca	TRUE
bddcccacadcadcdaaa	TRUE
cabcaddcacccddacdd	TRUE
cabccacdcaaddcdaad	TRUE
cbaadcaaddccdcaaaa	TRUE
cbaadcdccadaccccaa	TRUE
cbdacadadaddcdaccd	TRUE
cbdacadadcadcadccd	TRUE
ccbaccdadaaddacaca	TRUE
ccbadaaccaacddaccc	TRUE
ccdbddcacccaccccca	TRUE
ccdbddddaddcaadaac	TRUE
cdcacbacddddcacdda	TRUE
cdcacbadaadaadaada	TRUE
daadabddcdccccddca	TRUE
daadacacdbaaccaaad	TRUE
dadacabadcaacccdad	TRUE
dadacbcaddcddcaddd	TRUE
dbcacdacacddddadac	TRUE
dbcacdacdacadcdadc	TRUE
dcabcaaadcadaddaac	TRUE
dcabcaaccadacadadd	TRUE
dccccbdcddaacacddd	TRUE
dccccbddddcaaacdcd	TRUE
ddbcaddcdaacadaaca	TRUE
ddbccaaccadaaaaddc	TRUE
aaaaaaacbbbbbaadcd	FALSE
aaaaaababadaaacaab	FALSE
aacbcddbaadaaaccdc	FALSE
aacbdababbdaaacbbd	FALSE
abbbbdbddaacdbbadd	FALSE
abbbcbcbddbbbdcbcb	FALSE
acaababacdcddabbab	FALSE
acaabcbcbbdbbbaddd	FALSE
acccbdaabdddddcddc	FALSE
acccbdbcdcbbdaabcb	FALSE
adadadcbaaadbbdada	FALSE
adadbaacbacccbcadd	FALSE
addcbccaadbccddcbd	FALSE
addcbcdcbaddbbdcac	FALSE
bacbdccadadddadbaa	FALSE
baccacaabbbadddcbc	FALSE
bbbbadbbbadaaadcca	FALSE
bbbbbaadbbdbcaaccc	FALSE
bbdccbbbddcdcabdbc	FALSE
bbdccbdcadcabbddab	FALSE
bccabbacacccbcabba	FALSE
bccabcbabdcddbccba	FALSE
bdadbababcabacbccd	FALSE
bdadbcaacdbdddccca	FALSE
bddbdacacbabbbabab	FALSE
bddbdaddbbbbcdddba	FALSE
cabccddabccdadcddd	FALSE
cabcdbabcabdcadbcb	FALSE
cbabdaaabcdabacdca	FALSE
cbabdaabddddbcabcc	FALSE
cbcdbdacbcbddbdaca	FALSE
cbcdbdcbcbcdbaabcd	FALSE
ccbbdabcdbabdcccda	FALSE
ccbbdbbdbcdcdadcac	FALSE
ccdddaccbaaddddccb	FALSE
ccdddadaadcbacbacd	FALSE
cdcacadbcccccaaccb	FALSE
cdcacdcbccdbdaaccb	FALSE
daadacbcbccabcdadc	FALSE
daadadbadccdbcddba	FALSE
dadcdbcbbddabdaddc	FALSE
dadcdcaccabcdcbbac	FALSE
dbcadcabadbbcbbada	FALSE
dbcadcdcccdbdbcadc	FALSE
dcaccbdcdcdbcaacab	FALSE
dcaccbddbdbcdabddd	FALSE
dcdacbbddccddcdcca	FALSE
dcdacbcbabdccdbbcb	FALSE
ddbcaacbdcbdcbdcac	FALSE
ddbcaacbddbcdacdcc	FALSE
aaaaaaacbcaaaaadcdd	TRUE
aaaaaabcadaaacaacaa	TRUE
aaccacdabccaadadcac	TRUE
aaccbcdaacaaddadaad	TRUE
abaddcaaaadcadccdcc	TRUE
abaddcaccaccdaaacda	TRUE
acaaadbaccaccadcaca	TRUE
acaaadcbccdddadcacc	TRUE
accbdcaacaadcdcaaaa	TRUE
accbdcaaddaadcccadc	TRUE
adaddacadcdbccccdcc	TRUE
adaddacdcaccabcccdc	TRUE
addcbdaaacddadcddcc	TRUE
addccbddcddcacdadda	TRUE
bacadaadacdacaddddd	TRUE
bacadaccaccadcaddcc	TRUE
baddaddaaddcaacaccd	TRUE
baddcaaaaccaddaadca	TRUE
bccadcadccccccdcccc	TRUE
bccadcadccdcacdaacd	TRUE
bcdcdccacaaccaddcaa	TRUE
bcdcdccaddcacacaaac	TRUE
bdcacaaccdacccdcada	TRUE
bdcacaacddaacdacdcc	TRUE
bddcdcaacaccaadcdac	TRUE
bddcdcaccdcdddaacaa	TRUE
cabdadcadaaaaacdcdd	TRUE
cabdadddccdadcadacd	TRUE
cbaaccdcaadaaacaddc	TRUE
cbaacdadcdccddcacac	TRUE
cbcddddadaccacadcaa	TRUE
cbdaaacacdaaccccadd	TRUE
ccbacddcaaadadccdaa	TRUE
ccbacddcaaddadacddc	TRUE
ccddbacdddaaaaaacda	TRUE
ccddbcacdacadaddccc	TRUE
cdccabcadadddccdaaa	TRUE
cdccabdddcdacdcadcc	TRUE
daadadbcccaaccccdca	TRUE
daadbccaacdcdddaccd	TRUE
dadadadabdcdaacaaca	TRUE
dadadbcddccdccdcdcd	TRUE
dbcaddaddaadadccdaa	TRUE
dbcaddcdaccacaccdcc	TRUE
dcaacbadaaaccdaddac	TRUE
dcaaccbacccacdccdca	TRUE
dcccbcdaaaaaccaacdc	TRUE
dccccadbddddcddacac	TRUE
ddbadacacdaadcdcada	TRUE
ddbadcaccddacaaccda	TRUE
aaaaacadaaddcbbaaba	FALSE
aaaaacdcbcbccabcbaa	FALSE
aaccacaabaaacdaddcb	FALSE
aaccacdccddbcccbcbd	FALSE
abbabbbcdaddabaabcc	FALSE
abbabbcaadbcaadbcad	FALSE
abdcdacadcbdcbdacab	FALSE
abdcdacadcdbdacadaa	FALSE
acccbbbddaacaacbbba	FALSE
acccbccadaabaddbaad	FALSE
adbabccbdccbaaaabcc	FALSE
adbacacaabcabddcbdd	FALSE
addcdbcddbcaaaadcbb	FALSE
addcdbdcdbacbbadcdb	FALSE
bacacdbbbccadabbcbd	FALSE
bacadadcddbacbadcad	FALSE
bbadabddbcccdbbcdba	FALSE
bbadacaadbbdbbcbdab	FALSE
bbdabcdabbbcbcbddcb	FALSE
bbdabdbddcabaccddbb	FALSE
bcbccbabbbdbdddccbb	FALSE
bcbcccbaacdbabbdcca	FALSE
bdababdddadcccabccc	FALSE
bdabadcbdbaaababacd	FALSE
bdcdabdcbdcdcbbcdad	FALSE
bdcdacbdbacabbacadc	FALSE
cabbbacccdabbddbcab	FALSE
cabbbadcccdbabcdcad	FALSE
cadcddbdbadbabbdbac	FALSE
cadcddcacaacccadcda	FALSE
cbcbbbdddbbcddbdddc	FALSE
cbcbbcdaaadcaccaabc	FALSE
ccbabccdbddbacadcac	FALSE
ccbacaacacbbdadadca	FALSE
ccddadadddcbcdcddcb	FALSE
ccddbabdddacadcaccc	FALSE
cdcabcaaadcddcbbbcc	FALSE
cdcabcaadddcccbbaad	FALSE
daacaabdacbccccdbba	FALSE
daacabadbcabddacaad	FALSE
dacdccbddaabddadadb	FALSE
dacdccdcbacabaabbab	FALSE
dbbbdcbbbcbccabacca	FALSE
dbbbddbbcaacddacbdd	FALSE
dcaacdbdbbbbaabaaba	FALSE
dcaadabaacbaaaadbcb	FALSE
dccdaaabbbabaacbbcc	FALSE
dccdabbaacadadaadbd	FALSE
ddbcacbcbbaaccabcbc	FALSE
ddbcbbaccbcddacdbac	FALSE
