aaaaaaadcd	TRUE
aaaaaacada	TRUE
aaccdcadda	TRUE
aaccdccccc	TRUE
abaacaadad	TRUE
abaacacdcc	TRUE
abccccaddc	TRUE
abcccccadd	TRUE
acaaaaaacc	TRUE
acaaaaccdd	TRUE
acccaadaab	TRUE
acccaadaad	TRUE
acddccdacd	TRUE
acddccdcab	TRUE
adcacadacc	TRUE
adcacadccb	TRUE
adddaaacdb	TRUE
adddaaadcc	TRUE
caadcdcaaa	TRUE
caadcdcdca	TRUE
cadaacaaab	TRUE
cadaacaaad	TRUE
caddddccaa	TRUE
caddddccdd	TRUE
cccaacdcab	TRUE
cccaacddca	TRUE
ccdaaddddd	TRUE
ccdacaadcb	TRUE
cdaaaddcab	TRUE
cdaacaaacc	TRUE
cdccaaccca	TRUE
cdccaacdda	TRUE
cddcaccdad	TRUE
cddcaccddb	TRUE
daacadcccd	TRUE
daacadcdcb	TRUE
dacccacacd	TRUE
dacccaccca	TRUE
dadcdadcdb	TRUE
dadcdadcdb	TRUE
dcadaacaab	TRUE
dcadaadcaa	TRUE
dccdcaddcd	TRUE
dccdccaadc	TRUE
dcddcdaacd	TRUE
dcddcdadcc	TRUE
ddadcdcadc	TRUE
ddadcddcca	TRUE
ddcddaaaac	TRUE
ddcddaaacc	TRUE
aaaaaadaba	FALSE
aaaaaadbdb	FALSE
aacdaacbaa	FALSE
aacdaaddbc	FALSE
abbcaccbbc	FALSE
abbcaccbcc	FALSE
acababaabb	FALSE
acababaacc	FALSE
acccddbcdd	FALSE
accdaacdbb	FALSE
adbabdacaa	FALSE
adbaccaaab	FALSE
addcbdabaa	FALSE
addccdcdbd	FALSE
babdcddcdd	FALSE
babddadbdd	FALSE
bbaaddaddd	FALSE
bbaaddbdca	FALSE
bbccacbcdb	FALSE
bbccadcbcb	FALSE
bcaddbbaac	FALSE
bcaddbcaca	FALSE
bcddadbcaa	FALSE
bcddadbdba	FALSE
bdccabbcda	FALSE
bdccacbddd	FALSE
cabaddbadc	FALSE
cabbaabacb	FALSE
cadcddadba	FALSE
cadcddbaaa	FALSE
cbcbbcdddc	FALSE
cbcbbdddaa	FALSE
ccadcabdbc	FALSE
ccadcacdbb	FALSE
ccdbacadac	FALSE
ccdbbcbbca	FALSE
cdbdababcc	FALSE
cdbdabbdcd	FALSE
daabbadada	FALSE
daabbbabcc	FALSE
dacdcbcaac	FALSE
dacdcccaba	FALSE
dbbbdbdcca	FALSE
dbbcaabbac	FALSE
dcababaadc	FALSE
dcabaccbbc	FALSE
dccccbcdca	FALSE
dcccccabbc	FALSE
ddbacaddaa	FALSE
ddbaccaaca	FALSE
aaaaaaadcda	TRUE
aaaaaaccadc	TRUE
aaccddacadb	TRUE
aaccddaddaa	TRUE
abaaccddaad	TRUE
abaacdacacc	TRUE
abccdacaddc	TRUE
abccdacccad	TRUE
acaaaaaaaad	TRUE
acaaaaaddaa	TRUE
acccdacaadb	TRUE
acccdaccdcd	TRUE
acddccddaac	TRUE
acddcdaadcb	TRUE
adcadcccaaa	TRUE
adcadccccda	TRUE
addcdaccdcb	TRUE
addcdacdaad	TRUE
caadcccdccb	TRUE
caadcccdccc	TRUE
cacddaddacd	TRUE
cacddccacca	TRUE
cadddddaadd	TRUE
cadddddacdd	TRUE
ccaddadcaca	TRUE
ccaddcaaccc	TRUE
ccdaadcaada	TRUE
ccdaadccdca	TRUE
cdaadadaccd	TRUE
cdaadcaaadc	TRUE
cdcadaccacc	TRUE
cdcadacdcdd	TRUE
cddadacccdc	TRUE
cddadadaacd	TRUE
daacacddcda	TRUE
daacacddddc	TRUE
dacadddaacc	TRUE
dacadddacab	TRUE
dadcccacdca	TRUE
dadcccadcaa	TRUE
dcaccacdddb	TRUE
dcaccadaacb	TRUE
dccccdccadb	TRUE
dccccddcdaa	TRUE
dcdccccaccc	TRUE
dcdccccddad	TRUE
ddadaadaadd	TRUE
ddadaadcaab	TRUE
ddcdcaadcdc	TRUE
ddcdcaadddd	TRUE
aaaaaadadbd	FALSE
aaaaaadbbdc	FALSE
aaccdbcddbb	FALSE
aaccdcdddbd	FALSE
abbccddbbba	FALSE
abbcdadbcac	FALSE
acaadaadcbb	FALSE
acaadabdacd	FALSE
accdaabddbd	FALSE
accdaaccdbb	FALSE
adbaabddbbb	FALSE
adbaadadaca	FALSE
addbddabacc	FALSE
addbdddabbd	FALSE
bacbbbdddbb	FALSE
bacbbcdadba	FALSE
bbadaadbaab	FALSE
bbadaadbcbd	FALSE
bbdbdddcbcd	FALSE
bbdcaaacbca	FALSE
bcbcbdabcaa	FALSE
bcbccabdcba	FALSE
bcddddccccb	FALSE
bdaaabbddac	FALSE
bdccbcccbcc	FALSE
bdccbccdadb	FALSE
cabaacbddda	FALSE
cabaacdacab	FALSE
cadcddbcdac	FALSE
cadcddcbdda	FALSE
cbcaddbaacb	FALSE
cbcbaddacdd	FALSE
ccadabbacdc	FALSE
ccadabbcbda	FALSE
ccdbaadddcd	FALSE
ccdbabddaaa	FALSE
cdbcdbbccca	FALSE
cdbcdcbbbab	FALSE
daaadabcbaa	FALSE
daaadcdcbbd	FALSE
daccbdbabdc	FALSE
dacccaddcbc	FALSE
dbbadbadbca	FALSE
dbbadcaacab	FALSE
dbddbabdccd	FALSE
dbddbddcbba	FALSE
dcccbabccab	FALSE
dcccbbbadac	FALSE
ddbacccdacd	FALSE
ddbaccdcaac	FALSE
aaaaacaaadca	TRUE
aaaaacadcdcc	TRUE
aaccaddaddaa	TRUE
aacccaccdaaa	TRUE
aadcddcccaad	TRUE
aadcddcdacac	TRUE
abcacddcacdd	TRUE
abcacddcdccc	TRUE
abdcdacdcdda	TRUE
abdcdadcaddd	TRUE
accaadcddadd	TRUE
accaadcddccc	TRUE
acdcadcaddda	TRUE
acdcadcdacaa	TRUE
adadadcccaad	TRUE
adadcaaaaddc	TRUE
addadaaaacdc	TRUE
addadaaccacd	TRUE
caaccaadaddd	TRUE
caaccacacadb	TRUE
caccccccdaac	TRUE
caccccdcdccb	TRUE
cadcdaadccdb	TRUE
cadcdacacada	TRUE
ccacdcdcccdd	TRUE
ccacddacccaa	TRUE
cccdacaaaddc	TRUE
cccdacaadadb	TRUE
ccddcadcccda	TRUE
ccddcadddcdd	TRUE
cdcaaaadaaab	TRUE
cdcaaaadccac	TRUE
cddacaccccda	TRUE
cddacadccdab	TRUE
daaadcdddcaa	TRUE
daaadcddddca	TRUE
dacccacdaaaa	TRUE
dacccacdaada	TRUE
dadcccccaccb	TRUE
dadccccdaccc	TRUE
dcaccdcaacac	TRUE
dcaccdccdcca	TRUE
dccdacdadcca	TRUE
dccdacdcdcda	TRUE
dcddcdcadaca	TRUE
dcddcddddacc	TRUE
ddaddcadadac	TRUE
ddaddccaadcd	TRUE
ddcddacdacdd	TRUE
ddcddadccddc	TRUE
aaaaabbabada	FALSE
aaaaabcbacab	FALSE
aacacdcabaca	FALSE
aacadabdcbbd	FALSE
abadbbaaddaa	FALSE
abadbbbcadbd	FALSE
abdcaacaccbb	FALSE
abdcabdbbddc	FALSE
acbdddabbdad	FALSE
acbdddacdadb	FALSE
adabcbdbcbaa	FALSE
adabccaaaabb	FALSE
addabcbaacdb	FALSE
addabcdbddab	FALSE
babbdddadcbc	FALSE
babcacabddbd	FALSE
badddddbbbac	FALSE
badddddbcdcc	FALSE
bbccacbcdaca	FALSE
bbccaccadadc	FALSE
bcbabbbbaabb	FALSE
bcbabbccabca	FALSE
bcdcdcaccdad	FALSE
bcddaaaadadb	FALSE
bdcbccbbabcb	FALSE
bdcbdbabbccb	FALSE
caadbbdadddd	FALSE
caadbbdbcadc	FALSE
cadbbbadddad	FALSE
cadbbbddbacc	FALSE
cbcbacdbcdad	FALSE
cbcbadaddcda	FALSE
ccbabbbdcbda	FALSE
ccbabbdddaaa	FALSE
ccdcccbddcbd	FALSE
ccdccccbbbba	FALSE
cdcabacccccd	FALSE
cdcabaccdaca	FALSE
daadabcdcbac	FALSE
daadacccbabd	FALSE
dadbbdbadbbb	FALSE
dadbbdbbdcaa	FALSE
dbbddddbdadd	FALSE
dbcaacbbaada	FALSE
dcacccdacbba	FALSE
dcaccdaaddbb	FALSE
dcdabddddcba	FALSE
dcdaccdbdddd	FALSE
ddbadbdcdacb	FALSE
ddbadbddbdba	FALSE
aaaaacaaadcac	TRUE
aaaaacaddcdda	TRUE
aaccacacddcdc	TRUE
aaccacccccdad	TRUE
aaddaaadccadc	TRUE
aaddaaccccdca	TRUE
abcaccaacccda	TRUE
abcaccaacdaac	TRUE
abdcdaccccadd	TRUE
abdcdadacdaca	TRUE
acadddacdccdb	TRUE
acadddcaaadaa	TRUE
acdaddcaaccad	TRUE
acdaddccaadac	TRUE
adadadaccccad	TRUE
adadadcadcdda	TRUE
addaccdcddacd	TRUE
addaccddaaacd	TRUE
caacccdcdcdaa	TRUE
caacccddcddca	TRUE
caccdadaaccad	TRUE
caccdadadcdac	TRUE
caddaaaccddcc	TRUE
caddaacdadaad	TRUE
ccadcadaaadda	TRUE
ccadccaadcdda	TRUE
cccdddaacdccd	TRUE
cccdddccdcaab	TRUE
cdaaaddaccdab	TRUE
cdaaaddcacdaa	TRUE
cdcacccccdcdb	TRUE
cdcacccdaacda	TRUE
cddadcacddcab	TRUE
cddadcccdcddc	TRUE
daacaaadadcda	TRUE
daacaacacaaac	TRUE
daccacacddacd	TRUE
daccacadcddda	TRUE
dadcaadaaadab	TRUE
dadcaadaadccd	TRUE
dcacadcadaaca	TRUE
dcacaddccddad	TRUE
dcccddccaaaac	TRUE
dcccddcccdcca	TRUE
dcddadaaddadd	TRUE
dcddadcaacdca	TRUE
ddadccacdcaaa	TRUE
ddadcccaccdda	TRUE
ddcddaddaddab	TRUE
ddcddccacaddb	TRUE
aaaaabcdacaad	FALSE
aaaaacdabacdc	FALSE
aacbbacdbbadd	FALSE
aacbbadaaacda	FALSE
abbabaabdccac	FALSE
abbabacbbbaac	FALSE
abdccacabcbdc	FALSE
abdccacbddcbd	FALSE
accbcacccadbb	FALSE
accbcbcbdbdaa	FALSE
adbabcacbdbda	FALSE
adbabdcdcabbc	FALSE
addbaaddcdcba	FALSE
addbbcabdbccd	FALSE
babcbdcacbccb	FALSE
babcbddaaabdc	FALSE
baddbaabcdaad	FALSE
baddbcaabacbc	FALSE
bbcacdddcccbc	FALSE
bbcadaadaddcc	FALSE
bcadccabdaccb	FALSE
bcadcccbcccac	FALSE
bcdcabdabdbdb	FALSE
bcdcaccdcbada	FALSE
bdcbbacdccbda	FALSE
bdcbbbadabbab	FALSE
caadacbaaccad	FALSE
caadacbabbdbb	FALSE
cadadbadcccac	FALSE
cadadbcdbcccb	FALSE
cbcabadcacdad	FALSE
cbcabcadcbbdb	FALSE
ccacdbcacdbbd	FALSE
ccacdbccbacca	FALSE
ccdacbacaaddd	FALSE
ccdaccbbbdbad	FALSE
cdbcbaccdadca	FALSE
cdbcbbccbacac	FALSE
daaaacdaadbca	FALSE
daaabdddcaabb	FALSE
dacdcdccadabd	FALSE
dacddaacbacdb	FALSE
dbbccabdbcadb	FALSE
dbbccbaabaadb	FALSE
dcaabcdadadad	FALSE
dcaabdaaccddd	FALSE
dcccddaadccbc	FALSE
dccdabdccaacc	FALSE
ddbbcbabadabd	FALSE
ddbbcbcbdadaa	FALSE
aaaaaaadacdcdc	TRUE
aaaaaaccdcdcaa	TRUE
aaccadcccadcdc	TRUE
aaccadccdaadcb	TRUE
aaddadaaccdadc	TRUE
aaddadadcdccdc	TRUE
abcaaacacddccc	TRUE
abcaaadadaacdd	TRUE
abdcacacadadda	TRUE
abdcacacddccca	TRUE
acadcccdcadacb	TRUE
acadccdadcaadc	TRUE
acdaddaaddcdab	TRUE
acdaddcadaadcc	TRUE
adadcadccccddd	TRUE
adadcaddaacacb	TRUE
addaddddaaaaca	TRUE
addcaaaacdadaa	TRUE
caaccacdaadadb	TRUE
caaccacdcccdca	TRUE
cacccddcdacdab	TRUE
caccdaaacaaacc	TRUE
cadcaddcdcdacd	TRUE
cadccaaaccdacd	TRUE
ccacdacdccaaaa	TRUE
ccacdacdddcacb	TRUE
ccccdcccdadccd	TRUE
ccccdcdaacddca	TRUE
ccddaaacdccadb	TRUE
ccddaacacadaad	TRUE
cdadadacacaaac	TRUE
cdadadadcddddd	TRUE
cdcdccdaccacda	TRUE
cdcdcdaaaaaaad	TRUE
cddddcdaccddac	TRUE
cdddddaccaaccd	TRUE
dacaadcccaaacd	TRUE
dacaadcdcdcddb	TRUE
dadacacccacdad	TRUE
dadacacdcadaad	TRUE
dcaaccdaddadad	TRUE
dcaaccdcaacddc	TRUE
dcccaadcadcaac	TRUE
dcccacaaacdada	TRUE
dcdcdaacdacadc	TRUE
dcdcdaccacaacc	TRUE
ddadcaaccaaaca	TRUE
ddadcacaacddac	TRUE
ddcdcaddaccaab	TRUE
ddcdcaddcaacab	TRUE
aaaaaabcccdcbc	FALSE
aaaaaabdabacbd	FALSE
aaccabaddccaad	FALSE
aaccbacacbcabb	FALSE
abbacdcbddabaa	FALSE
abbacdddbccabc	FALSE
abdcdbdddddaab	FALSE
abddaacbdbccba	FALSE
accbbbdaccbdca	FALSE
accbbcbbdaaacd	FALSE
adbaaaaccbcdcd	FALSE
adbaaadcbbdaaa	FALSE
adddcaaddacbdd	FALSE
adddccbaaddadd	FALSE
bacbddccdbbcdd	FALSE
baccabbacccaad	FALSE
bbbacccdabbccd	FALSE
bbbaccdbbadadd	FALSE
bbddccdadcbccb	FALSE
bbddcdcdbadbab	FALSE
bccabddcddbcbc	FALSE
bccacabccddbdc	FALSE
bdacdadadcbccd	FALSE
bdacdbaadbacab	FALSE
bddbabcdbcdcad	FALSE
bddbabdcccadba	FALSE
cabcbcdacbdada	FALSE
cabcbdacccdbcb	FALSE
caddccdbaccabd	FALSE
cadddacdcbaada	FALSE
cbcbcbacdcdcbb	FALSE
cbcbccbcdaccab	FALSE
ccacddadbbcddb	FALSE
ccadabaadbaddd	FALSE
ccdcdcdcbdadaa	FALSE
ccdcddadcddbaa	FALSE
cdcbcadcabdbad	FALSE
cdcbccaaadddbd	FALSE
daadbbbbcadccd	FALSE
daadbbdcdbcdcb	FALSE
dadbdaacacdbda	FALSE
dadbdabbbaaccd	FALSE
dbcabdbddcbbdb	FALSE
dbcacaabbaaccd	FALSE
dcabdbbcbddadc	FALSE
dcabdbbdcaaacc	FALSE
dccddcbdbddadc	FALSE
dccddcdabacaca	FALSE
ddbdabdbbcccad	FALSE
ddbdabddabccda	FALSE
aaaaaaadcaccddb	TRUE
aaaaaacaddccddc	TRUE
aaccaaacadcadac	TRUE
aaccaacaacccdcd	TRUE
aadddcdaacacccd	TRUE
aadddcdadacdddb	TRUE
abccacdacdadcdc	TRUE
abccacdccaacaaa	TRUE
abddadccdacdaaa	TRUE
abddaddadcdaccd	TRUE
accadaddadadccd	TRUE
accadcaacddaacc	TRUE
acddacaccdccdca	TRUE
acddacaccddadaa	TRUE
adccaacdacdaccc	TRUE
adccaaddddddcad	TRUE
addddaacaaacdca	TRUE
addddaccdccccab	TRUE
caaddacaddaaadc	TRUE
caaddacaddacccb	TRUE
cadaaaadcadcdcd	TRUE
cadaaacddaacccc	TRUE
ccaacdcaaaadada	TRUE
ccaacddcddaacda	TRUE
ccccaccacacaccc	TRUE
ccccaccadcdcdad	TRUE
ccdcccacdaaccdd	TRUE
ccdcccacddadcdd	TRUE
cdaccdcddddacdd	TRUE
cdaccddacddcdac	TRUE
cdcccddadddccca	TRUE
cdcccddccccaacb	TRUE
cddccdaccadadad	TRUE
cddccdacccdcdaa	TRUE
daacccaaddddadc	TRUE
daacccccaacadaa	TRUE
daccdaaacadcadb	TRUE
daccdacccccadcc	TRUE
dadcdaccdcccaaa	TRUE
dadcdacdddccaac	TRUE
dcadaaccccdadcc	TRUE
dcadaacdcacccda	TRUE
dccdaccdaaaaaaa	TRUE
dccdacdaccadcda	TRUE
dcddacadddcccaa	TRUE
dcddacadddddaca	TRUE
ddadaaaccacadcd	TRUE
ddadaaadacddacc	TRUE
ddcdcdcdcacddda	TRUE
ddcdcdddcacacaa	TRUE
aaaaaacccdbcdbb	FALSE
aaaaabcdbacabdc	FALSE
aacccaddbcccaab	FALSE
aaccccabdabdccb	FALSE
abbacaabaaccacd	FALSE
abbacdcbbddcabc	FALSE
abdbbbbbbccddcd	FALSE
abdbbccaaddabad	FALSE
acbcbacdbcacddc	FALSE
acbcbadbcbdaabd	FALSE
acdddaccccacdbd	FALSE
acdddccacbbdaac	FALSE
adccccddcbbdcad	FALSE
adccdadbdcaadca	FALSE
babacaabdabdaac	FALSE
babacadccacccac	FALSE
badcbaccadcdcbc	FALSE
badcbcaabddadcd	FALSE
bbcdacdbbbdcaad	FALSE
bbcdadabcbccbcc	FALSE
bcbbbbaadababbb	FALSE
bcbbbbbcbdabcad	FALSE
bcdddacadbdbcdb	FALSE
bcdddacadcbbddb	FALSE
bdcbbbcabbadaab	FALSE
bdcbbbdaabbabdb	FALSE
caacdaccadcacbc	FALSE
caacdadbabccbbc	FALSE
cadabccbcdddacd	FALSE
cadabdccdcddcbb	FALSE
cbbcacadabcadda	FALSE
cbbcacddbcaccbd	FALSE
ccaacdcbcbbbacc	FALSE
ccaacddddcddbdd	FALSE
cccccdcacddaaba	FALSE
cccccddbccdbaaa	FALSE
cdbbbaabcccbaaa	FALSE
cdbbbabdabddbcd	FALSE
cdddbcdaaacdabd	FALSE
cdddcacdaaabbcb	FALSE
dacbaaadcbdabac	FALSE
dacbaccadbdcadc	FALSE
dbadcaddacaabab	FALSE
dbadcbbdcdcddbc	FALSE
dbddbbddbaaaccb	FALSE
dbddbcbabdacaad	FALSE
dccbdbdbccacdbd	FALSE
dccbdcacddbdcab	FALSE
ddbadbabbdaabbd	FALSE
ddbadcbbbbdcdaa	FALSE
aaaaaacaacddacab	TRUE
aaaaaacadcacadcb	TRUE
aaccacddacdcaaaa	TRUE
aaccadaacaaaddad	TRUE
abaaaccdcdcadcad	TRUE
abaaacdacddddaad	TRUE
abcaddaccdadcaad	TRUE
abcaddaddadcadca	TRUE
abddaadaddddcadc	TRUE
abddaadccaccaadc	TRUE
accacaaadaacacdb	TRUE
accacaacacacccac	TRUE
acdcacdddddadddd	TRUE
acdcadccccccdcab	TRUE
adadaaadcaddddaa	TRUE
adadaacaadcacadc	TRUE
addacddcaddaccad	TRUE
addacddccccadcdc	TRUE
caaccaadcaaaadad	TRUE
caaccacaccdddccd	TRUE
caccaddacdddcddc	TRUE
caccaddccadacddc	TRUE
cadcccaadccacddd	TRUE
cadcccadaccaddda	TRUE
ccacdcdaaccaacac	TRUE
ccacdcdaaddaddcc	TRUE
cccdacadccdcccca	TRUE
cccdacadddaaadab	TRUE
ccddaccadcdaccab	TRUE
ccddaccadddcdaad	TRUE
cdadcaacacaadacb	TRUE
cdadcaadadddcaab	TRUE
cddaaaaaddadcddd	TRUE
cddaaacaaaddaada	TRUE
daaaaacacdccacca	TRUE
daaaaaccdcccddac	TRUE
dacaccaaaccccdda	TRUE
dacaccadadadcadb	TRUE
dadcaadaaacddaac	TRUE
dadcaadccdddaaad	TRUE
dcacdaaaacacdcaa	TRUE
dcacdaadccdadacb	TRUE
dcccddacdddcddda	TRUE
dcccddcacaacacad	TRUE
dcddaacdcdaacdda	TRUE
dcddaadaacdcadcd	TRUE
ddacdcddaadddacb	TRUE
ddacdcddadccadcc	TRUE
ddcdcccdcdcdcacb	TRUE
ddcdcdaacacdadaa	TRUE
aaaaaadadaccdbdc	FALSE
aaaaacabaccbdcda	FALSE
aacbdaabbaabccdd	FALSE
aacbdbaadbbcccda	FALSE
abbbaadadabacdbd	FALSE
abbbabdadbbcacca	FALSE
abddaacadbbadacc	FALSE
abddaadadbadcbdc	FALSE
accabbabaaccabdd	FALSE
accabbbdbabdabab	FALSE
adabbbbbcdcaacad	FALSE
adabbcdabcacbcda	FALSE
addadddbbcdddadb	FALSE
addadddbddbbcdca	FALSE
babdabbccdbabadd	FALSE
babdabdcaadabdca	FALSE
bbabbbacdbadcacb	FALSE
bbabbbbdbdbabaaa	FALSE
bbcdaacdaacdbcbb	FALSE
bbcdabcbcdadddbc	FALSE
bcbbccbaaabcaddc	FALSE
bcbbcdaaddbaabab	FALSE
bdaadadbcaacdcbc	FALSE
bdaadccacbadbdbd	FALSE
bdccbabbcaccbcab	FALSE
bdccbbaddacdaabc	FALSE
cabaaabbcabcccda	FALSE
cabaaadbcbbccadd	FALSE
cadccdbbabaaabba	FALSE
cadcdadcbccbdddc	FALSE
cbccaddbcccdddba	FALSE
cbccbadacbcbdbdc	FALSE
ccbacdcdaacabccc	FALSE
ccbacdcddcacbaba	FALSE
ccdccbdcccaabbca	FALSE
ccdccdaccdbcaabc	FALSE
cdcbdcbcaaabcaaa	FALSE
cdcbdcdabaadbdad	FALSE
daacdbdcdcbdbcdd	FALSE
daacddcadabbdadb	FALSE
dadadabdacdbbbcd	FALSE
dadadacdddaadcbc	FALSE
dbbccaddabcbabda	FALSE
dbbccccbddddbcab	FALSE
dcaaaacbbbbacdda	FALSE
dcaaaacbdccdcbbd	FALSE
dcccaddaaaccadba	FALSE
dcccbbbabdaccadd	FALSE
ddbbdcabccbcdbbc	FALSE
ddbcaabdccabbbcc	FALSE
aaaaaccadacdadcac	TRUE
aaaaacdaccdddadcb	TRUE
aacadcdaaaadcaadb	TRUE
aacaddaaaaaadcccd	TRUE
aaddacdacccdcdadd	TRUE
aaddacdddaaaacaca	TRUE
abcacaccddacddccc	TRUE
abcacacdcccaaadaa	TRUE
abdcddacdcccaaddd	TRUE
abdcddcacdaccccda	TRUE
acaddddcaddaddddc	TRUE
accaaaaacaacdcaca	TRUE
acdcaadcccccacacd	TRUE
acdcacaaacdddaddc	TRUE
adadcdddcadacadaa	TRUE
adadcdddcadcddada	TRUE
addccccadacddcadc	TRUE
addccccddddacaacb	TRUE
caadadaaacddcdccc	TRUE
caadadadccdcaddab	TRUE
cacdadacaaadccadd	TRUE
cacdaddcccccdaccb	TRUE
caddcdcddddacaadd	TRUE
caddcddcacccacacc	TRUE
ccadcdcddaadddadd	TRUE
ccaddaaaaddcddacd	TRUE
cccdddaadaaccdccd	TRUE
cccdddaccddcdddaa	TRUE
ccddddacdaccadacc	TRUE
ccddddadcaaacdcdc	TRUE
cdcaadcdacadcacac	TRUE
cdcaaddaccccaccda	TRUE
cddaccdddcadadada	TRUE
cddacdacdadddccdc	TRUE
daaaddaaacaddcdcd	TRUE
daaaddacdddadcdca	TRUE
dacadacdaacaaaaad	TRUE
dacadacdaccadcccd	TRUE
dadaddcddcdacccca	TRUE
dadadddadcccaddcc	TRUE
dcacaacadadacdadc	TRUE
dcacaacadadcdccac	TRUE
dcccadacadcacadda	TRUE
dcccadaccacddacac	TRUE
dcdcccdcccadcaaaa	TRUE
dcdccdacaaadcccad	TRUE
ddacddccaccddadcd	TRUE
ddacdddcadacddcdd	TRUE
ddcdcccdddcdcddda	TRUE
ddcdccdcadcdccddc	TRUE
aaaaaaacdaccdacbb	FALSE
aaaaaaadbdbdddbac	FALSE
aaccbdccdbcadaccc	FALSE
aacccaaabddbbcdad	FALSE
abaddcddcbbcdabda	FALSE
abbaaabcdbbacdddd	FALSE
abdcaccabcbcbbccb	FALSE
abdcbbabdabadbccb	FALSE
accabbbabcbddcdbc	FALSE
accabcbaddcabbccc	FALSE
adacabcddbcddccca	FALSE
adacaccadcdddbacb	FALSE
addadccaaddabdddd	FALSE
addaddacddbcabbbd	FALSE
babddbddcbdcdcdbd	FALSE
babddcaabbbcbdcdd	FALSE
bbabdadccbdbcdbbd	FALSE
bbacaaadaaadaadaa	FALSE
bbcdcdbbcaabcbabc	FALSE
bbcdcdccdadadddcc	FALSE
bcbbcdcccbdbdcbab	FALSE
bcbbcddadcaacddad	FALSE
bcdcddabbabadbbbd	FALSE
bcdcddccdaaddbdac	FALSE
bdcbbaabdaacbcbac	FALSE
bdcbbbbaaacacdaaa	FALSE
cababaabcccbccdcc	FALSE
cabababaabcaacbab	FALSE
cadbadddccbadcabb	FALSE
cadbbabaadbcdaccd	FALSE
cbbcddbaacdabbddb	FALSE
cbbcddbbaccbcccaa	FALSE
ccabdcdacbaaaaaaa	FALSE
ccacaaccacaabcdcb	FALSE
ccdabbbabbdaabbab	FALSE
ccdabdabcbaddbcbb	FALSE
cdbdbcadbbacadaac	FALSE
cdbdcacdaaaccccad	FALSE
daabcccdcdcddabcd	FALSE
daabccddbbbdaabda	FALSE
dadaaaccccbacdcdb	FALSE
dadaabbdccddbddaa	FALSE
dbbddcabadbcaddad	FALSE
dbcaaabdacabaaccb	FALSE
dcabddcaaabcbcbcd	FALSE
dcacaabdaacdbaacb	FALSE
dcdbabdbdabdddabc	FALSE
dcdbacdbaadbadacb	FALSE
ddbdaabaccbbbadac	FALSE
ddbdabbcdabddbadb	FALSE
aaaaaaacccddadacaa	TRUE
aaaaaaccaadcdcaadd	TRUE
aacaddccacdacacdaa	TRUE
aacadddacacadaadaa	TRUE
aaddccddcadcdacddc	TRUE
aaddcdaadcddacaacc	TRUE
abcaddadcdccadaaca	TRUE
abcaddaddaccacddcc	TRUE
abddacdddadcddaaaa	TRUE
abddacdddaddddaacd	TRUE
accacdacaaccadcccc	TRUE
accacdcddccccdccac	TRUE
acdcddcddcaaaddacd	TRUE
acddaadacdcdccaadb	TRUE
adcacaadccacdacdcb	TRUE
adcacaaddcdadaadcb	TRUE
adddacddaaaaacccdb	TRUE
adddadadcdcaacadab	TRUE
caadaddaaaccaaddcc	TRUE
caadaddaaadaadcacc	TRUE
cacddcddaaacacadaa	TRUE
cacddcddcddccdcccc	TRUE
ccaaacdaddccdadddc	TRUE
ccaaadaaacadccadab	TRUE
cccaadddaccaacdacb	TRUE
cccaadddaccdacdacc	TRUE
ccdacacdcdaddaccaa	TRUE
ccdacacddccaaadcac	TRUE
cdaadadaddacdadaaa	TRUE
cdaadaddaddadcaddd	TRUE
cdcadcddcdacdccccb	TRUE
cdccaaaaaaacadaadb	TRUE
cddadcacaadccacacd	TRUE
cddadcadaacdcccadb	TRUE
daaaccddccaaaaddcd	TRUE
daaacdccaaacaaaaab	TRUE
daccadcacadccdcada	TRUE
daccadcadcaaaddaca	TRUE
dadccaadcdddddadac	TRUE
dadccacaadacdcdddc	TRUE
dcacdaaccdacdcaadb	TRUE
dcacdaaddaadaccada	TRUE
dccdaccdcccaacaccd	TRUE
dccdaccdddddaadcab	TRUE
dcddcdaddcdcdaccdc	TRUE
dcddcdcadcdcacadac	TRUE
ddadddcdcccdcaacaa	TRUE
ddaddddacdcddcddcd	TRUE
ddcdddcccacddadccb	TRUE
ddcddddcaaaadadcad	TRUE
aaaaaaaaddbadaaddb	FALSE
aaaaaadabcddbcdadd	FALSE
aacbbcbbabbbddabab	FALSE
aacbbccbdcccaacdba	FALSE
abadccddccdddbbdda	FALSE
abadcddabddbccbbda	FALSE
abdcbbdabadcadccca	FALSE
abdcbbdbcbcbaddccd	FALSE
accccdaadacdbcdbba	FALSE
accccdcacbcdbddddb	FALSE
adbadbbbacaabacabd	FALSE
adbadcbdcbbdabddac	FALSE
addddaabcdbcbadcca	FALSE
addddbbccbbcbacdac	FALSE
bacadadccaabddcbdc	FALSE
bacadcbaddbddabbdc	FALSE
bbacdcacbcdddcadda	FALSE
bbacdcadddbaddcabc	FALSE
bbdabaaacadcdabdab	FALSE
bbdababbcdcdcdacdd	FALSE
bcbcdaaaadcccbccca	FALSE
bcbcdabcbcaaacbdaa	FALSE
bdabcadacdadbcdada	FALSE
bdabcbbdaaaadcbadd	FALSE
bdcccdbdbadbdcbdba	FALSE
bdccdabdadabcadaac	FALSE
cabacbdbcbcaddbdda	FALSE
cabadaaacddcbdbdca	FALSE
cadcaaaacbcbbdadbb	FALSE
cadcaadaabcaacbbbd	FALSE
cbbdccdacabbdbdada	FALSE
cbbdcdcdccbacbddcd	FALSE
ccabbadbcdbacbdbcd	FALSE
ccabbbcbdbdbdbdcac	FALSE
cccdddddbdcdaaabbb	FALSE
ccdaaadbaccaaacaac	FALSE
cdbcbddbbbccdacbab	FALSE
cdbcccdcbbbcbaacab	FALSE
daabbadcccaabdccdc	FALSE
daabbbcaadcbaadbda	FALSE
dadaabcadcdbacabbb	FALSE
dadaabcdbabcacdaab	FALSE
dbbcbccdddcacbdcdd	FALSE
dbbccaccdbcaadcdcc	FALSE
dcabaaaacbdddaaddc	FALSE
dcabaadccadbabadbb	FALSE
dccdbcbbddcacddbac	FALSE
dccdbcbccdbbcabadb	FALSE
ddbcdccbcbacbcabca	FALSE
ddbcdccdaaaadacdad	FALSE
aaaaaadccacaaaadcdd	TRUE
aaaaaadccccacadcddc	TRUE
aacccdcdaaacaadddcb	TRUE
aacccdcdaddaccdccad	TRUE
abaacacddadcdadadac	TRUE
abaacaddccccdddcadd	TRUE
abcccdccaccdacadacd	TRUE
abcccddadcaacaccdcc	TRUE
acaaadaaaaaacddaccd	TRUE
acaaadacaacaaaacdad	TRUE
acccdddaaacadccaaab	TRUE
accdaaacacaaccdcacd	TRUE
adaaaaddacadaccdaac	TRUE
adaaacaaaadcdacaaab	TRUE
adcadddddaaaddcdddc	TRUE
adccaaacadddcaaddac	TRUE
adddccadddcccaddddd	TRUE
adddccccadcadcaaacb	TRUE
caaddcacddaccdcacdb	TRUE
caaddccaaadcdadacaa	TRUE
cacddcddaddacdaadaa	TRUE
cacdddaadcdddadcdad	TRUE
ccaacacdcdacdcadddd	TRUE
ccaacadacacdadacaac	TRUE
cccacccaddccdddcdda	TRUE
cccaccccdccdadcacad	TRUE
ccdacaaccaacdaadccd	TRUE
ccdacaccadcaddcdcab	TRUE
cdaadaaddddddadadca	TRUE
cdaadacccacccdddccb	TRUE
cdccacaddccadacddcd	TRUE
cdccaccdcccdacaacdd	TRUE
cddadcdaaccdacdcddb	TRUE
cddadcdccacacacdccd	TRUE
daaccaccadadadcaccd	TRUE
daaccaddaddddcadacc	TRUE
daccdcdcccccccddadc	TRUE
daccddacdcacddcacac	TRUE
daddaaccddcaadccadb	TRUE
daddaaddadacccaacad	TRUE
dcadccacdddddaacdcb	TRUE
dcadcccadcacaacadcc	TRUE
dccdcccaaddccdccdcc	TRUE
dccdcccacdaaccccdcb	TRUE
dcddccccaaaaaccddcd	TRUE
dcddcccdccdcccccdcd	TRUE
ddadddaaacdadddccab	TRUE
ddadddaccdadaaaadad	TRUE
dddaaacacacdaccacad	TRUE
dddaaaccdaccaaadaaa	TRUE
aaaaaaabaaacbbaaabc	FALSE
aaaaabdddbabbacdbca	FALSE
aaccbabcbaddacbaadb	FALSE
aaccbdbbbcabbbdbada	FALSE
abbbcbdbdabaaabdbbb	FALSE
abbbccadaddcbadbbba	FALSE
acaacabccdabcaaccac	FALSE
acaacbbcacabdadcbcb	FALSE
accdbbdabbcbabcbccd	FALSE
accdbcadcbdaabbbcaa	FALSE
adbbbbccdbdacddaada	FALSE
adbbbcaaaaccbdcaacc	FALSE
adddcddcacbabbbddac	FALSE
addddadbbbbbdbdabab	FALSE
bacbdabbbdbabbabcbc	FALSE
bacbdbacdbaccadbbbc	FALSE
bbacdabcbaabddcdcbd	FALSE
bbacdbbccacbacdcbbb	FALSE
bbdadbdddddcbbbdaab	FALSE
bbdadcbaddbbddacdbd	FALSE
bcbdbcdadbcdaddbcbc	FALSE
bcbdbdabaaabddbcbba	FALSE
bdaacdcbcccbccaabac	FALSE
bdaadaaddcdadcacbca	FALSE
bdccdbadcccaccbadaa	FALSE
bdccddacaaaaabadbba	FALSE
caadddbbcdbcbdbdcaa	FALSE
cabaaabaacdbaacabbc	FALSE
caddabbdacbdabdacbd	FALSE
caddabcabcabaaadccd	FALSE
cbcbabdacbddbadbdcb	FALSE
cbcbacbccdbbacdabdb	FALSE
ccacabadbbbdcbcdacc	FALSE
ccacabbbdabcaaccdba	FALSE
ccdbdacbabcaaacacab	FALSE
ccdbdbcbddabddbdabc	FALSE
cdcaaacaabcacbcaaba	FALSE
cdcaabdaaabbcddbcbb	FALSE
daacdabddaddaaaabdc	FALSE
daacdacbcdaadcdcbab	FALSE
dadbaaaadbccddccdad	FALSE
dadbabccbadaacacadb	FALSE
dbbcabddacddcdccaab	FALSE
dbbcacbacccbacadccb	FALSE
dcaacbbaddaaadbccba	FALSE
dcaaccbcbcdcabacbad	FALSE
dccdacadbbddddbddca	FALSE
dccdbbcbccacadbdbdb	FALSE
ddbbddacdbdbcbaaabb	FALSE
ddbcaabadcadbcbabaa	FALSE
