aaaaaaadaa	TRUE
aaaaabccdb	TRUE
aaccbcadbc	TRUE
aaccbdcadd	TRUE
abadcdacaa	TRUE
abaddaadcd	TRUE
abddccbacb	TRUE
abddccbccb	TRUE
accadacadb	TRUE
accadacbaa	TRUE
adacccbaaa	TRUE
adacccccdd	TRUE
adcddcddaa	TRUE
adcdddbadc	TRUE
baadcaabca	TRUE
baadcacabd	TRUE
badaadddac	TRUE
badacbaaba	TRUE
bcadaabdab	TRUE
bcadaacaac	TRUE
bcccccabaa	TRUE
bcccddabdd	TRUE
bdaccadcdd	TRUE
bdaccbbaad	TRUE
bddaadaaac	TRUE
bddaadaacb	TRUE
cabacccacc	TRUE
cabaccdacd	TRUE
caddbddaad	TRUE
caddcadcad	TRUE
cbccbbddac	TRUE
cbccbdaacc	TRUE
ccacbdaaaa	TRUE
ccacbddaaa	TRUE
ccdaabddda	TRUE
ccdaacabcd	TRUE
cdbdaadcba	TRUE
cdbdaccbca	TRUE
daabaddaac	TRUE
daabadddda	TRUE
dacdcacccb	TRUE
dacdcadcaa	TRUE
dbcadacbdd	TRUE
dbcadbaccd	TRUE
dcabcddaad	TRUE
dcabcddaad	TRUE
dcdacbaacc	TRUE
dcdaccbddd	TRUE
ddbcdbddaa	TRUE
ddbcdcabcc	TRUE
aaaaaaadbb	FALSE
aaaaabbcdb	FALSE
aaccbbadbc	FALSE
aaccbdbadd	FALSE
abadbdacaa	FALSE
abaddaadbd	FALSE
abddbcbacb	FALSE
abddbcbccb	FALSE
accadacabb	FALSE
accadacbab	FALSE
adacccbaab	FALSE
adacccccbb	FALSE
adcddcddbb	FALSE
adcdddbadb	FALSE
baadbaabca	FALSE
baadbacabd	FALSE
badaadddab	FALSE
badabbaaba	FALSE
bbadaabdab	FALSE
bbadaacaac	FALSE
bbccccabaa	FALSE
bbccddabdd	FALSE
bdabcadcdd	FALSE
bdabcbbaad	FALSE
bddaadaaab	FALSE
bddaadaabb	FALSE
cababccacc	FALSE
cababcdacd	FALSE
caddbddaab	FALSE
caddcadcbb	FALSE
cbbcbbddac	FALSE
cbbcbdaacc	FALSE
ccacbdaaab	FALSE
ccacbddaab	FALSE
ccdaabdddb	FALSE
ccdaacabbd	FALSE
cdbdaadbba	FALSE
cdbdabcbca	FALSE
daabaddaab	FALSE
daabaddddb	FALSE
dacdcaccbb	FALSE
dacdcadcbb	FALSE
dbbadacbdd	FALSE
dbbadbaccd	FALSE
dcabbddaad	FALSE
dcabbddaad	FALSE
dcdacbaabc	FALSE
dcdaccbddb	FALSE
ddbbdbddaa	FALSE
ddbbdcabcc	FALSE
aaaaaaadaad	TRUE
aaaaabadcdd	TRUE
aacbdcbddbd	TRUE
aaccaaaabaa	TRUE
abaddadcabb	TRUE
abaddadcacd	TRUE
abddcdaabcb	TRUE
abddcdbcabc	TRUE
accbccccacb	TRUE
accbcccccbd	TRUE
adacdcbcbdc	TRUE
adadabdcbcb	TRUE
addacdabcad	TRUE
addadaddbad	TRUE
baaddadaaaa	TRUE
baaddadaaad	TRUE
badacddbacd	TRUE
badacdddaac	TRUE
bcadccdccac	TRUE
bcadcdbcdac	TRUE
bcdaabcccad	TRUE
bcdaadcbbbb	TRUE
bdaddacbdcd	TRUE
bdaddaccbad	TRUE
bddaddaaadc	TRUE
bddaddacdca	TRUE
caadccaacdd	TRUE
caadccadbcc	TRUE
cadadacaaaa	TRUE
cadadcadddb	TRUE
cbcadacdadb	TRUE
cbcadbdcacc	TRUE
ccabdcbcbba	TRUE
ccabddaccdd	TRUE
ccdadcbdaac	TRUE
ccdaddaddda	TRUE
cdbdcbdbbca	TRUE
cdbdccdacdb	TRUE
daacacacbcb	TRUE
daacadacbdc	TRUE
dadabcacdac	TRUE
dadabcbcdba	TRUE
dbcbddabadd	TRUE
dbccaacabad	TRUE
dcabdddcbcc	TRUE
dcabddddddc	TRUE
dcdacabcada	TRUE
dcdacadcbdd	TRUE
ddbcbbadbdb	TRUE
ddbcbbcddcb	TRUE
aaaaaacbadb	FALSE
aaaaaadcabb	FALSE
aacdabddaba	FALSE
aacdabdddba	FALSE
abaddabbacc	FALSE
abaddabbcbb	FALSE
abddaaddbab	FALSE
abddabababb	FALSE
accaacbabcc	FALSE
accaacbadab	FALSE
adabbbccbcd	FALSE
adabbbdaacc	FALSE
addaccbbcdd	FALSE
addadabbbda	FALSE
baaddbbaacc	FALSE
baaddbcaaac	FALSE
badbbbbacad	FALSE
badbbbbadbb	FALSE
bbbabdcaaca	FALSE
bbbabdcbaca	FALSE
bbcdbbadcdb	FALSE
bbcdbbcdadc	FALSE
bdabcbdbbdc	FALSE
bdabcbddadd	FALSE
bddaaaaadbc	FALSE
bddaaaabbbb	FALSE
caadccddbab	FALSE
caadcdabbcc	FALSE
caddbaabacc	FALSE
caddbbabbcd	FALSE
cbbcacdaccc	FALSE
cbbcadacabd	FALSE
ccacbbcacbd	FALSE
ccaccabbcdb	FALSE
cccddbabdda	FALSE
cccddbdaabd	FALSE
cdbbaaacbca	FALSE
cdbbaadbbbb	FALSE
daaaabdbddd	FALSE
daaaadaabdb	FALSE
dacdbdaadab	FALSE
dacdccbddbb	FALSE
dbbadaccdbc	FALSE
dbbadadcbbd	FALSE
dcabbcaabca	FALSE
dcabbccaaab	FALSE
dcdaaddbbdc	FALSE
dcdabbdbcba	FALSE
ddbbcdaddac	FALSE
ddbbcdbacca	FALSE
aaaaaacbadaa	TRUE
aaaaaadaacad	TRUE
aacccddccada	TRUE
aaccdaabcacc	TRUE
abadcadbbabd	TRUE
abadcadcccda	TRUE
abdcdddabddc	TRUE
abdcdddbacaa	TRUE
acbddcccdbbb	TRUE
acbdddadddca	TRUE
adacacaacccb	TRUE
adacbacccccd	TRUE
addadaaaaccb	TRUE
addadadabdcd	TRUE
baaddddcbccd	TRUE
bacaaabcbbbb	TRUE
badcaacacaaa	TRUE
badcabadbdad	TRUE
bcbacbdadadc	TRUE
bcbaccbdadad	TRUE
bcdabcaaccbc	TRUE
bcdabccadbda	TRUE
bdadaacabdbd	TRUE
bdadaadcddbd	TRUE
bddacabcdabd	TRUE
bddacacaccaa	TRUE
caadadcbadcb	TRUE
caadbaddcbbb	TRUE
cadccadadcbd	TRUE
cadcccabcdcb	TRUE
cbccccbbbbbd	TRUE
cbccccdaccbb	TRUE
ccacaadaddbd	TRUE
ccacabddaadd	TRUE
ccdadbcbddcd	TRUE
ccdaddaaaccc	TRUE
cdbcdddbcccc	TRUE
cdbdaaaaaacd	TRUE
daaabaddcbba	TRUE
daaabcdcdadc	TRUE
daccdaaddcca	TRUE
daccdcaabaad	TRUE
dbcabcbcbdbc	TRUE
dbcabddadbac	TRUE
dcabaaccbbdc	TRUE
dcabaaccdcda	TRUE
dcccdbaadaac	TRUE
dcccdbcbccad	TRUE
ddbcbbadabbd	TRUE
ddbcbbbaabbc	TRUE
aaaaaacbadab	FALSE
aaaaaadaacbb	FALSE
aacccddccabb	FALSE
aaccdaabbacc	FALSE
abadbadbbabd	FALSE
abadbadcccda	FALSE
abdbdddabddc	FALSE
abdbdddbacaa	FALSE
acbddbccdbbb	FALSE
acbdddadddba	FALSE
adacacaaccbb	FALSE
adacbabccccd	FALSE
addadaaaacbb	FALSE
addadadabdbd	FALSE
baaddddbbccd	FALSE
babaaabcbbbb	FALSE
badbaacacaaa	FALSE
badbabadbdad	FALSE
bbbacbdadadc	FALSE
bbbaccbdadad	FALSE
bbdabcaaccbc	FALSE
bbdabccadbda	FALSE
bdadaababdbd	FALSE
bdadaadbddbd	FALSE
bddababcdabd	FALSE
bddabacaccaa	FALSE
caadadcbadbb	FALSE
caadbaddbbbb	FALSE
cadccadadcbb	FALSE
cadcccabbdcb	FALSE
cbbcccbbbbbd	FALSE
cbbcccdaccbb	FALSE
ccacaadaddbb	FALSE
ccacabddaadb	FALSE
ccdadbbbddcd	FALSE
ccdaddaaacbb	FALSE
cdbbdddbcccc	FALSE
cdbdaaaaaabd	FALSE
daaabaddbbba	FALSE
daaabbdcdadc	FALSE
daccdaaddcbb	FALSE
daccdcaabaab	FALSE
dbbabcbcbdbc	FALSE
dbbabddadbac	FALSE
dcabaabcbbdc	FALSE
dcabaabcdcda	FALSE
dcccdbaadaab	FALSE
dcccdbbbccad	FALSE
ddbbbbadabbd	FALSE
ddbbbbbaabbc	FALSE
aaaaaadcaccbc	TRUE
aaaaabdcbaddc	TRUE
aacdacbcadcaa	TRUE
aacdacbddddaa	TRUE
abadcbadddcda	TRUE
abadcbcdbddca	TRUE
abdcdcabdbcbc	TRUE
abdcdcadcbbbb	TRUE
accabccdcabad	TRUE
accabdcabdcac	TRUE
adbaacbcbdbcc	TRUE
adbaadadddcad	TRUE
addbcdccacacd	TRUE
addbdacadbdbc	TRUE
bacacdbbcdccc	TRUE
bacacdbcacdcc	TRUE
baddadadcdddd	TRUE
baddadcdcbddb	TRUE
bcbcdaabcbcba	TRUE
bcbcdabbdabbc	TRUE
bcdbbddbcaabd	TRUE
bcdbcaabaacad	TRUE
bdcacccbbcbda	TRUE
bdcacdccccbdb	TRUE
bddcbcddcbddc	TRUE
bddcbdadbbccc	TRUE
cabdadcddbddd	TRUE
cabdaddddcddc	TRUE
cbaaddccacadb	TRUE
cbaaddcccbacd	TRUE
cbdadaadaaadd	TRUE
cbdadadcbcdbc	TRUE
ccbccdbaacaac	TRUE
ccbccdbbcabda	TRUE
cdaacbdadadcb	TRUE
cdaacbdaddaad	TRUE
cdccdabcababa	TRUE
cdccdbadcccdd	TRUE
dabaddcbcbddc	TRUE
dabadddaaacdc	TRUE
dadcddbadaacd	TRUE
daddaaadbdaaa	TRUE
dbccdabcbcbba	TRUE
dbccdbaabacab	TRUE
dcaccabaadaad	TRUE
dcaccbadcbcaa	TRUE
dcdadccbccbbb	TRUE
dcdbaadadddcd	TRUE
ddbdaadaaacab	TRUE
ddbdacacaadca	TRUE
aaaaaadcaccbb	FALSE
aaaaabdbbaddc	FALSE
aacdacbbadcaa	FALSE
aacdacbddddab	FALSE
abadbbadddcda	FALSE
abadbbcdbddca	FALSE
abdbdcabdbcbc	FALSE
abdbdcadcbbbb	FALSE
accabbcdcabad	FALSE
accabdbabdcac	FALSE
adbaabbcbdbcc	FALSE
adbaadadddbad	FALSE
addbbdccacacd	FALSE
addbdabadbdbc	FALSE
babacdbbcdccc	FALSE
babacdbcacdcc	FALSE
baddadadbdddd	FALSE
baddadbdcbddb	FALSE
bbbcdaabcbcba	FALSE
bbbcdabbdabbc	FALSE
bbdbbddbcaabd	FALSE
bbdbcaabaacad	FALSE
bdbacccbbcbda	FALSE
bdbacdccccbdb	FALSE
bddbbcddcbddc	FALSE
bddbbdadbbccc	FALSE
cabdadbddbddd	FALSE
cabdaddddbddc	FALSE
cbaaddbcacadb	FALSE
cbaaddbccbacd	FALSE
cbdadaadaaadb	FALSE
cbdadadbbcdbc	FALSE
ccbbcdbaacaac	FALSE
ccbbcdbbcabda	FALSE
cdaacbdadadbb	FALSE
cdaacbdaddaab	FALSE
cdccdabbababa	FALSE
cdccdbadbccdd	FALSE
dabaddbbcbddc	FALSE
dabadddaaabdc	FALSE
dadcddbadaabd	FALSE
daddaaadbdaab	FALSE
dbbcdabcbcbba	FALSE
dbbcdbaabacab	FALSE
dcaccabaadaab	FALSE
dcaccbadbbcaa	FALSE
dcdadccbbcbbb	FALSE
dcdbaadadddbd	FALSE
ddbdaadaaabab	FALSE
ddbdabacaadca	FALSE
aaaaaadcaccbca	TRUE
aaaaabcbaddccc	TRUE
aaccdaddadddbc	TRUE
aaccdcdabadcaa	TRUE
abadadccbcccdd	TRUE
abadaddaaadddc	TRUE
abddaacdbbabcb	TRUE
abddaadaaadddc	TRUE
accbaccdbacadd	TRUE
accbadcbdbadda	TRUE
adadadbdcbcdad	TRUE
adadadcaaacbca	TRUE
addcaadcbddadd	TRUE
addcaddcabccdc	TRUE
bacabdcaadacdc	TRUE
bacacaaabacdad	TRUE
badcbcccbcbcaa	TRUE
badcbcdbdadacd	TRUE
bcbbbaaabbaabb	TRUE
bcbbbabacbdbcd	TRUE
bcdacbbacbaccb	TRUE
bcdaccabbcaabc	TRUE
bdaddaddccdcdc	TRUE
bdaddaddcdcadd	TRUE
bddcbdbabdcdbd	TRUE
bddcbdbcccbcbb	TRUE
cabcdddaacadca	TRUE
cabcdddbdabbad	TRUE
cbaaaddacddcda	TRUE
cbaacabddcddbd	TRUE
cbdacddbcccdba	TRUE
cbdadaaaadddac	TRUE
ccbcdabdcbbacc	TRUE
ccbcdbabaaccad	TRUE
cdabaaddaaccaa	TRUE
cdabaadddcdbdc	TRUE
cdcccbcbdccbdd	TRUE
cdcccddbacabdd	TRUE
dabaaaacbbddbd	TRUE
dabaaaaccadacc	TRUE
dadbdacabbccba	TRUE
dadbdacccacaaa	TRUE
dbcbbdbbaaccbb	TRUE
dbcbbdcacdbdcb	TRUE
dcabacacadbdcd	TRUE
dcabacbdbbccbb	TRUE
dccdbdddcabccc	TRUE
dccdbddddddddd	TRUE
ddbadcdcdccdbd	TRUE
ddbaddddddadcb	TRUE
aaaaaaddcacabb	FALSE
aaaaabaaabcddd	FALSE
aacbddbcbbdcdc	FALSE
aaccacbabdbabc	FALSE
abadbdbddabaaa	FALSE
abadbddaccbcba	FALSE
abddbcddacddac	FALSE
abddbdcdcccbac	FALSE
accbdaaabccbab	FALSE
accbdababdcbbb	FALSE
adbaddadababad	FALSE
adbaddadabdddc	FALSE
addbddddddadab	FALSE
addcaaddacbbbc	FALSE
babadbddbdbaac	FALSE
babadcadaabbba	FALSE
badbdadcdadaab	FALSE
badbdbcddccacb	FALSE
bbbbbbacaddbcd	FALSE
bbbbbbbbbbddca	FALSE
bbdadcbccadaca	FALSE
bbdaddcdddcccd	FALSE
bdadbabbcccbbc	FALSE
bdadbacbbcdccc	FALSE
bddadbadabbaac	FALSE
bddadbbcbabada	FALSE
cababcdbbcadcb	FALSE
cababdabcaadda	FALSE
cadcbddbbcabda	FALSE
cadccbddbbddab	FALSE
cbbcbcbbbccbaa	FALSE
cbbcbdacbbbadb	FALSE
ccacbbdabbaacd	FALSE
ccacbdaaaaaddb	FALSE
ccdacbabcdabca	FALSE
ccdacbbdbaacbc	FALSE
cdbbdccbbddcbc	FALSE
cdbdaaabcccabd	FALSE
cdddddacccbbbd	FALSE
daaaaaacdbdbca	FALSE
dacdaaabdbbcbc	FALSE
dacdaaccdbadbd	FALSE
dbbaadabbbaaab	FALSE
dbbaadabbcddbc	FALSE
dcaaabbcdcaacb	FALSE
dcaabaaddadbbd	FALSE
dcccaadccdccbb	FALSE
dcccabaadaddba	FALSE
ddbabcacdddaba	FALSE
ddbabcbcaabccd	FALSE
aaaaaaddcacabdd	TRUE
aaaaabaadaccddd	TRUE
aaccabdaaddcccb	TRUE
aaccabddadadcad	TRUE
abadcaabbcacabd	TRUE
abadcadabcacaba	TRUE
abddcdcdcacaaab	TRUE
abdddcabdaabbda	TRUE
acccbdcadbdbdbd	TRUE
acccbdcbdbacbad	TRUE
adbaaddaaadddaa	TRUE
adbaadddaaaaccb	TRUE
addcbcacacacdad	TRUE
addcbcccbdbcbad	TRUE
bacabdaabaacdbc	TRUE
bacabddaacbddba	TRUE
badcdaaabbddbbb	TRUE
badcdaaadbbcbac	TRUE
bcbbaadbbbaacba	TRUE
bcbbaaddcbdadda	TRUE
bcdabacbdaddcaa	TRUE
bcdabbabbacdabd	TRUE
bdadcaaddcccbcb	TRUE
bdadcabaabcdcbc	TRUE
bddadcbcdbbcbda	TRUE
bddadcccdaaaddc	TRUE
cabacacddddcddc	TRUE
cabacadbddbbacc	TRUE
caddbaacacbbaaa	TRUE
caddbaadaaddddc	TRUE
cbccdbdadbabdca	TRUE
cbccdcbcdabddac	TRUE
ccaccdccbaddccd	TRUE
ccaccddbcdcccac	TRUE
cccdcddaaadcdbc	TRUE
cccddaaabcadcca	TRUE
cdbcaababacbaac	TRUE
cdbcabdadbacbbd	TRUE
cddddcbcacadccd	TRUE
daaaaacddbcabbc	TRUE
daccccbadcacdcb	TRUE
dacccccbdacdacb	TRUE
dbadddcdccdacad	TRUE
dbaddddacbadaac	TRUE
dbdddaaacdacdbd	TRUE
dbdddaaacdadcda	TRUE
dcccacadcaddddc	TRUE
dcccbacdddbcdbd	TRUE
ddbcccdbbcdadaa	TRUE
ddbcccdcaabaccd	TRUE
aaaaabbcbcccacb	FALSE
aaaaabbdbcdbabb	FALSE
aaccccbbcacbccc	FALSE
aacccccccbbdacc	FALSE
ababdadaabbbabd	FALSE
ababdcaccbdabdb	FALSE
abdbdcccddbcdac	FALSE
abdbdcdbacdcaba	FALSE
accacccbbcdcbcc	FALSE
accacccdcbbdacb	FALSE
adacccadadababd	FALSE
adacdadcccadbab	FALSE
addbbabdabccdbd	FALSE
addbbadcdbbdaca	FALSE
babaabadabbacbc	FALSE
babaacbdcbcdaad	FALSE
badbcdabbdbcbbc	FALSE
badbcdadcdccadc	FALSE
bbbababaabadacc	FALSE
bbbabbacbdaaaca	FALSE
bbdaadabdaabcba	FALSE
bbdabaadcbccbba	FALSE
bdabdaddadaaccc	FALSE
bdabdadddadddbb	FALSE
bddaadabcacbcdb	FALSE
bddaadbbbbbcdad	FALSE
cabaaabdcbdaacd	FALSE
cabaaadabcabadc	FALSE
cadccccaabbbbbb	FALSE
cadccddcbbbbcdd	FALSE
cbbdabaadbdbcdd	FALSE
cbbdabaddbbdcbb	FALSE
ccbabcbdbcdbaba	FALSE
ccbabccbcadabab	FALSE
ccdbdbdbcdcaada	FALSE
ccdbddadabcabab	FALSE
cdcaacbaaadaadb	FALSE
cdcaaddacabdbdd	FALSE
daadbabcbaaaada	FALSE
daadbbbaabcbdcd	FALSE
dadbbcacdcaacdb	FALSE
dadbbcbbcabacad	FALSE
dbbbcaadadacddc	FALSE
dbbbcadbabdabdd	FALSE
dcaadadcacbbcda	FALSE
dcaadcbabaccada	FALSE
dccdaabdbcbbadc	FALSE
dccdaccdbdbaddd	FALSE
ddbadbbabcdacba	FALSE
ddbaddabbbacbdb	FALSE
aaaaabccbcccacba	TRUE
aaaaabcdcdbabbbc	TRUE
aaccabaddcdddabc	TRUE
aaccabddcacabdac	TRUE
abadadcbabbaccab	TRUE
abadadcbbacbcbdb	TRUE
abddadcbbcbacaaa	TRUE
abddaddaaacdddcc	TRUE
accabdcaacbadbdb	TRUE
accacbaacdccccac	TRUE
adacbacacaabccac	TRUE
adacbdaaddddacdd	TRUE
addbacbbabdbbcdc	TRUE
addbadacbadaadad	TRUE
bacabbcdbacacbcd	TRUE
bacabbdadbcdcdda	TRUE
baddaaaddadddccd	TRUE
baddaacdcbaaabbd	TRUE
bcbccbbaadacbbbb	TRUE
bcbccbdabacadbad	TRUE
bcdbadadcabbaadc	TRUE
bcdbadadddcbbadb	TRUE
bdadcbdbbdcacddb	TRUE
bdadccadabdcdcdd	TRUE
bddaccbcdbacdddd	TRUE
bddacddcddcbdcda	TRUE
caaddbdcbaabbbdb	TRUE
caaddbdcddcdddab	TRUE
cadbaccbabdccdbc	TRUE
cadbadaadacbbcbc	TRUE
cbcbcbaacbadaada	TRUE
cbcbcdbbbaacadaa	TRUE
ccabadddcdbacbba	TRUE
ccabcababadbdcba	TRUE
ccdbaacddaccbbdd	TRUE
ccdbacaadddaaccd	TRUE
cdcabaaacacabccd	TRUE
cdcabacabdbcbbad	TRUE
daadadacddaaccaa	TRUE
daadbaaacdccbbad	TRUE
dadcaacaccadadab	TRUE
dadcacabdcaddabd	TRUE
dbcbbdcbbabcdbba	TRUE
dbcbbdccdbcbdadc	TRUE
dcaadcdcacadaddd	TRUE
dcaaddbacbcccbcb	TRUE
dccdddaddacaacbc	TRUE
dcdaaaacccabdccc	TRUE
ddbdacccbdcbdcda	TRUE
ddbdadcdcbabbdba	TRUE
aaaaaaaaaadcbbad	FALSE
aaaaaaabddbacaac	FALSE
aaccdbbaccdaaadc	FALSE
aaccdbbcbbddbddc	FALSE
abbadacbbbadcbbd	FALSE
abbadacdacaccbcd	FALSE
acaacbbcddbaacdb	FALSE
acaacbddadaabccd	FALSE
acccddbbbdcaccca	FALSE
acccdddbbdabadac	FALSE
adbadabbbaaababa	FALSE
adbadbacadacddad	FALSE
adddbdbaacaacbcd	FALSE
adddcacaacdccabb	FALSE
babacddadbdbcdac	FALSE
babacddcacbbdbda	FALSE
badbdaabadbccadd	FALSE
badbdbadccabdcac	FALSE
bbbbbdbdaadcccdb	FALSE
bbbbbddddacdcaac	FALSE
bbdbcdcdadbdccba	FALSE
bbdbdadccdaacdca	FALSE
bdaddaddbacdcaac	FALSE
bdaddadddbcaabad	FALSE
bddbcacbaddbcbdc	FALSE
bddbcadbaaccdbca	FALSE
cabdbaacacdbdbdd	FALSE
cabdbacdaabbacca	FALSE
cbaadaabadbabaad	FALSE
cbaadaabbdbadbcb	FALSE
cbdaaaaaaaddaaab	FALSE
cbdaaaabbdbbbbcd	FALSE
ccbaaabbbddddaaa	FALSE
ccbaaadaaaabdbaa	FALSE
ccdcacccaabbabaa	FALSE
ccdcadcadddadbab	FALSE
cdcbaadabddddcdb	FALSE
cdcbaadddbaaaadc	FALSE
daaccdaaccdacabb	FALSE
daaccdacdcadcdbb	FALSE
dadabaddbacdbcca	FALSE
dadabbacaaaaacbb	FALSE
dbbcaadcbaaacacb	FALSE
dbbcabbbdbaaadcd	FALSE
dcabbabccdabdbdb	FALSE
dcabbbbdddaacaaa	FALSE
dccdccadbaddbada	FALSE
dccddabaaaadbdcc	FALSE
ddbdaaabddcaaaba	FALSE
ddbdaaadabddadda	FALSE
aaaaaaaaaadcbcadd	TRUE
aaaaaaabdcacaacbb	TRUE
aacdabcdcccbdcdcc	TRUE
aacdabdadaaaaaaaa	TRUE
abcabbdcdcacdbcac	TRUE
abcabdaaaabcbaaca	TRUE
acaaddcacdaacdabc	TRUE
acabaaacdbacccbad	TRUE
acccbcdbacaccbcad	TRUE
acccbdaddcccbcdad	TRUE
adbacbccaccbacdbd	TRUE
adbacbdddbddcddab	TRUE
adddadacdbadacaba	TRUE
adddbaaaccabadcba	TRUE
bacadaddccbdbdacd	TRUE
bacadbbcdaacaabdc	TRUE
baddccbaaaaccbccd	TRUE
baddccbdcdaacbccc	TRUE
bcbdbacaaacdbddca	TRUE
bcbdbbaaadacbaaaa	TRUE
bcdcacdcbaddbcaaa	TRUE
bcdcacddcdcabbdad	TRUE
bdcabdbcabbcdccba	TRUE
bdcabdcacbccaccdd	TRUE
bddcdcdbdcabacaba	TRUE
bdddaaaaacacdcbcc	TRUE
cabcccabacbdccaba	TRUE
cabccccabdaabbbcd	TRUE
caddadbcacaccbadc	TRUE
caddaddaaabddccac	TRUE
cbcdbcbbbbbddbcda	TRUE
cbcdbcccbacdabcca	TRUE
ccbaadccaadccacad	TRUE
ccbaadccbddcccddd	TRUE
ccdcbacbbbdbcccdd	TRUE
ccdcbcacdcbdaacdd	TRUE
cdcaaccaadcbddada	TRUE
cdcabcbaaadbabacc	TRUE
daacdcaacccdacdca	TRUE
daacdcbaaadccdddd	TRUE
dadaaabaacabccccb	TRUE
dadaaadaddcbaddac	TRUE
dbcbadbddbaabcada	TRUE
dbcbaddcbaabcccda	TRUE
dcabaadaadadddacd	TRUE
dcabacacbacaaaabb	TRUE
dccdbacbaddddcbdb	TRUE
dccdbaccbcbacbbca	TRUE
ddbaccaabcccababd	TRUE
ddbaccacaabdcabbd	TRUE
aaaaaaababdbcaabd	FALSE
aaaaaaabddabdbdab	FALSE
aaccacdcaadbbbddd	FALSE
aaccbaaadaadbcccd	FALSE
abadabddaacbacada	FALSE
abadadddadbabacda	FALSE
abddabbbbcbccdaba	FALSE
abddabdacaabcabdc	FALSE
accababccacbdccbb	FALSE
accababdcbadcbcbc	FALSE
adacbdbddbabddcbc	FALSE
adaccabdbcaadadad	FALSE
addadcbdbaaacabaa	FALSE
addadcdbddadabddd	FALSE
baaddbdacbbbbcadc	FALSE
baaddbdbbacccdcbc	FALSE
badbcaabdbadbbddd	FALSE
badbcabbdbadabdad	FALSE
bbaddbadcbcabadba	FALSE
bbaddbbcbdcabbaab	FALSE
bbcdabadbdddbcaba	FALSE
bbcdabdbbbcaacadd	FALSE
bdabbadccaccbcccd	FALSE
bdabbbabacdaddddc	FALSE
bdbdcdccaacbcdacd	FALSE
bdbddabbadbcdcbbb	FALSE
caacaacbbdbdacacd	FALSE
caacaadbbcdbdacda	FALSE
cacdcddaaddbadbab	FALSE
cacddacbabadaaaab	FALSE
cbbacaccbdcaccabd	FALSE
cbbacacccbdbddddd	FALSE
ccabbbaadbddadadd	FALSE
ccabbbbdbdddcdacb	FALSE
ccdadcbbaadcaccda	FALSE
ccdadcdabaabacaab	FALSE
cdbdabbcdacddcdda	FALSE
cdbdadbdaabbaacad	FALSE
daababdaadbcacbab	FALSE
daababddbcbdcdcdb	FALSE
daccdbbbddcccacac	FALSE
daccdcabdbcbbbabb	FALSE
dbbacacaaacdcbdba	FALSE
dbbacaddddbdabdaa	FALSE
dcabaadbaabbaddba	FALSE
dcabaadbadaadccdd	FALSE
dcccbdbbadbcacddd	FALSE
dcccbdbdbabbdcadb	FALSE
ddbbabadbdacacdad	FALSE
ddbbabbbbaddbddab	FALSE
aaaaabaddacadbccdd	TRUE
aaaaabcddcacbacacd	TRUE
aacdaddadcadbcaddc	TRUE
aacdbaadadcdbdcadb	TRUE
abcaaacddccbcddcaa	TRUE
abcaaadccccaacbbdc	TRUE
abdcdbcabcbdcbdcdd	TRUE
abdcdcbcbdbaaccacc	TRUE
acbdddaadcbbcacaab	TRUE
acbddddacaccccaadd	TRUE
adabcdbdbcaaccbdcb	TRUE
adabdacaaacbababca	TRUE
addbccccdcabaccbcb	TRUE
addbccddcbbbcbdbcc	TRUE
bacaaddabdabdccbcd	TRUE
bacabacddabdccbadd	TRUE
baddacddccbabbbabb	TRUE
baddadaaddcacbabdc	TRUE
bcbbccdabaaabadaac	TRUE
bcbbcdcacbdaacaddc	TRUE
bcdbccbbdbdbcaabcd	TRUE
bcdbccccbddbabcddd	TRUE
bdadcadbaaadbcccdb	TRUE
bdadcadbbcbbbdaccd	TRUE
bddadcbcbccdcbdddc	TRUE
bddaddaaddcbdbadca	TRUE
cabdaacadcacaacdda	TRUE
cabdaadaddadaaddcb	TRUE
caddcdbaadacabdacd	TRUE
cadddbdaacabdcbbcc	TRUE
cbdaaaadcbaaaaccda	TRUE
cbdaaaccbccbdcbbda	TRUE
ccaddcccdcbddaacda	TRUE
ccadddadbcacbdaccb	TRUE
ccdbcdadbbadcdadcc	TRUE
ccdbcddbddabbcaccb	TRUE
cdbdadacddbabbcbab	TRUE
cdbdadcaaaabbcaacb	TRUE
daaacabcaccbdaadbd	TRUE
daaacbdcdbbbbccdca	TRUE
dacdccbacadcbccbda	TRUE
dacdcccdbdcbbdcdcb	TRUE
dbcadaaabdabdabccb	TRUE
dbcadbcdabdcbbaabd	TRUE
dcabaaaddaadcdaddc	TRUE
dcabacbbabbcbaadbc	TRUE
dccdbcbcabbbbbbbda	TRUE
dccdbcdabcbcabcdbc	TRUE
ddbcabbcbcbbccaaac	TRUE
ddbcabcacbabdbdcca	TRUE
aaaaabaddabadbccdd	FALSE
aaaaabbddcacbacacd	FALSE
aacdaddadcadbbaddc	FALSE
aacdbaadadbdbdcadb	FALSE
abbaaacddccbcddcaa	FALSE
abbaaadccccaacbbdc	FALSE
abdbdbcabcbdcbdcdd	FALSE
abdbdcbcbdbaaccacc	FALSE
acbdddaadbbbcacaab	FALSE
acbddddabaccccaadd	FALSE
adabbdbdbcaaccbdcb	FALSE
adabdabaaacbababca	FALSE
addbbcccdcabaccbcb	FALSE
addbbcddcbbbcbdbcc	FALSE
babaaddabdabdccbcd	FALSE
bababacddabdccbadd	FALSE
baddabddccbabbbabb	FALSE
baddadaaddbacbabdc	FALSE
bbbbccdabaaabadaac	FALSE
bbbbcdcacbdaacaddc	FALSE
bbdbccbbdbdbcaabcd	FALSE
bbdbccccbddbabcddd	FALSE
bdadbadbaaadbcccdb	FALSE
bdadbadbbcbbbdaccd	FALSE
bddadbbcbccdcbdddc	FALSE
bddaddaaddbbdbadca	FALSE
cabdaabadcacaacdda	FALSE
cabdaadaddadaaddbb	FALSE
caddcdbaadababdacd	FALSE
cadddbdaababdcbbcc	FALSE
cbdaaaadbbaaaaccda	FALSE
cbdaaabcbccbdcbbda	FALSE
ccaddcccdcbddaabda	FALSE
ccadddadbbacbdaccb	FALSE
ccdbbdadbbadcdadcc	FALSE
ccdbbddbddabbcaccb	FALSE
cdbdadabddbabbcbab	FALSE
cdbdadbaaaabbcaacb	FALSE
daaacabbaccbdaadbd	FALSE
daaacbdbdbbbbccdca	FALSE
dacdccbabadcbccbda	FALSE
dacdcccdbdbbbdcdcb	FALSE
dbbadaaabdabdabccb	FALSE
dbbadbcdabdcbbaabd	FALSE
dcabaaaddaadbdaddc	FALSE
dcababbbabbcbaadbc	FALSE
dccdbbbcabbbbbbbda	FALSE
dccdbbdabcbcabcdbc	FALSE
ddbbabbcbcbbccaaac	FALSE
ddbbabcacbabdbdcca	FALSE
aaaaaaaccaaaccdadab	TRUE
aaaaaacccbdaaacbdbb	TRUE
aadaaabaaacdcaccacd	TRUE
aadaaadcacadcdbaccc	TRUE
abcacbbdcdabbcdddaa	TRUE
abcacbdcccbbdcabcaa	TRUE
abdddcddcddbacccbab	TRUE
abddddcaabbdcdddbdd	TRUE
accbadcdccacadcccac	TRUE
accbcacadabadabccbc	TRUE
adacddcbadccbcddbad	TRUE
adacdddacbddadacabd	TRUE
addbaccbbcaaadbcdcc	TRUE
addbaccbddbabbcacbc	TRUE
bacacbbaacadbaaadcd	TRUE
bacacbcabcdddcddcdc	TRUE
badccdddaacbbabdbcb	TRUE
badcdabaaadaaaccdcc	TRUE
bcbbaaddbadbbbaaddd	TRUE
bcbbacaadaabbabadbc	TRUE
bcdabdddccadbdaadaa	TRUE
bcdacbbdcccabdccacd	TRUE
bdaddadaacddabcbcdd	TRUE
bdaddadcdacdcdaadaa	TRUE
bddadacdadbbcbcacbd	TRUE
bddadacdcdbabcaabcc	TRUE
cabacccabaabaabddbd	TRUE
cabacccbbabcaadbaba	TRUE
cadccadddaacacbddac	TRUE
cadccbdacbacbbbbacc	TRUE
cbcddbcaacbabbcacdc	TRUE
cbcddcadacdbbddaddd	TRUE
ccbaddadaccdbcacaba	TRUE
ccbaddcdaabdadacbdc	TRUE
ccddaaccccdcbccbdcc	TRUE
ccddabaaddddaccdadc	TRUE
cdcbcababcdabcaacdc	TRUE
cdcbcabccbadbabcdcc	TRUE
daaccbccadababccadb	TRUE
daacccbcacacdcbaccb	TRUE
dadaccddcdaddadadcb	TRUE
dadacdadbcadaccbacc	TRUE
dbcbabcbcaacdacaaca	TRUE
dbcbabcddbbbbacbbdc	TRUE
dcacbdcdcbaacadddcd	TRUE
dcacbdddddccbbcabca	TRUE
dcdabcbabcccdcadcbc	TRUE
dcdabcbdabaddadacdb	TRUE
ddbadacbbbcacaacbad	TRUE
ddbadaccbbdbabdacbd	TRUE
aaaaaaaaaacddcdccbb	FALSE
aaaaabbcdcbdacbdbcd	FALSE
aacbbabadccbbaddaaa	FALSE
aacbbadcbbaabdabaaa	FALSE
abadbcabaabaccdbacb	FALSE
abadbcacbbcdddbcadc	FALSE
abdddbcacddbbccabaa	FALSE
abdddbcbadabbcadcab	FALSE
acccabaaadabbabcccb	FALSE
acccabbaccaaaabdada	FALSE
adbabcbdbcbcbdbaddc	FALSE
adbabcccadccddbacbd	FALSE
addbaddaaadabdbcaad	FALSE
addbaddabcbbadccbcb	FALSE
babababbaacddbbdccd	FALSE
bababacbdbbbbdcdaca	FALSE
badbdbacbacacdcbddb	FALSE
badbdcbadabdacbdcda	FALSE
bbbbbacbdbbcadcabda	FALSE
bbbbbbbbbabdddbaacd	FALSE
bbdbbbccdcaacccaabc	FALSE
bbdbbbdbcdbdddbabdb	FALSE
bdadbdccacbbbccddab	FALSE
bdadbddbbadacadcbbd	FALSE
bddaddddabccbbbcacb	FALSE
bddaddddbccdaaabaad	FALSE
cabaddddadaaabcbdbc	FALSE
cabbaaabbacbdbdadda	FALSE
caddcdbddaadbabbbad	FALSE
cadddadcbdddabdcdbc	FALSE
cbbcdcbcadacbabddaa	FALSE
cbbcdcbcccdcddadcbc	FALSE
ccadaaddcdacabdbcac	FALSE
ccadabadbbabccbcdbb	FALSE
ccdadaadadddabdadab	FALSE
ccdadaddcabaabddadd	FALSE
cdbadbadacbdbdaabad	FALSE
cdbaddaaadabbadbabd	FALSE
cddcdddddbbcaacbcca	FALSE
cdddaabadadbbdcccbb	FALSE
dacbbbbcbcaddbbbcca	FALSE
dacbbbdaacdcddaaaaa	FALSE
dbadadaaabaadccabdb	FALSE
dbadadaadbcdcaacabb	FALSE
dbdbdbcadabddbaccac	FALSE
dbdbdbcccddadbcadaa	FALSE
dccbadaaabbdccbaacd	FALSE
dccbaddaadddbdbaacd	FALSE
ddadbdbdbddcacdccba	FALSE
ddadbdbddabcaddaddd	FALSE
