aaaaabcccb	TRUE
aaaababdbb	TRUE
aacdadcccb	TRUE
aacdaddacb	TRUE
abbbbcddbb	TRUE
abbbbdbbab	TRUE
abdccbcccb	TRUE
abdcccddab	TRUE
acbdcdbaab	TRUE
acbdcdbbdb	TRUE
adadaabddb	TRUE
adadacabbb	TRUE
addbccbbab	TRUE
addbccdbdb	TRUE
bacaacdaac	TRUE
bacabadcaa	TRUE
bbaccddacc	TRUE
bbacdacdbc	TRUE
bbdbccddad	TRUE
bbdbdabcba	TRUE
bcbdadcbda	TRUE
bcbdbbaacc	TRUE
bdabdccbca	TRUE
bdabdcdcda	TRUE
bdcccbbadd	TRUE
bdcccbccaa	TRUE
cabcadadcd	TRUE
cabcadbabc	TRUE
cbaacaaadd	TRUE
cbaacaacca	TRUE
cbccbdadaa	TRUE
cbccbdcbbd	TRUE
ccbaabdcdc	TRUE
ccbaacbccd	TRUE
ccdadbbbbc	TRUE
ccdadbbbdd	TRUE
cdbbdbbcbd	TRUE
cdbbdbbdcc	TRUE
daaabacdda	TRUE
daaabbbacd	TRUE
dacccdbbba	TRUE
daccdaabdc	TRUE
dbbcacbbdd	TRUE
dbbcaccabc	TRUE
dcaabbaaac	TRUE
dcaabccccd	TRUE
dcccccbdbd	TRUE
dccccdabad	TRUE
ddbbbacddd	TRUE
ddbbbbbada	TRUE
aaaaabccca	FALSE
aaaababdbd	FALSE
aacdadccca	FALSE
aacdaddaca	FALSE
abbbbcddbc	FALSE
abbbbdbbad	FALSE
abdccbccca	FALSE
abdcccddaa	FALSE
acbdcdbaac	FALSE
acbdcdbbdd	FALSE
adadaabddd	FALSE
adadacabba	FALSE
addbccbbad	FALSE
addbccdbdd	FALSE
bacaacdaab	FALSE
bacabadcab	FALSE
bbaccddacb	FALSE
bbacdacdbb	FALSE
bbdbccddab	FALSE
bbdbdabcbb	FALSE
bcbdadcbdb	FALSE
bcbdbbaacb	FALSE
bdabdccbcb	FALSE
bdabdcdcdb	FALSE
bdcccbbadb	FALSE
bdcccbccab	FALSE
cabcadadcb	FALSE
cabcadbabb	FALSE
cbaacaaadb	FALSE
cbaacaaccb	FALSE
cbccbdadab	FALSE
cbccbdcbbb	FALSE
ccbaabdcdb	FALSE
ccbaacbccb	FALSE
ccdadbbbbb	FALSE
ccdadbbbdb	FALSE
cdbbdbbcbb	FALSE
cdbbdbbdcb	FALSE
daaabacddb	FALSE
daaabbbacb	FALSE
dacccdbbbb	FALSE
daccdaabdb	FALSE
dbbcacbbdb	FALSE
dbbcaccabb	FALSE
dcaabbaaab	FALSE
dcaabccccb	FALSE
dcccccbdbb	FALSE
dccccdabab	FALSE
ddbbbacddb	FALSE
ddbbbbbadb	FALSE
aaaaaacbcdb	TRUE
aaaaadbcccb	TRUE
aacbcbcbdab	TRUE
aacbccbbbcb	TRUE
abadbbdaabb	TRUE
abadbcabbdb	TRUE
abdaadcbacb	TRUE
abdabcbbcbb	TRUE
acbbbdbdaab	TRUE
acbbcabdcab	TRUE
acddbacaaab	TRUE
acddbbaaaab	TRUE
adcadaabcab	TRUE
adcadadbdbb	TRUE
baaddbcbbca	TRUE
baaddcaabad	TRUE
badccbacdbc	TRUE
badccbdbdaa	TRUE
bbcbacbdbba	TRUE
bbcbaccdcda	TRUE
bcbacbcbdcc	TRUE
bcbaccbbdcd	TRUE
bdaabbbdddc	TRUE
bdaabbcdaac	TRUE
bdccacdcacd	TRUE
bdccadbdaca	TRUE
cabbbbcbcbc	TRUE
cabbbccadcc	TRUE
cadccbacbac	TRUE
cadccbbbdad	TRUE
cbbddbddccd	TRUE
cbbddcabbcd	TRUE
ccacacbabac	TRUE
ccacacddbbd	TRUE
cccdcbbbcac	TRUE
cccddacbcdd	TRUE
cdbcadbacaa	TRUE
cdbcadbdabd	TRUE
daabbdbbaac	TRUE
daabcacccbc	TRUE
dadabcbacda	TRUE
dadabccbddc	TRUE
dbbdadcbbba	TRUE
dbbdbcadabd	TRUE
dcacccbcdad	TRUE
dcaccdbbbbd	TRUE
dcdaaabacdc	TRUE
dcdaaacbbac	TRUE
ddbbadadbcc	TRUE
ddbbadccdaa	TRUE
aaaaaacbcdc	FALSE
aaaaadbcccd	FALSE
aacbcbcbdad	FALSE
aacbccbbbcc	FALSE
abadbbdaabc	FALSE
abadbcabbda	FALSE
abdaadcbacd	FALSE
abdabcbbcbd	FALSE
acbbbdbdaac	FALSE
acbbcabdcad	FALSE
acddbacaaac	FALSE
acddbbaaaaa	FALSE
adcadaabcaa	FALSE
adcadadbdbd	FALSE
baaddbcbbcb	FALSE
baaddcaabab	FALSE
badccbacdbb	FALSE
badccbdbdab	FALSE
bbcbacbdbbb	FALSE
bbcbaccdcdb	FALSE
bcbacbcbdcb	FALSE
bcbaccbbdcb	FALSE
bdaabbbdddb	FALSE
bdaabbcdaab	FALSE
bdccacdcacb	FALSE
bdccadbdacb	FALSE
cabbbbcbcbb	FALSE
cabbbccadcb	FALSE
cadccbacbab	FALSE
cadccbbbdab	FALSE
cbbddbddccb	FALSE
cbbddcabbcb	FALSE
ccacacbabab	FALSE
ccacacddbbb	FALSE
cccdcbbbcab	FALSE
cccddacbcdb	FALSE
cdbcadbacab	FALSE
cdbcadbdabb	FALSE
daabbdbbaab	FALSE
daabcacccbb	FALSE
dadabcbacdb	FALSE
dadabccbddb	FALSE
dbbdadcbbbb	FALSE
dbbdbcadabb	FALSE
dcacccbcdab	FALSE
dcaccdbbbbb	FALSE
dcdaaabacdb	FALSE
dcdaaacbbab	FALSE
ddbbadadbcb	FALSE
ddbbadccdab	FALSE
aaaaaacbcdbb	TRUE
aaaaadcccdcb	TRUE
aacbdaddadcb	TRUE
aaccaaaccddb	TRUE
abacdbdadddb	TRUE
abacdcabdcab	TRUE
abdaacbbdacb	TRUE
abdababcbdcb	TRUE
acbbcccdbdcb	TRUE
acbbdbdcacbb	TRUE
acdcdbddaabb	TRUE
acdcdcaabadb	TRUE
adcaddacbcdb	TRUE
adcbaabcccdb	TRUE
baaccdbdbacd	TRUE
baaccddcacbc	TRUE
badcbbdbaaca	TRUE
badcbccadbdd	TRUE
bbcbdaccdbaa	TRUE
bbcbdcabcbdc	TRUE
bcbaaddbbbba	TRUE
bcbabbacbadc	TRUE
bcdccbbadada	TRUE
bcdccbbbddbd	TRUE
bdcccadacdad	TRUE
bdcccbcccaac	TRUE
cabbbcdacccd	TRUE
cabbbdbcbdbd	TRUE
cadcdcacdcbd	TRUE
cadcdcdcaaca	TRUE
cbcbcadabdaa	TRUE
cbcbcbdaccaa	TRUE
ccaddcdbccaa	TRUE
ccbaabbabbdc	TRUE
ccdcabdccdad	TRUE
ccdcadacbaad	TRUE
cdbdcdbadbac	TRUE
cdbdcdbbabac	TRUE
daabbbaacbcd	TRUE
daabbbcaaaac	TRUE
dacdccababdc	TRUE
dacdcdadccda	TRUE
dbbcaccdbddc	TRUE
dbbcacdadadd	TRUE
dcacadccacbd	TRUE
dcacbbabaddd	TRUE
dccdcccdcdca	TRUE
dccdccdbbaac	TRUE
ddbaddabdbba	TRUE
ddbaddbbcbbc	TRUE
aaaaaacbcdbc	FALSE
aaaaadcccdca	FALSE
aacbdaddadca	FALSE
aaccaaaccddc	FALSE
abacdbdadddc	FALSE
abacdcabdcaa	FALSE
abdaacbbdacd	FALSE
abdababcbdcd	FALSE
acbbcccdbdca	FALSE
acbbdbdcacbd	FALSE
acdcdbddaaba	FALSE
acdcdcaabada	FALSE
adcaddacbcda	FALSE
adcbaabcccdd	FALSE
baaccdbdbacb	FALSE
baaccddcacbb	FALSE
badcbbdbaacb	FALSE
badcbccadbdb	FALSE
bbcbdaccdbab	FALSE
bbcbdcabcbdb	FALSE
bcbaaddbbbbb	FALSE
bcbabbacbadb	FALSE
bcdccbbadadb	FALSE
bcdccbbbddbb	FALSE
bdcccadacdab	FALSE
bdcccbcccaab	FALSE
cabbbcdacccb	FALSE
cabbbdbcbdbb	FALSE
cadcdcacdcbb	FALSE
cadcdcdcaacb	FALSE
cbcbcadabdab	FALSE
cbcbcbdaccab	FALSE
ccaddcdbccab	FALSE
ccbaabbabbdb	FALSE
ccdcabdccdab	FALSE
ccdcadacbaab	FALSE
cdbdcdbadbab	FALSE
cdbdcdbbabab	FALSE
daabbbaacbcb	FALSE
daabbbcaaaab	FALSE
dacdccababdb	FALSE
dacdcdadccdb	FALSE
dbbcaccdbddb	FALSE
dbbcacdadadb	FALSE
dcacadccacbb	FALSE
dcacbbabaddb	FALSE
dccdcccdcdcb	FALSE
dccdccdbbaab	FALSE
ddbaddabdbbb	FALSE
ddbaddbbcbbb	FALSE
aaaaaacbcbacb	TRUE
aaaaabdaccddb	TRUE
aaccaaaacdcab	TRUE
aaccabbaadadb	TRUE
abadbabcdbccb	TRUE
abadbbaadcbbb	TRUE
abdcbbbbbdccb	TRUE
abdcbbbdabaab	TRUE
accaadaabcddb	TRUE
accaadbacdcdb	TRUE
adadadccdcdbb	TRUE
adadbbbbcaadb	TRUE
addaacddaacab	TRUE
addabacaccdcb	TRUE
babdbbabdbdda	TRUE
babdbbbcdddcc	TRUE
bbacbadbccabc	TRUE
bbacbdacdaaca	TRUE
bbcddccabbaad	TRUE
bbcdddccbddca	TRUE
bcbccbcaadbda	TRUE
bcbccccdacdca	TRUE
bdaabbadbcbaa	TRUE
bdaabbcbddbaa	TRUE
bdccaaabcaada	TRUE
bdccaabcdacad	TRUE
caadbbdcddaad	TRUE
caadbccaabbad	TRUE
cadbbadbcbada	TRUE
cadbbadddcada	TRUE
cbbdddabddbca	TRUE
cbbddddcbaaad	TRUE
ccabcabbbcaca	TRUE
ccabcabdaaabc	TRUE
ccccdcccdaacd	TRUE
cccdabccacbcc	TRUE
cdbccccddbddc	TRUE
cdbcdbbcdbbbd	TRUE
daaabbdabbbcc	TRUE
daaabcbaacaad	TRUE
daccaddccacca	TRUE
daccbaabbcbaa	TRUE
dbbaabadcdcca	TRUE
dbbaadaccbcac	TRUE
dbddabbabdabc	TRUE
dbddabbdabdac	TRUE
dccccccccbacd	TRUE
dcccdaccadbaa	TRUE
ddbbbdddcdcad	TRUE
ddbbcccaaaccc	TRUE
aaaaaacbcbacc	FALSE
aaaaabdaccddd	FALSE
aaccaaaacdcad	FALSE
aaccabbaadadd	FALSE
abadbabcdbcca	FALSE
abadbbaadcbbc	FALSE
abdcbbbbbdccc	FALSE
abdcbbbdabaaa	FALSE
accaadaabcdda	FALSE
accaadbacdcdc	FALSE
adadadccdcdbc	FALSE
adadbbbbcaadd	FALSE
addaacddaacaa	FALSE
addabacaccdca	FALSE
babdbbabdbddb	FALSE
babdbbbcdddcb	FALSE
bbacbadbccabb	FALSE
bbacbdacdaacb	FALSE
bbcddccabbaab	FALSE
bbcdddccbddcb	FALSE
bcbccbcaadbdb	FALSE
bcbccccdacdcb	FALSE
bdaabbadbcbab	FALSE
bdaabbcbddbab	FALSE
bdccaaabcaadb	FALSE
bdccaabcdacab	FALSE
caadbbdcddaab	FALSE
caadbccaabbab	FALSE
cadbbadbcbadb	FALSE
cadbbadddcadb	FALSE
cbbdddabddbcb	FALSE
cbbddddcbaaab	FALSE
ccabcabbbcacb	FALSE
ccabcabdaaabb	FALSE
ccccdcccdaacb	FALSE
cccdabccacbcb	FALSE
cdbccccddbddb	FALSE
cdbcdbbcdbbbb	FALSE
daaabbdabbbcb	FALSE
daaabcbaacaab	FALSE
daccaddccaccb	FALSE
daccbaabbcbab	FALSE
dbbaabadcdccb	FALSE
dbbaadaccbcab	FALSE
dbddabbabdabb	FALSE
dbddabbdabdab	FALSE
dccccccccbacb	FALSE
dcccdaccadbab	FALSE
ddbbbdddcdcab	FALSE
ddbbcccaaaccb	FALSE
aaaaaacbcbacbb	TRUE
aaaaabaccddcab	TRUE
aaccadbdbdacdb	TRUE
aaccadcabbdbab	TRUE
abbaabcbcaddbb	TRUE
abbaaccddabadb	TRUE
abdccbadbcdddb	TRUE
abdccbcaccccdb	TRUE
accbbabbdcaddb	TRUE
accbbbcbbcdcdb	TRUE
adadabcdbabbcb	TRUE
adadabddbcaacb	TRUE
addbbcbbcadcab	TRUE
addbbcbdcaccab	TRUE
bacadccdbccaad	TRUE
bacaddcbcddbaa	TRUE
bbadbadcdbadcc	TRUE
bbadbbddaccacd	TRUE
bbdadccbccbcac	TRUE
bbdbaabbbcccac	TRUE
bcbcbcdbacdcca	TRUE
bcbcbdbcdccbca	TRUE
bcddddcbbddbdd	TRUE
bdaaaabdadccba	TRUE
bdcbccbabcccba	TRUE
bdcbdadbbcbcaa	TRUE
caaddaacacadbd	TRUE
caaddabcdabbdd	TRUE
cadbcbaadadada	TRUE
cadbcddabadcba	TRUE
cbbddbddacdbca	TRUE
cbbdddaccaaadd	TRUE
ccacaddbbccabd	TRUE
ccacbbdacacdcc	TRUE
ccdadabccaddbc	TRUE
ccdadadadbccba	TRUE
cdbcbbbabcaada	TRUE
cdbcbbccccbaca	TRUE
daaaacbaacbccd	TRUE
daaaaccaddddca	TRUE
dacdadbaaabccc	TRUE
dacdbadacccdba	TRUE
dbbadbccacadba	TRUE
dbbadbdabcacca	TRUE
dcaadcdbbccdcd	TRUE
dcaaddbbbadcba	TRUE
dccdccdabacccc	TRUE
dccdccdabadccd	TRUE
ddbcbdbbddaacc	TRUE
ddbccaadcaadcc	TRUE
aaaaabadcbcaca	FALSE
aaaaabdcbaccdd	FALSE
aacbbcbadabbba	FALSE
aacbbccaddbcaa	FALSE
abbaaaabdbcabd	FALSE
abbaabccaddaba	FALSE
abdaddabbaccdd	FALSE
abdaddcabbcaaa	FALSE
accacaabbadccc	FALSE
accacaacdabbaa	FALSE
adadaabbdbcaad	FALSE
adadabcbcdabba	FALSE
addabdacbdcdad	FALSE
addacbcdaccdbc	FALSE
babdccdcaaaabb	FALSE
babdcdbdccaddb	FALSE
bbabccacbbdcdb	FALSE
bbabccacdbacab	FALSE
bbdaadbcddbcbb	FALSE
bbdabaadaddccb	FALSE
bcbcbaccdbbdbb	FALSE
bcbcbcadddbcab	FALSE
bcddddadaaabdb	FALSE
bdaaabbaccbccb	FALSE
bdcdcbcbccccab	FALSE
bdcdccdabbbdcb	FALSE
cabacaaacdcccb	FALSE
cabacdaacdbcbb	FALSE
cadcdcabdddcbb	FALSE
cadcdccbcbddbb	FALSE
cbcadcbdcccadb	FALSE
cbcadcdbbddbab	FALSE
ccabdaadacaccb	FALSE
ccabdaadddcdcb	FALSE
ccdbacadacabbb	FALSE
ccdbacadbaabab	FALSE
cdbdccdddacbbb	FALSE
cdbdcdbaaaaddb	FALSE
daabcabbacdcdb	FALSE
daabcdabbcbabb	FALSE
dacdccdbcbbccb	FALSE
dacdcdcbdbcbab	FALSE
dbbcacbbbcacbb	FALSE
dbbcadaddcddcb	FALSE
dcabacbdccddab	FALSE
dcabacdcbcdaab	FALSE
dccddcddbbadbb	FALSE
dcdaaaabbccdcb	FALSE
ddbbbacabadccb	FALSE
ddbbbcaddbbbcb	FALSE
aaaaabadcbcacab	TRUE
aaaaabdbaccdcab	TRUE
aacbddccbdacccb	TRUE
aacbddccddadbbb	TRUE
abadddaacabccab	TRUE
abadddaaddcbdab	TRUE
abdbbccbddacbab	TRUE
abdbbdcdcdcbbab	TRUE
accabcabbccdbcb	TRUE
accacbaacddbdbb	TRUE
adacddbcbdcbacb	TRUE
adacddcccdddbdb	TRUE
addadaddbcdcbab	TRUE
addadbcbbbdcddb	TRUE
babccccdbdbaddd	TRUE
babccdcdabbccca	TRUE
bbabbbddcbcddda	TRUE
bbabbbddcbdadba	TRUE
bbdabaaabdcabda	TRUE
bbdabadcddbccad	TRUE
bcbccbdcdcbdbca	TRUE
bcbccdbbadbacdc	TRUE
bdabbcdbdcddcdd	TRUE
bdabbdbdcabdcdc	TRUE
bdcdabbcdbaccad	TRUE
bdcdadcdbbbbcdc	TRUE
cababadacddacbc	TRUE
cababbacdadaacc	TRUE
cadcdbccacbcbbd	TRUE
cadcdbccbdcaaad	TRUE
cbcbcacaddacdaa	TRUE
cbcbcccadabcbaa	TRUE
ccadbcdcbacdbcd	TRUE
ccadbcdcbbdbabc	TRUE
ccdbbdbbaddbcaa	TRUE
ccdbcaabbabcabc	TRUE
cdbdcbacbaaaabc	TRUE
cdbdcdddcbbcbac	TRUE
daabdcdcabdcbac	TRUE
daabddabcbcacda	TRUE
dadaaabadaabadc	TRUE
dadaabcadcbdccd	TRUE
dbbddacadaddbdc	TRUE
dbbddacdddacbca	TRUE
dcabcccbcacbcaa	TRUE
dcabcdbbdacdcac	TRUE
dcdacdabcaddcca	TRUE
dcdacdcddcabbaa	TRUE
ddbdbabdbbaccbc	TRUE
ddbdbadadbbdcca	TRUE
aaaaabbbbdcbaca	FALSE
aaaaabcdbcaddcd	FALSE
aacbcbcbcadacda	FALSE
aacbccadddcdbcd	FALSE
abbabbbaaabbcda	FALSE
abbabccaaadadad	FALSE
abdbcabbdacabbd	FALSE
abdbcabdaaacaca	FALSE
acbdbdcaddbdaba	FALSE
acbdbdcdcccaaca	FALSE
adabdddbddbdaba	FALSE
adacabcacadccbc	FALSE
adcdcaacdcaaadd	FALSE
adcdcacdabbcdaa	FALSE
babcdbdbaccdabb	FALSE
babcdcbdaabdccb	FALSE
baddbdcbabbccbb	FALSE
baddcbaabdcaacb	FALSE
bbcbcdaaccdbdbb	FALSE
bbcbcddbaabdbcb	FALSE
bcbabdbcccbbcdb	FALSE
bcbacbcbacbabdb	FALSE
bcdccbbdddcbbbb	FALSE
bcdccbcadcacadb	FALSE
bdcacbdabccacbb	FALSE
bdcacccabcbdcab	FALSE
caaccacccaccadb	FALSE
caaccadabdbdacb	FALSE
cacdbccbadbddab	FALSE
cacdbcddbacbddb	FALSE
cbbbddcbbdcbbcb	FALSE
cbbcabaaacdddbb	FALSE
ccabbbcacccddab	FALSE
ccabcaacdbabdab	FALSE
ccdadcccbbdcddb	FALSE
ccdadcdbaaacdcb	FALSE
cdbdadbdbdadadb	FALSE
cdbdbaabbbaaaab	FALSE
daaaaadbbaabbab	FALSE
daaaadcadbbcdbb	FALSE
daccbbdabcccaab	FALSE
daccbdacddcbdbb	FALSE
dbbacaccbcbcacb	FALSE
dbbacbcaddddcdb	FALSE
dcaabddbcbaaadb	FALSE
dcaacaaacdcaaab	FALSE
dccdaabccdacbab	FALSE
dccdabacdadbbbb	FALSE
ddbbdbdddbadddb	FALSE
ddbbdcbcbacdbab	FALSE
aaaaabbbbdcbacbb	TRUE
aaaaabcbcaddcdcb	TRUE
aacbbddbccadbacb	TRUE
aacbcbdbbbdbdcab	TRUE
abaddcadacbbbdcb	TRUE
abaddcbbbbbbcccb	TRUE
abdbdddcbcadaacb	TRUE
abdcacbaaadaabdb	TRUE
accaababcaabcddb	TRUE
accaacababbbcbbb	TRUE
adabcaabcdacccab	TRUE
adabcabcccdadbdb	TRUE
addabaaddbbbabcb	TRUE
addabadcbaabadcb	TRUE
babbdacddaaabadc	TRUE
babbdbdddbaaccac	TRUE
bbaaacacbcddaddc	TRUE
bbaaaccbdabcdaca	TRUE
bbccbbdcdddacddc	TRUE
bbccbccddcddadad	TRUE
bcbaccddcddbcaad	TRUE
bcbacdbcdccdbddd	TRUE
bcdcccbddbcadcca	TRUE
bcdccdbabccddbba	TRUE
bdcabcdbcdbdaddd	TRUE
bdcacccbcadacacc	TRUE
caaccacdbcbcabca	TRUE
caacccbdddbaadaa	TRUE
cadaaccbcdbbcaaa	TRUE
cadaacccabbdddbc	TRUE
cbbdaabddbdcacbc	TRUE
cbbdaacbadabddbd	TRUE
ccacabdbdbdabcad	TRUE
ccacacaaaacdcbca	TRUE
ccdaaccabbcbdcaa	TRUE
ccdaacccbdbdbcda	TRUE
cdbbbbcadacabbda	TRUE
cdbbbcbabbacbcbd	TRUE
daaaabbcddbaaacd	TRUE
daaaacaacdbccabc	TRUE
daccbdcbadabbbda	TRUE
dacccaccbacddbac	TRUE
dbbcadbbaadcddac	TRUE
dbbcadcdacdccdcc	TRUE
dcaacbbcdcaddbad	TRUE
dcaacdadbdaaabbd	TRUE
dcccaddbdaabbbac	TRUE
dcccbabbcdcdaaaa	TRUE
ddbacdbabdccddaa	TRUE
ddbadaccdbaabbaa	TRUE
aaaaacddbabdaddc	FALSE
aaaaadabbaadcdaa	FALSE
aacbacdcbaaaccac	FALSE
aacbadabcddcadda	FALSE
abadacadacdcdbca	FALSE
abadaccbaccdcdca	FALSE
abdbbcbbdacbdccd	FALSE
abdbbcdbbbcccbbd	FALSE
acbddcbdcbbaacaa	FALSE
accaaacaaaacbaba	FALSE
adaadbdadaccaadc	FALSE
adaadcaddbbccdad	FALSE
adcdbdaaddcdaaac	FALSE
adcdbdddcdccbabd	FALSE
babdabcaaabddabb	FALSE
babdabccdadacbdb	FALSE
bbaadbbdbcacdcab	FALSE
bbaadcabaaabbcbb	FALSE
bbcdbabadacbaddb	FALSE
bbcdbbcbbaccdcab	FALSE
bcbbbdbbcbcaacdb	FALSE
bcbbcbaabbadaacb	FALSE
bcddacdbcabbdbcb	FALSE
bcddadcadcdbabbb	FALSE
bdcbcbbdbbcabcab	FALSE
bdcbcbccbcbddadb	FALSE
caaddbbddcacaddb	FALSE
caaddcaacddcbbdb	FALSE
cadcabcabdcacddb	FALSE
cadcbbadadadcbcb	FALSE
cbcaabcdaabcdbcb	FALSE
cbcaabdbcbdcdcab	FALSE
ccacadccbabacacb	FALSE
ccacbbdbbacdacdb	FALSE
ccdadcbcacbdaadb	FALSE
ccdadcbccbbcccdb	FALSE
cdbdbdbddcccdbdb	FALSE
cdbdcabdccacaccb	FALSE
daadcbaccddabbcb	FALSE
daadcbbbcaccdabb	FALSE
dadbbbcaaddaabcb	FALSE
dadbbdccbdccadbb	FALSE
dbbdcbcaadcdbddb	FALSE
dbbdccdcdccbddab	FALSE
dcabccbabaddadbb	FALSE
dcabdbcadadcddab	FALSE
dccdbdbcdbcdbdcb	FALSE
dccdcbadabbacbcb	FALSE
ddbbbbcbbdaccbcb	FALSE
ddbbbbccdbccbabb	FALSE
aaaaacddbabdaddcb	TRUE
aaaaadabbdaadcdab	TRUE
aacbcbccddacbbcbb	TRUE
aacbcbdcbccbddbdb	TRUE
abaddacdabdaaaaab	TRUE
abaddadbbbddadcab	TRUE
abdcaacbaaaaacccb	TRUE
abdcabbaacccbdaab	TRUE
acbdbbddcbcdccbdb	TRUE
acbdbcacadcaaaaab	TRUE
adabaddadcdbaabcb	TRUE
adabaddbdbbbddbab	TRUE
adcdccbbabbbbcbdb	TRUE
adcdcccaacdbccccb	TRUE
babccddbddaaaddca	TRUE
babcdaadacdacabca	TRUE
bbaaddbbaabbdabad	TRUE
bbaaddbcaaabbbadd	TRUE
bbcdaaccadcdabcda	TRUE
bbcdadcdbbcacbaad	TRUE
bcbbdbbbaccabccba	TRUE
bcbbdbccdbaabaddc	TRUE
bcddcbcabbacbcbca	TRUE
bcddcbccbccbabdcd	TRUE
bdcbcadbbccaabacd	TRUE
bdcbcbbdcddacaabc	TRUE
caaddaaccddcbbadd	TRUE
caaddbabccbbdcbda	TRUE
cadbcddcadbdcbcdc	TRUE
cadbdaacdbbdbbdba	TRUE
cbbdccddbcabcddbc	TRUE
cbbdcdcbddddbcacd	TRUE
ccabccbbcccbadbba	TRUE
ccabdbacdccddaccd	TRUE
ccdabcbcbabcaabda	TRUE
ccdabccacdbcbddba	TRUE
cdbdabaabbbbaacdd	TRUE
cdbdacddcdacabdba	TRUE
daadcdaaababbcadc	TRUE
daaddadbcacdcdcdc	TRUE
dadacbbdbbdcbccda	TRUE
dadacdabbbcdddabd	TRUE
dbbcbdcccaacbbcbc	TRUE
dbbcbddaccbadddca	TRUE
dcabcabdcaddbddaa	TRUE
dcabcacbcdbbacdca	TRUE
dcccdbdacdabcabcd	TRUE
dcccdcadddddaadbc	TRUE
ddbbdbcbccabacdbd	TRUE
ddbbdcbaabbaaadba	TRUE
aaaaaacdcbabcbadc	FALSE
aaaaaadcbcaadabbc	FALSE
aacdbdacadddbdbcd	FALSE
aacdcbcdcbabbadaa	FALSE
abbabdabdbcdcdddc	FALSE
abbabdccbbbbddcad	FALSE
abdcbdddddcdcabbd	FALSE
abdccacbbaabbdaac	FALSE
accbbbcadbcbddaca	FALSE
accbbbcbddcabddbd	FALSE
adadadcbbccdadbdd	FALSE
adadbabbcbdcdddba	FALSE
adcddccadcadaccca	FALSE
addaabdddaaccdaca	FALSE
babbbcdacbdcdadab	FALSE
babbbdadabbcdcabb	FALSE
baddbcdbbabcbdbbb	FALSE
baddbdcdcdadbdabb	FALSE
bbcbdabbbbbcbbccb	FALSE
bbcbdabbbccabbbbb	FALSE
bcbabbbdcdaacbccb	FALSE
bcbabdbabbddaccbb	FALSE
bcdbcbcdbccbbbbab	FALSE
bcdbcdadbbdcdabdb	FALSE
bdbdccaccdbdacacb	FALSE
bdbdccdcbddbdbccb	FALSE
caabdabaaccdbdbbb	FALSE
caabdabddabbabbdb	FALSE
cacdcabaabdbcddbb	FALSE
cacdcbbcaabdbbcab	FALSE
cbbcbabbdddbdddcb	FALSE
cbbcbacaaacadaacb	FALSE
ccabdadcaacbccccb	FALSE
ccabdbbcddbdacccb	FALSE
ccdaaddacabbdcddb	FALSE
ccdabbcdbcbdaaadb	FALSE
cdbcbbddabddcdcbb	FALSE
cdbcbccaccabaacbb	FALSE
daaabadcccbbcccbb	FALSE
daaabcdddadcaadcb	FALSE
daccdcddbddccabbb	FALSE
dacdaabdbbbadbbdb	FALSE
dbbbbdadadbddbbab	FALSE
dbbbbddddccbbbdbb	FALSE
dcaaaabbacdaadbcb	FALSE
dcaaaacbbacdcadcb	FALSE
dccbdcaadbdcbbcab	FALSE
dccbdcdddbbccaccb	FALSE
ddbacdaddbbdadacb	FALSE
ddbadbbacadbddddb	FALSE
aaaaababccacccdcbb	TRUE
aaaaacccdbdcbdcbbb	TRUE
aaccdbbccbaaccddab	TRUE
aaccdcbacddacacddb	TRUE
abbbabacbbadacbbab	TRUE
abbbabbacacbcbcbbb	TRUE
abddbababcbdadbcbb	TRUE
abddbabcbbbcdbcccb	TRUE
accbaacccababbbabb	TRUE
accbbbbbcccdcbdddb	TRUE
adaccaacdcdbbcdabb	TRUE
adaccbcddabbbdaabb	TRUE
addadabaabbdaadcbb	TRUE
addadbaadbdabcbabb	TRUE
bacabaabacccadcbba	TRUE
bacababcbbcadaacaa	TRUE
bbacabdabbddacdbbc	TRUE
bbacaccbcdccbaacad	TRUE
bbcdddbddacaaddadd	TRUE
bbdaaaccabacdcddaa	TRUE
bcbbbddabababcbddc	TRUE
bcbbcababccdcaddaa	TRUE
bdaaadccdbddabdbdc	TRUE
bdaaaddbcadbdbbadd	TRUE
bdcccbccabccacadbc	TRUE
bdccccbbdacbdcaccc	TRUE
caadddaaccdaddbcbd	TRUE
cabaaccabcbcddadcd	TRUE
cadcdddddbbbabbdcd	TRUE
caddabbddbbacbabba	TRUE
cbcbcadadaababbbcd	TRUE
cbcbcadbacdbadbcad	TRUE
ccaccdbbbacbdbcdba	TRUE
ccaccddccbcdbbddcc	TRUE
ccdabbcacdbddcbcad	TRUE
ccdabbdaddbadbaadd	TRUE
cdbbdaaaabbcdbdada	TRUE
cdbbdaccccadbcbaad	TRUE
daabccbdbacacaacda	TRUE
daabdadbcdabbbcacd	TRUE
dadadadbddbcaccdaa	TRUE
dadadbbaddbaaadbcc	TRUE
dbbdbddcacdcccdadd	TRUE
dbbdcabdcaccaacbba	TRUE
dcaadabacbcbcabaca	TRUE
dcaadabaddacccdadc	TRUE
dccdccacacdbbcabba	TRUE
dccdcdcadcabddcdbd	TRUE
ddbbcbbcbbbaaababd	TRUE
ddbbcbccabddbacabc	TRUE
aaaaababccacccdcbd	FALSE
aaaaacccdbdcbdcbbd	FALSE
aaccdbbccbaaccddad	FALSE
aaccdcbacddacacddc	FALSE
abbbabacbbadacbbac	FALSE
abbbabbacacbcbcbbd	FALSE
abddbababcbdadbcba	FALSE
abddbabcbbbcdbccca	FALSE
accbaacccababbbaba	FALSE
accbbbbbcccdcbdddd	FALSE
adaccaacdcdbbcdabd	FALSE
adaccbcddabbbdaaba	FALSE
addadabaabbdaadcbc	FALSE
addadbaadbdabcbabc	FALSE
bacabaabacccadcbbb	FALSE
bacababcbbcadaacab	FALSE
bbacabdabbddacdbbb	FALSE
bbacaccbcdccbaacab	FALSE
bbcdddbddacaaddadb	FALSE
bbdaaaccabacdcddab	FALSE
bcbbbddabababcbddb	FALSE
bcbbcababccdcaddab	FALSE
bdaaadccdbddabdbdb	FALSE
bdaaaddbcadbdbbadb	FALSE
bdcccbccabccacadbb	FALSE
bdccccbbdacbdcaccb	FALSE
caadddaaccdaddbcbb	FALSE
cabaaccabcbcddadcb	FALSE
cadcdddddbbbabbdcb	FALSE
caddabbddbbacbabbb	FALSE
cbcbcadadaababbbcb	FALSE
cbcbcadbacdbadbcab	FALSE
ccaccdbbbacbdbcdbb	FALSE
ccaccddccbcdbbddcb	FALSE
ccdabbcacdbddcbcab	FALSE
ccdabbdaddbadbaadb	FALSE
cdbbdaaaabbcdbdadb	FALSE
cdbbdaccccadbcbaab	FALSE
daabccbdbacacaacdb	FALSE
daabdadbcdabbbcacb	FALSE
dadadadbddbcaccdab	FALSE
dadadbbaddbaaadbcb	FALSE
dbbdbddcacdcccdadb	FALSE
dbbdcabdcaccaacbbb	FALSE
dcaadabacbcbcabacb	FALSE
dcaadabaddacccdadb	FALSE
dccdccacacdbbcabbb	FALSE
dccdcdcadcabddcdbb	FALSE
ddbbcbbcbbbaaababb	FALSE
ddbbcbccabddbacabb	FALSE
aaaaaacccdadbdddbdb	TRUE
aaaaabaadaabbcaccbb	TRUE
aacbddbaadaaacdabcb	TRUE
aaccaabbabbaddbcacb	TRUE
abadbacaddbaabadabb	TRUE
abadbadbacadacdccdb	TRUE
abdbbaaacdacaadadcb	TRUE
abdbbbbbdbdbcabccab	TRUE
acbcdbdabcadbcadacb	TRUE
acbcddcbdbabbbdaacb	TRUE
adabbbacdbaacbdbdcb	TRUE
adabbbcbadbcaccacbb	TRUE
addbabbaadddddbdcbb	TRUE
addbaccdcccdacdbbbb	TRUE
babcdbbbcdbbaabbaba	TRUE
babcdbcdccadddbadba	TRUE
bbaadddbadbbdacbaba	TRUE
bbabaabbdcdaaacdcac	TRUE
bbcdcaabccbaaccbacd	TRUE
bbcdcabcccdaccdbcac	TRUE
bcbcadbadddaadbcbad	TRUE
bcbcaddababccbccdca	TRUE
bdaacacadddbdbdbaba	TRUE
bdaaccaccabbccacbad	TRUE
bdcdabbbcbbbadbcbcd	TRUE
bdcdacbcddbcbdccbba	TRUE
cabbccdaddbdbdadbda	TRUE
cabbcdacadcccbbbcdc	TRUE
cbaaabbddbabdacbbcd	TRUE
cbaaacbcaccadadbabc	TRUE
cbcccabcbdacbcdcabc	TRUE
cbcccadaabbdddabbbd	TRUE
ccadccbbdbcdbbdacda	TRUE
ccadccbcaabbddbcacc	TRUE
ccdaddccdbacaabccda	TRUE
ccdadddbbaccdcbbdba	TRUE
cdbdddabbcddabdcdba	TRUE
cdcaabaaadccbcadbcc	TRUE
daacbbccdcddcdccdaa	TRUE
daacbbddcbbbdcdbdba	TRUE
dadaddcbadddddacddd	TRUE
dadaddcbdcddaaaccad	TRUE
dbbbdabacbdcddcdadd	TRUE
dbbbdbaaaadcddcccca	TRUE
dcaadaadabadcbbdbdd	TRUE
dcaadbadbdadbacbacc	TRUE
dcccccccbaddcdcaaba	TRUE
dccccdccbcbbcabdccc	TRUE
ddbadabbddacbadacdd	TRUE
ddbaddcbdcdddacdaaa	TRUE
aaaaaacccdadbdddbdd	FALSE
aaaaabaadaabbcaccbc	FALSE
aacbddbaadaaacdabca	FALSE
aaccaabbabbaddbcaca	FALSE
abadbacaddbaabadabd	FALSE
abadbadbacadacdccda	FALSE
abdbbaaacdacaadadcd	FALSE
abdbbbbbdbdbcabccad	FALSE
acbcdbdabcadbcadaca	FALSE
acbcddcbdbabbbdaacc	FALSE
adabbbacdbaacbdbdcc	FALSE
adabbbcbadbcaccacbd	FALSE
addbabbaadddddbdcba	FALSE
addbaccdcccdacdbbbc	FALSE
babcdbbbcdbbaabbabb	FALSE
babcdbcdccadddbadbb	FALSE
bbaadddbadbbdacbabb	FALSE
bbabaabbdcdaaacdcab	FALSE
bbcdcaabccbaaccbacb	FALSE
bbcdcabcccdaccdbcab	FALSE
bcbcadbadddaadbcbab	FALSE
bcbcaddababccbccdcb	FALSE
bdaacacadddbdbdbabb	FALSE
bdaaccaccabbccacbab	FALSE
bdcdabbbcbbbadbcbcb	FALSE
bdcdacbcddbcbdccbbb	FALSE
cabbccdaddbdbdadbdb	FALSE
cabbcdacadcccbbbcdb	FALSE
cbaaabbddbabdacbbcb	FALSE
cbaaacbcaccadadbabb	FALSE
cbcccabcbdacbcdcabb	FALSE
cbcccadaabbdddabbbb	FALSE
ccadccbbdbcdbbdacdb	FALSE
ccadccbcaabbddbcacb	FALSE
ccdaddccdbacaabccdb	FALSE
ccdadddbbaccdcbbdbb	FALSE
cdbdddabbcddabdcdbb	FALSE
cdcaabaaadccbcadbcb	FALSE
daacbbccdcddcdccdab	FALSE
daacbbddcbbbdcdbdbb	FALSE
dadaddcbadddddacddb	FALSE
dadaddcbdcddaaaccab	FALSE
dbbbdabacbdcddcdadb	FALSE
dbbbdbaaaadcddccccb	FALSE
dcaadaadabadcbbdbdb	FALSE
dcaadbadbdadbacbacb	FALSE
dcccccccbaddcdcaabb	FALSE
dccccdccbcbbcabdccb	FALSE
ddbadabbddacbadacdb	FALSE
ddbaddcbdcdddacdaab	FALSE
